#######################
# #     # #   #       #
# ##### # # ### #######
# #     # # # #     # #
# ### ### # # # ##### #
# #       # #   # #   #
# ####### # # ### ### #
#         # # #       #
######### # # ### #####
# #   #       # #     #
# # ######### # # #####
# #   #       # #   # #
# # ####### # # ### # #
# # #       #   #     #
# # ######### ##### ###
# # # #       # #     #
# # # ####### # ##### #
# #           #   #   #
# ####### # ### ### ###
#   #     #   # #     #
### ####### ### # #####
#                     #
#######################
