#######################
# # # #       #   # # #
# # # ### ### ### # # #
# # #   # #   #   # # #
# # ### ##### ### # # #
#         # #     #   #
# # ##### # ##### # ###
# # #         # # #   #
# ### # ##### # # # # #
#   # # #           # #
# # ########### #######
# # # #               #
##### ####### # ### # #
# #   #       #   # # #
# ### ##### ### # # # #
#             # # # # #
##### ### ### #########
#     #   #           #
# ### # ### # ### # # #
# #   # #   #   # # # #
### ######### # ### # #
#   #         #   # # #
#######################
