#######################
# #     # # # # #     #
# ##### # # # # # # # #
# #         #   # # # #
# ##### # # ### ### ###
# #     # #   #   #   #
# ######### # ### # ###
#       # # #     #   #
# ##### # ####### # ###
# #             # #   #
############### # ### #
#                     #
######### ######### # #
#         #         # #
### # # # # ##### # ###
#   # # # # #     #   #
# # # ### ######### ###
# # # #   #           #
# ####### # ####### # #
# #       # #       # #
### ##### ##### # # # #
#   #     #     # # # #
#######################
