#######################
#   # # # #   # #     #
### # # # # ### # #####
#   # # # # # # #     #
### # # # # # # # ### #
#         #         # #
# ### # # # ##### #####
# #   # #       # # # #
### # # ########### # #
#   # #               #
### ### ### # #########
#   #     # #   # # # #
# # # ### # # # # # # #
# # # #   # # #       #
# ##### ### # #########
# #       # #         #
# ### ####### # # #####
# #         # # #     #
# ### ######### ##### #
# #           #     # #
####### # ##### ### ###
#       #   #     #   #
#######################
