#######################
#     #     #       # #
##### ### # ####### # #
#       # # # #   # # #
# ##### ### # ### # # #
# #     #   #   #   # #
####### ### # ##### # #
# #     # # #   # # # #
# ##### # # # ### # # #
# # #   #       # #   #
# # ### ####### # # ###
#       #       # #   #
####### ##### ### ### #
# #                   #
# ################### #
#               #     #
# # ##### ##### # # ###
# # #     #       #   #
# ##### ##### ### # ###
# #     #     #   #   #
##### # # # # # # # # #
#     # # # # # # # # #
#######################
