#######################
#         #           #
# # ### ### # ####### #
# # #       #       # #
####### # # # #########
#       # # #         #
# ### # # # # #########
# #   # # # # #     # #
# # # ### # ### ##### #
# # #   # #         # #
### # ############### #
#   #     #   #       #
# # # ##### # # #######
# # #       #         #
# # # # ####### ### # #
# # # #       #   # # #
##### # # # ### ### # #
#     # # # # #   # # #
### ##### # # ####### #
#       # #   #     # #
# # ### # # ### ##### #
# #   # # #     #     #
#######################
