#######################
#           # # #   # #
########### # # ### # #
# #   #     # # #     #
# ### ##### # # ### ###
#     # # # # # #   # #
### # # # # # # # ### #
#   # # # #   # # # # #
##### # # # ### # # # #
#   #   #   #   # #   #
### ### # ### ### # ###
#   # #   #           #
# # # ### # ##### #####
# #         #   # #   #
####### # ### ##### ###
# #     #             #
# ### # # # # # ### ###
#     # # # # #   # # #
### # # # # ### ##### #
#   # # # #   #       #
########### ### ### # #
#           #     # # #
#######################
