#######################
# #   # #   # #   # # #
# ### # ### # ### # # #
#   #     # # # #     #
### ##### # # # # ### #
#   #   # # #   # #   #
### ### # # ### ### # #
#           #       # #
##### # ### ####### # #
# #   # #           # #
# # ####### # # ### ###
#   # # # # # # #     #
# ### # # ##### # # # #
# #             # # # #
### ##### ### # # ### #
#   # # # #   # #   # #
##### # ### # # # # ###
#     #     # # # #   #
# ### ####### # # ### #
# #     #     # # #   #
####### ####### # #####
#               #     #
#######################
