#######################
#     #     #   #   # #
### # ### ##### ### # #
# # #     # #   # # # #
# ##### ### ### # # # #
#       # # #   # #   #
# ##### # # # ### ### #
# #     #   # # #     #
### ### ### # # ##### #
# # # #     # #   # # #
# ### ##### # ### # # #
# # #   # # #   #     #
# # ### # # ### ### ###
#     #               #
##### ##### ####### ###
#   #       #       # #
### ### ### ####### # #
#   # # #   #         #
# # # # ####### ##### #
# #   # #       #     #
##### # ####### ### ###
#       #       #     #
#######################
