#######################
#         # # #   #   #
### ####### # # ### ###
# #       # # #     # #
# # ####### # # ##### #
#     #         #     #
### ### ### ##### #####
#         #       #   #
# # ####### ####### ###
# #       # #         #
### ######### #########
#               #     #
# # # # # ####### ### #
# # # # #         # # #
# # # # # # # # ### ###
# # # # # # # #       #
### # ### # # # # #####
#   #   # # # # #     #
# ### ### # ### #######
# #     # # #   #   # #
# # # # ##### ### ### #
# # # #     #         #
#######################
