#######################
#             # #     #
# # ####### ### ### ###
# # #         # # # # #
# # # # ### ### # # # #
# # # # #             #
##### ##### # ##### # #
#     # #   #     # # #
### # # ### ######### #
#   # #             # #
### # ####### ##### ###
#   # #         #     #
############# ##### ###
# #           #   # # #
# ####### ### # ##### #
#           #         #
##### # ##### # # # ###
#     # #     # # #   #
####### ### # # # #####
#       #   # # # #   #
### ### # ##### ### # #
#     # # #         # #
#######################
