#######################
#   # #               #
### # # ### ##### #####
# # #   # # # # #   # #
# # ##### # # # ##### #
# # # # #   #   # # # #
# # # # # ### ### # # #
# # # # # # # # # #   #
# # # # # # # # # # # #
#           # # # # # #
######### ### # # # ###
# #   #     # #       #
# ### ##### # ### #####
#   #   # #   # #     #
# ##### # ### # # #####
# # #   # #   #       #
# # ### # # ##### #####
# #   # #   #   # #   #
# ### # # ##### # # ###
# #   # #   # # #   # #
# ### # # ### # # ### #
#                     #
#######################
