#######################
#         #       #   #
### ##### ### ####### #
# # #                 #
# # ######### #########
# # # #   # #         #
# ### ### # # #########
#     # #     #       #
##### # ##### # # #####
#               #     #
######### # # # ##### #
#         # # #     # #
####### ### # # ### # #
#       # # # #   # # #
# ### # # # # # ##### #
# #   # #   # #     # #
####### # ### # # # ###
#       #   # # # #   #
####### # # ### # ### #
#   # # # #   # #   # #
### # # ### ### #######
#       #     #       #
#######################
