#######################
# # # # #             #
# # # # # ### #########
#           #       # #
##### # # ##### ##### #
#     # #     #       #
# # # ##### # ### # # #
# # #     # #   # # # #
# # # # # # ### ##### #
# # # # # #   # # #   #
# # ####### # # # ### #
# #       # # #   # # #
# # # ##### # # # # ###
# # #   # # # # #     #
# ### ### ### # ### ###
#   #       # #   #   #
### ###################
#                     #
### ####### # # # # ###
#         # # # # #   #
# ##### ##### #########
#     #     #         #
#######################
