#######################
#             #       #
# # # # # # # # # #####
# # # # # # #   #     #
### ### ### # # ##### #
#     # #   # #     # #
# # # # ### # ### # # #
# # # #   # #   # # # #
# # # # ############# #
# # # #             # #
# ### # ###############
#   # #       #   #   #
# # ### ##### # ### ###
# # #       #         #
# ##### # #############
#   #   #             #
# ### # # # # # # #####
#   # # # # # # #     #
# ### # # # # ### # ###
# #   # # # # #   #   #
# ######### ### # # ###
#         # #   # #   #
#######################
