#######################
# #       #   #       #
# ##### ### ### ##### #
#     #   # # #     # #
# ##### ### # # ##### #
#       #   # #   # # #
# # ##### ### # ### ###
# #               # # #
# ######### ####### # #
# #   #   #   # # #   #
# # ### # ### # # # ###
#       #   #         #
# ############# ##### #
#     #     #       # #
# # ### ####### # ### #
# #           # #   # #
# # # # # ######### # #
# # # # # #       # # #
# # ##### # ##### # # #
# #   #         # # # #
# # # ### ##### ### # #
# # #   #   #     # # #
#######################
