#######################
#   # # #       #     #
### # # ####### # #####
# # # # # # # #     # #
# # # # # # # ##### # #
# # #     # # # #     #
# # # ##### # # # #####
#       #   # #   #   #
### ### ### # # ### ###
# # #   # # #   # #   #
# ##### # # # ### # ###
#     #       #       #
##### ####### # ### ###
#       # #   #   # # #
# # ### # ### ##### # #
# # #               # #
# ####### ####### # # #
# #         # #   #   #
# ########### ####### #
# # #     #       #   #
# # ##### ####### # # #
# #                 # #
#######################
