#######################
#   #                 #
### ##### ### ####### #
#           #       # #
######### # ######### #
# # # #   #   #     # #
# # # ### ##### ##### #
# # #           #   # #
# # ####### ##### #####
# # # #         #     #
# # # # ######### #####
#   #                 #
### ##### # # ### # ###
#         # # #   #   #
# # # # # ### ### # # #
# # # # # #     # # # #
# # ##### # # # ##### #
# #     # # # #   #   #
# # # ##### # # # # # #
# # #   #   # # # # # #
### # ### ##### # #####
#   #   #     # #     #
#######################
