#######################
# # #       #   # #   #
# # ####### ### # ### #
# #       # # # #   # #
# ####### # # # # ### #
# # #     # # #     # #
# # ##### # # # ##### #
# #   # # #           #
# ### # # ### ### #####
# #             #     #
# ### ##### # ### ### #
#     #     #   #   # #
########### # # # ### #
#           # # # # # #
# ##### ### # # # # ###
#   # # # # # # #     #
# ### ### ### # ### ###
# #           #   #   #
####### ##### # # #####
#       #     # #     #
# ##### # # # # # #####
# #     # # # # #     #
#######################
