#######################
#       #     #     # #
####### ##### ### ### #
# # # #   # #       # #
# # # ### # ####### # #
# #         # #     # #
# ####### # # ##### # #
#         # #   # # # #
# ######### ### # # # #
# #   # # # #   # # # #
##### # # # ### # # # #
# #         #       # #
# ### ##### ##### # # #
#     # #         #   #
# ##### ##### # # # ###
#   #         # # #   #
### ####### # # # ### #
# # # #     # # #   # #
# ### # # # # # # # ###
#       # # # # # #   #
### ### ### # # # ### #
#   #     # # # #   # #
#######################
