#######################
# #     # #           #
# # ### # # ##### #####
# #   # #     # #   # #
# # ##### ##### ##### #
# # #   #         #   #
# # # ##### ######### #
# # # #     #     #   #
# # # # # ### ##### ###
# # # # #     #       #
# # # # ##### # #######
# # #     # #         #
# # # ##### ###########
#         # # #   # # #
# ### # ### # # ### # #
# #   #       #   #   #
# ####### # ##### # ###
#     #   #   #       #
# ##### # # ##### #####
#     # # #   # #     #
# # ### # # ### # #####
# # #   # #           #
#######################
