#######################
# #             #     #
# ### ##### # ##### # #
#     #     #   #   # #
# ### ### # ##### #####
#   #   # #       #   #
# ####### # ####### ###
# #       #     #     #
# # ### ##### ### #####
# #   # #       #     #
### ### # ### ### # # #
#   #   # #       # # #
########### # # ##### #
#           # # #     #
# ####### # # ##### # #
# #       # #     # # #
### ### # ### ### # # #
#   #   #   #   # # # #
# ####### # # ##### ###
# #       # #   # # # #
# # # ### # ### # ### #
# # # #   #   #       #
#######################
