#######################
# # #   #   # #       #
# # # # # ### ### # # #
#   # #       #   # # #
### # ### ### ### # # #
#     #   #       # # #
### ######### # ### # #
# # #         #   # # #
# ########### # # #####
#     # # #   # #     #
##### # # ### ### # # #
#       # #     # # # #
##### # # # # # ### # #
# #   #     # #   # # #
# ##### ### ### # ### #
#         #   # #   # #
# # ######### ####### #
# #       #   #       #
# # # # # ##### ##### #
# # # # # #     #     #
### # # ########### # #
#   # #   #         # #
#######################
