#######################
# #   # # #   #       #
# # # # # ### ##### # #
#   #   # # #   #   # #
####### # # # ##### ###
# # # #     # # # # # #
# # # ##### # # # # # #
# #   #     #       # #
# # ##### # ### ##### #
# #   # # #     #   # #
# # # # ####### # ### #
# # #     # # #     # #
# ####### # # # # ### #
#     #   #     #     #
# # # ### ##### ##### #
# # #             #   #
# ### # # # # # #######
# #   # # # # #       #
# # ### # # # # ##### #
# # #   # # # #     # #
# ##### ### # # # ### #
# #     #   # # # #   #
#######################
