#######################
# #           #   #   #
# ####### ####### ### #
#       # # #   # #   #
##### # # # ### # # ###
#     # #     # #     #
####### ##### # # ### #
#       # #         # #
##### # # ##### ##### #
#     #             # #
### # ##### # # ##### #
#   #   #   # #   #   #
# ### ### # # # ##### #
# #   #   # # #   #   #
### # # ### # # ### # #
#   # # # # # # # # # #
######### ### # # #####
# #   #   #   #       #
# ### # # ### # # # ###
#     # # #   # # #   #
# # # # # # ##### # # #
# # #   #     #   # # #
#######################
