#######################
#     #     #         #
##### ##### # ### # # #
# # #   #   #   # # # #
# # ### ### # # ### # #
#       # #   #   # # #
####### # # ##### # # #
#               # # # #
######### # ###########
#         #       # # #
### ### ### # ### # # #
#   #     # #   #     #
##### # # ### # # #####
#     # # #   # #     #
# # # ######### ### ###
# # #     #       #   #
### ######### ### # # #
#       # #   # # # # #
# # ### # # # # # # # #
# #   #   # #   # # # #
##### # ### # # ##### #
#     # #   # #     # #
#######################
