#######################
#       #           # #
# # ### ######### ### #
# # #       # #   # # #
# # # # # # # ### # # #
# # # # # #           #
# ### ##### ### ### ###
#   # #   # #   #     #
# ### # ### # # # ### #
# #       # # # #   # #
# # # ######### # # # #
# # #   #       # # # #
# ### # ####### ### # #
# #   #   # #   #   # #
##### # # # ####### ###
#     # # #           #
# # # # ####### # ### #
# # # #   #   # #   # #
# # # # ### ##### # # #
# # # #   #       # # #
### ### ####### ### # #
#   #   #         # # #
#######################
