#######################
#     # #     #   #   #
# # ### ##### # ##### #
# # # #   # #     # # #
### # # ### ### ### # #
#               # #   #
##### # ####### # ### #
#   # # #   # # # # # #
# # # ##### # # # # # #
# #   #     #     # # #
########### ##### # # #
# #   # # # # # # # # #
# ### # # # # # # # # #
#     #     #   # # # #
##### ### ##### # # # #
#   # #   #   # #   # #
### # ### ### # ### # #
#           # # # #   #
########### # # # ### #
#     # # #   # #     #
# # ### # # ### # #####
# #                   #
#######################
