#######################
# #   # #             #
# ### # # ### ### # # #
#       # #     # # # #
####### ### # ### ### #
#           #   #   # #
# # # ### ### ##### ###
# # # #   #       #   #
### ####### # ### # # #
#   #       #   # # # #
### # # ### ### ### ###
#   # #   # #   #     #
# # ####### ##### # # #
# #   #       #   # # #
# # ####### ######### #
# # #           #     #
### ##### ### ### # # #
#   #       # # # # # #
# # ##### # ### ### ###
# # #     #   #       #
# ####### ##### ### ###
#   #     #     #     #
#######################
