#######################
#   # #           # # #
# # # ########### # # #
# #   #   # # # # # # #
# ####### # # # # # # #
#   # # # #           #
# ### # # ####### ### #
# #     # #   # #   # #
# # ##### # ### # #####
# # #         # # # # #
# # ### ##### # # # # #
#   # # # # #         #
# # # ### # ### ##### #
# #       # #   #   # #
### ##### # ### # ### #
#   #     #         # #
######### ##### #######
#                     #
####### # ##### ### ###
# #     # #       # # #
# ##### ####### ### # #
#       #         #   #
#######################
