#######################
# #   # #     # # # # #
# ### # # ##### # # # #
# # # # # #       #   #
# # # # # # ####### ###
# #         #   # #   #
# ### ####### ### ### #
# # # #       # # # # #
# # # # ####### # # # #
#   # # #   #     #   #
### # # # ### ####### #
# #     # #     #   # #
# ##### # # ####### # #
#   # # #       # #   #
### # # ### ##### # ###
#     #   # #   #   # #
##### # ### # ##### # #
#             # # #   #
####### # # ### # # ###
#       # #       #   #
### ### ### ######### #
#   #   #             #
#######################
