#######################
#                     #
# ### # ##### # ##### #
#   # #   #   #     # #
# # # ### # # # ##### #
# # #   # # # #   #   #
##### ### # ### ##### #
#     #   #   # #     #
##### ##### ### ### # #
#     #       #   # # #
# # # ##### # # ##### #
# # # #     # #   #   #
# # # # # # ### ### ###
# # # # # #   #   #   #
# ### ### # # # ##### #
# #   #   # # # #   # #
# # ######### ### # # #
# #       #       # # #
### # ##### ### # # ###
# # #     # # # # #   #
# ######### # ##### ###
#               #     #
#######################
