#######################
#   # # #       # #   #
### # # ####### # # ###
# #   # # #       #   #
# # ### # ####### ### #
#   #   # # #       # #
# # ### # # # # # ### #
# # #     #   # #     #
### ##### ### ##### ###
# #   # #     #       #
# ### # ########### # #
# #   #             # #
# ### ### ######### # #
#       # #         # #
### ### ####### # #####
#   #         # #     #
############# ### # ###
# # # # #   # # # #   #
# # # # ### # # # # # #
#   # #           # # #
# # # # # ##### # ### #
# #     # #     #   # #
#######################
