#######################
#     #               #
# ### # ###############
#   #     # #   # # # #
##### ##### # ### # # #
#         #           #
##### ##### ##### # ###
#               # #   #
##### # ### # # # # # #
#     #   # # # # # # #
# ### # ########### ###
# #   #       # #     #
# ### ######### ### # #
# #     #     #   # # #
# # # ### ##### ### # #
# # #             # # #
# # # # ### # # ##### #
# # # #   # # #     # #
### # # ##### ##### # #
#   # # #         # # #
# ### # ##### # # # ###
# #   #   #   # # #   #
#######################
