#######################
# #       #   # # #   #
# ####### ### # # # ###
# # # # # #   #   # # #
# # # # # # # ### # # #
#   #       #       # #
# ####### ####### ### #
#     # # # #       # #
##### # # # # ####### #
# # #   #   # #   #   #
# # # ####### # # # ###
#   # # # #     # #   #
### # # # ### ##### ###
# # # #   # # # # # # #
# # # ### # # # # # # #
# # # #         #   # #
# # # ##### ### ### # #
#   #   # # #   # #   #
### ### # ### ### # ###
#   #           #   # #
### ######### # # ### #
#             #       #
#######################
