#######################
#                 #   #
# # ### ########### ###
# # #   # #     #     #
####### # # ### # # ###
#             #   # # #
### ####### ######### #
#   #                 #
# # ### # # ### ##### #
# # #   # #   #   #   #
### # ### # ### # # ###
#   # #   # #   # #   #
# # # # ### # # ### # #
# # # # #   # # #   # #
### # ### ### # # # ###
#   #   # # # # # #   #
### # # ### ### # # # #
# # # # #     # # # # #
# ##### # # ####### # #
#         # #     # # #
### ### ### # ##### ###
#     #   #       #   #
#######################
