#######################
#       # # # #       #
# ### ### # # # # #####
# # # # # #   # # #   #
# # # # # ### # ### ###
#   #     # # #   #   #
# ######### # # ### ###
#     # #       # # # #
##### # # ####### # # #
#   #     #       #   #
### # ##### ### ##### #
#       #     #   #   #
# # ##### # # # ### # #
# #   #   # # #   # # #
# ##### ########### ###
# #       #     # #   #
# # ####### ### # # ###
# #     #   # # #     #
# # ##### ### ### # # #
# # #   #         # # #
# # # ### # ######### #
#         #         # #
#######################
