#######################
# #   #   #   # #     #
# # # ### ### # ### ###
#   #     # #         #
# ##### # # ##### ### #
# #     #   #     #   #
# # ### # # # # # # # #
# # #   # #   # # # # #
########### # # # ### #
#           # # #   # #
# ##### ### ### # # # #
# # #   #   #   # # # #
# # # ##### # ####### #
# #       # #     #   #
### # # ##### # ##### #
#   # # #     #   #   #
### ##### # # # ##### #
# #   #   # # # #     #
# # # ####### # # ### #
#   #   #     # # #   #
### ##### # ### ### ###
#     #   #   # #     #
#######################
