#######################
#         # # #       #
# ######### # # #######
#       # #   # #     #
### ##### # ### # #####
# # # #       #   #   #
# # # # ####### ##### #
#   #   #   # #       #
# ### ### ### # #######
# #   # #       #     #
# # ### # ####### #####
# # #   # #   #       #
# # # ### # ### ### # #
#               #   # #
### # # ### ### #######
# # # #   #   #   #   #
# # ######### # # # # #
#           # # #   # #
# ### ######### # # # #
# #           # # # # #
### ####### ######### #
#         #         # #
#######################
