#######################
#   #   #           # #
### ### ####### ### # #
#   #   # # #   # # # #
# ##### # # ##### # # #
# #   # # #     # # # #
# ### # # ##### # # # #
#   #   # #           #
# # ### # ######### # #
# # # # #         # # #
### # # # ####### ### #
# # #     # # # #     #
# # ### ### # # ### # #
# # # # #   #   # # # #
# # # ##### # ### ### #
# # #   # #           #
# # ### # ### ### ### #
#     #       #   # # #
##### ### ### ### # ###
#           #   #     #
####### ### ### ### ###
#       #   #     #   #
#######################
