#######################
# #     #       #   # #
# ##### # ### ### # # #
#     # # # # # # # # #
##### # # # ### # # # #
# #   #   # # # # #   #
# ### ### # # # ##### #
#     # #   # #     # #
##### # ### # ##### # #
# # # #   #       #   #
# # # # ##### ####### #
#   #   #       #   # #
# ##### ##### ##### # #
#       # # # #   #   #
##### ### # # ### ### #
#       #   # #       #
# ####### ### # #######
# #     #   # #       #
# # ##### ### # ### # #
# # #   #     #   # # #
# # # ### ##### # # # #
#               # # # #
#######################
