#######################
#     #     #         #
# ### ### ### # # # ###
# #         # # # #   #
# ##### ### # ##### # #
# #       # #     # # #
# # ### ####### #######
# # #   #     #       #
####### ### ### ##### #
#   #   #     #     # #
### ### # ##### ### # #
# #   #   #     # # # #
# ### ### # # ### #####
#   # #     #       # #
# # # ### ##### ##### #
# # #         #       #
# # ### # # # # #######
# #     # # # # #     #
### # # # # # ####### #
#   # # # # # # #   # #
######### ##### # # # #
#                 #   #
#######################
