#######################
#   #     #           #
# ##### ############# #
#   # # #     # #     #
### # # ##### # ### # #
# #   # #     # #   # #
# # ### # ### # ### ###
#   #   # #       # # #
# ### ########### # # #
#     # #   #     # # #
##### # # ##### ### # #
# # # #   #   #       #
# # # ### ### ##### ###
#   # #     # #   #   #
# # # ### ### ### # ###
# #     # #     #   # #
####### # ### ##### # #
# # #                 #
# # ### # # # ### ### #
#     # # # #   #   # #
# ### # ### # ### ### #
# #       # #   #   # #
#######################
