#######################
#   #     # #     #   #
### ### # # ##### ### #
# # # # # # #   #     #
# # # ### # ### # #####
# #   #       # # # # #
# ### # ##### # # # # #
# # #   # #   #   # # #
# # ##### ### ### # # #
#   # # # #     #     #
# ### # # ##### # #####
# #                   #
# # ########### ### # #
# # #       #     # # #
# # # ##### # # # # ###
#   # #   #   # # #   #
######### ### # # # ###
#             # # #   #
# ### ### # # # # ### #
#   # # # # # # # # # #
####### # ######### # #
#         #           #
#######################
