#######################
#   #     #         # #
### ### # # ### ### # #
# # # # # # #     # # #
# # # ### # # # ##### #
#     #     # # # #   #
# ### # ######### # ###
# # # #           #   #
### # # ### ##### # ###
#       #     # #     #
### ######### # #######
#       # # #   #   # #
### ##### # # # # ### #
#         # # # # #   #
### ### ### # ### # ###
#   #       #   #   # #
### # # # # ##### ### #
#   # # # #           #
# ########### #########
# # #             #   #
### ##### # ##### # ###
#         # #         #
#######################
