#######################
#         #           #
### ##### ##### ##### #
#   #   #   #       # #
# ##### ### # #########
# # #     #   # #   # #
### ### # # # # ### # #
#     # # # # # #   # #
##### ### # ### # ### #
#     # #   #   #   # #
# ##### ### ### # ### #
# # #     # # #   # # #
# # ##### # # # ### # #
# #   #   #       #   #
# ### # # # # ##### ###
#       #   #   # #   #
# ############# # # ###
# # # # #         # # #
### # # ### # # ### # #
#           # # # #   #
# ######### ### # ### #
# #         #         #
#######################
