#######################
# #   #           # # #
# ### # ####### # # # #
#             # # #   #
### # ### ### ##### ###
#   #   #   #         #
##### # ##### ####### #
#     #     #     #   #
# # ### ### ### # # # #
# # #     #   # # # # #
### # # ### # ### # # #
#   # #   # # #   # # #
##### # # # # ##### ###
#     # # # #     #   #
# ### # # ### # #######
# #   # # #   #       #
# # # # ##### ##### # #
# # # #     #     # # #
# # # # # ### # # ### #
# # # # # #   # #   # #
# # # ##### ### ### ###
# # #   #     # #     #
#######################
