#######################
# #           #       #
# ### ##### ### #######
#         # #   # #   #
### # ##### # ### ### #
#   #     #           #
# # ### # # # ####### #
# #   # # # #       # #
# ### ### # ###########
# #   #   #           #
# # ############# #####
# # #           #     #
# ### ### ########### #
#     # #           # #
### # # # # # ### ### #
#   #   # # #   # #   #
# ### # ####### # # ###
# #   #   #   # # #   #
# # ### # # ### ##### #
# # #   #   # #   # # #
### # # # # # # ### # #
#   # # # #   #     # #
#######################
