#######################
#   # # #   # #   #   #
# ### # # ### # # # # #
#   # #       # # # # #
# ### # ####### ##### #
#     #           # # #
# ### # ########### # #
# #                 # #
# ##### ### # ##### # #
# #       # #     # # #
# ####### # # ####### #
#     #   # # # #   # #
# # # ##### ### # ### #
# # #     #           #
# ### # ### ### ### ###
# #   #   #   # #     #
# ####### # ##### ### #
#     #   #     #   # #
# ### ############# # #
#   #   #     # # # # #
### ### # ##### # ### #
#     #             # #
#######################
