#######################
#     #     # #       #
##### # ##### # #######
#     #       #     # #
# # # # ##### # ### # #
# # #   #   #   #     #
# ##### # ####### # # #
# #     # # #   # # # #
# ##### # # # # ##### #
# #     # #   # # #   #
####### # # ##### #####
#           #     #   #
### # ### ####### # # #
#   # #         #   # #
####### # ####### # ###
# # # # #   #     #   #
# # # ### # # #########
#         #     #   # #
# ##### ### # # # ### #
# #       # # #       #
##### ##### ### ### ###
#       #     #   #   #
#######################
