#######################
#   #   # #     # #   #
# ### ### ##### # ### #
#     # #   #     #   #
### ### # ### ####### #
# #     # #       #   #
# ##### # # ######### #
#   #     #   # # # # #
# # ##### # ### # # # #
# # #           # #   #
# ######### ##### ### #
# #   #   #         # #
# # ### # # ### # ### #
#   #   #     # #   # #
### # # # # # ##### # #
#     # # # #   # # # #
##### ### # ##### # # #
# #     # #   # #     #
# ### ####### # ##### #
#         #   #     # #
##### # ####### # # # #
#     #   #     # #   #
#######################
