#######################
# # #               # #
# # ### ########### # #
#   # #       #   #   #
# # # # # ### ### #####
# #     #   # #     # #
##### ##### ### ##### #
#   #   # #     #   # #
### # ### ##### # # # #
# #   #   # # # # #   #
# # ### ### # ##### ###
#     #     # #       #
### ### ##### # ##### #
# # #       # #   #   #
# # # ### ### # #######
#   # # #   #       # #
### # # ### # ####### #
# # # # # #           #
# # # # # ########### #
#   # #     # #   # # #
# # # ### ### # ### # #
# #                 # #
#######################
