#######################
#           # #       #
### ####### # ### # # #
#   #   #     #   # # #
# ### ######### ### ###
#         #       # # #
# ########### # ##### #
#     #   #   #       #
# ### # ##### ##### ###
#   #             #   #
# ####### ######### # #
#       #       # # # #
# ##### # # ##### ### #
#     # # #       #   #
# ### ########### ### #
#   #       #   #   # #
### ### ### # ### ### #
#     #   # # # # # # #
##### ####### # ### # #
# #     #         # # #
# # ##### # ####### # #
#         #       #   #
#######################
