#######################
#       # # # #       #
# ### # # # # # ### ###
# #   #         # # # #
### ##### # # ### # # #
#       # # # #       #
# # ############### ###
# # #   #             #
# ##### ##### # ##### #
# #   #       #   #   #
# # # # # # ####### # #
# # # # # #   #     # #
# ### # # ##### # # # #
# #     # #     # # # #
# ######### ####### # #
# #         #       # #
### # ### ##### ##### #
# # #   # #         # #
# ##### ##### ##### # #
#         # # #     # #
# ### ### # ######### #
# #   #           #   #
#######################
