#######################
#           #   # # # #
### ### ### # ### # # #
#   #   #   #   #     #
# ####### # # # ### ###
# # #     #   # #     #
### ### ####### # # # #
# # #   #         # # #
# # # # ######### ### #
# #   # # # #       # #
# ####### # # # # #####
#     #   #   # #   # #
# ### ### # ### # ### #
# # #       #   #     #
# # ##### ####### ### #
#   #     # # #   #   #
########### # ### ### #
# #               #   #
# # ####### ##### # # #
#   # # #     #   # # #
# ### # # ########### #
#   #       #         #
#######################
