#######################
# #             #     #
# ##### # ####### #####
#     # #     #       #
# ### ### ##### ##### #
# #       #         # #
# ### ### # # # # # # #
#   # #     # # # # # #
# ##### # ### # # # ###
# #     # #   # # #   #
### ### ### # # # ### #
#   #   #   # # #   # #
# ####### ### # ### ###
# #       #   # #   # #
# ####### ### # ##### #
# #     # #   #       #
### # # # # # ### # # #
# # # #   # # # # # # #
# # ####### # # # # # #
#   #     # # # # # # #
# # # # # # ### ### ###
# # # # #       #     #
#######################
