#######################
# #   #   # # #     # #
# # ##### # # # ##### #
# # # # #       #   # #
# # # # # # ####### # #
#     # # #   # # #   #
##### # ### ### # ### #
#   #   #       #     #
### ### # ##### # #####
#     # #     #     # #
##### # # ########### #
#               #     #
# ### ##### ##### #####
#   # #       #       #
####### ### ### # #####
#         #     # #   #
##### ### ### # # # # #
#   # #   #   # #   # #
### # # # ##### ### # #
#     # # # # #   # # #
# ####### # # ####### #
# #       #           #
#######################
