#######################
#   #     #   #       #
### # # ### ######### #
# # # #     #   #     #
# # # ####### # # #####
# #   #     # # # #   #
# # ### ### # ### ### #
#   # # # #       #   #
# ### # # ##### ### ###
#   # # #   #   #     #
# ### # # # ##### #####
# # # # # #           #
# # # # # ### ### # ###
#   #   # # #   # #   #
# # # ### # ##### #####
# #       #     #     #
# # # ##### ####### ###
# # #     # #     #   #
# ### ##### # ### ### #
# #         #   # #   #
# ##### # ### ### # ###
# #     #     #   #   #
#######################
