#######################
#   # # #           # #
# ### # ####### ### # #
# #               #   #
# ######### ### #######
#           # #   # # #
# # ####### # # ### # #
# #   #       # # #   #
# ########### ### # ###
#   #       # # # #   #
# ### ##### # # # # # #
# #   #           # # #
### ### ### ####### ###
# # # # #   #     #   #
# ### ##### # ##### # #
#       #       # # # #
# ##### ####### # ### #
# #       # #   # #   #
# ####### # # ### ### #
# #       #     #   # #
# ##### ####### # # # #
#   #             #   #
#######################
