#######################
#           #     #   #
# ####### ### # # # # #
#   # # #     # #   # #
### # # ### ### ### # #
#   #   #   # #   # # #
####### # ### #########
#     # #       #     #
##### # # # ##### ### #
#   #   # #       #   #
# ### # # ####### #####
# #   # # #   # # #   #
# ##### # ### # ### ###
#       # # #         #
####### # # # #########
#   #         # # # # #
### ##### ##### # # # #
#                     #
####### # ### ####### #
# #     # #         # #
# ### ### # # # # #####
#       # # # # #     #
#######################
