#######################
#         #   #     # #
######### ### # # # # #
#           #   # #   #
# # # # ### # # #######
# # # #   #   #   #   #
### # ### # # ##### # #
# # #   # # # #     # #
# # ##### ### # ### # #
#     #     #   # # # #
# ####### ####### # ###
#       #   #   # #   #
# ### ##### # ### # # #
#   #     #   #     # #
# # ### # ### ### # # #
# #   # #   # # # # # #
# ### # ##### # # # # #
#   # #   #   #   # # #
### ### ### # ##### # #
#   # # # # # # #   # #
# # # ### # # # # ### #
# # #       # #   #   #
#######################
