#######################
#       # #   #     # #
# ##### # # ### ### # #
# #               #   #
####### ####### # #####
# #   #   # #   #   # #
# # # ### # ##### # # #
#   #     #   #   # # #
### ######### ### ### #
# # #     #   #   # # #
# # # ### # # ### # # #
# # # # #   # #   # # #
# ### # ### ### ### # #
# # # #     #     #   #
# # ####### ##### # ###
#           #     # # #
########### ##### # # #
#         #       #   #
# # ##### ####### ### #
# # #   #           # #
# ### ########### # # #
# #               #   #
#######################
