#######################
#     #       #       #
# ##### # # # ####### #
# #   # # # #   #   # #
# # ### # ### ### ### #
#   #   # #   # #     #
# ##### ### ### # #####
# # # # # # #   # #   #
# # # # # ### ### # ###
# # #   # # # #       #
# # ### # # # # # # ###
#   # #         # #   #
# # # # ##### ####### #
# #         #     # # #
# ##### # # # # ### ###
# #   # # # # #       #
# ### # # # ### #######
#   #   # # #         #
##### # # ##### ##### #
#     # #     #   # # #
####### # ### # ### # #
#       # #   #     # #
#######################
