#######################
# #                 # #
# ##### ### ####### # #
# #     # # #     # # #
# ####### ##### # # # #
#     #   # #   #   # #
### # ### # ### ##### #
# # # #       #   #   #
# # # # ####### ### ###
#   #     #           #
##### ### # ####### ###
#     #     #   #     #
##### # # # # # ### ###
#     # # # # #       #
# ####### ####### # # #
#   #       #     # # #
############# ### # ###
#   #         #   #   #
# # ### # ##### # ### #
# #   # # # # # #   # #
# ######### # # ### # #
#               #   # #
#######################
