#######################
#     #   #         # #
# # # ### ### ### ### #
# # # # # #   # #   # #
##### # # ### # ##### #
#   # # # #       #   #
### # # # ### ### ### #
# #           # #   # #
# ######### ### ##### #
#     #         # #   #
##### # ### ##### # # #
#       #           # #
# # ##### # ######### #
# # #     #       #   #
# ### ### ######### # #
#   # #     #   #   # #
##### ### # # ### ### #
#     #   #     #   # #
##### # # # ##### # # #
# #   # # # #     # # #
# # ### ### ######### #
#     #   #   #       #
#######################
