#######################
#       #   #   #     #
####### # # ### ### # #
#   # #   #   #     # #
# ### # ######### ### #
# #   #     #       # #
# ### # ##### ##### # #
#           # #     # #
####### # ########### #
# #     #   # # # #   #
# ####### ### # # # # #
#   #   #         # # #
### # ### ######### # #
# #     # #   # #   # #
# # ##### # ### # ### #
# #         #   # # # #
# # ### ##### ### # ###
#     # # # # # #     #
# # ##### # # # ### ###
# # #   # #   #     # #
# ### ### # ### ##### #
#                     #
#######################
