#######################
#   #   # #       #   #
# # ### # ##### ##### #
# # # # # #     #   # #
# # # # # # ####### # #
# #   # # # #         #
# # ### # # # # ##### #
# #   # # # # #   # # #
##### # # # ##### # # #
# #       #     # #   #
# ##### ####### # #####
#   #       #   #     #
# # ### # # ### ### ###
# # # # # #           #
# # # ##### ##### # # #
# #       # # #   # # #
# # # ### ### # # # # #
# # #   #       # # # #
# ##### ##### ### #####
# #     #   # #       #
# ####### # ##### # ###
# #       #       #   #
#######################
