#######################
#     #           #   #
# ### ########### # # #
# #         #   # # # #
### ####### ### # # ###
# # #     #   #   #   #
# ### ### # ##### ### #
#   #   #     #     # #
# # ##### ### ##### # #
# # #       #       # #
### # ### ##### ### # #
#     #   #   # #     #
### ####### # ##### # #
# #   #     # #     # #
# ### # # ### # ### # #
#     # # #     #   # #
##### # ### # ####### #
#     # #   # #       #
# ########### ##### # #
# #   # #   # #     # #
# # # # # ### ##### ###
#   #     #   #       #
#######################
