#######################
#   #         #     # #
# ### ##### ### # # # #
#   # # # # #   # #   #
### ### # # # ### #####
# #     #     #     # #
# ### ### ####### ### #
# # #     # #         #
# # ####### ##### #####
# #                   #
# ################# ###
#         #     #     #
##### ##### # # # # # #
#   #   #   # #   # # #
# # # ### # # ### ### #
# # #     # #   #   # #
# ### ##### ### # ### #
#     #     #   # #   #
# ### ####### # ##### #
#   # # #   # #   #   #
####### # # ### # # ###
#         #     # #   #
#######################
