#######################
#   #   #   #     #   #
# ### # ### # # ### # #
#     #       #     # #
# ########### # ##### #
# # # # #     # # #   #
# # # # # ####### ### #
# # #   #   # #   # # #
### ### # ### # ### ###
# # # # # # # # #   # #
# # # # # # # # # ### #
#           # # #     #
# # ####### # # ##### #
# #       #       # # #
# ##### ########### # #
#   #         #       #
# ### # # ####### #####
#   # # #   #     #   #
# ##### ##### # ### ###
#   # #     # # #     #
### # ### # # # # ### #
#       # #   #   #   #
#######################
