#######################
#       #   #   # #   #
# ##### ### ### # # # #
# #   #   #     #   # #
##### # # ### ### #####
#     # # #   # #   # #
# ####### # ### # ### #
#       # #   # #   # #
# ### ### ### # ### # #
# # #   #   #   #   # #
# # # ##### # ### ### #
#   # #     #     #   #
# ### # ### ##### ### #
#   #   #   # #   # # #
# ######### # ### # # #
#   # #     # #     # #
##### ##### # ##### # #
#   #     #     #     #
# ####### # ####### ###
# #     #   # #       #
# ### # # # # ### #####
#     #   #           #
#######################
