#######################
#     #           # # #
# # ######### ##### # #
# #   #   # # #       #
##### ### # # # #######
#     # #     #   # # #
# ##### ##### # ### # #
# #             # # # #
# ############# # # # #
#       #         # # #
# ##### # ##### ### # #
# #     # #   #   #   #
### ### ### # ### ### #
#   #       # #   #   #
# ######### # ### # ###
# # #   #   #         #
### # # # ####### # # #
#     #   # # #   # # #
# # ####### # ##### # #
# #   # #   #   #   # #
# ##### ### ### ### ###
#     #               #
#######################
