#######################
#       #     # #     #
##### ##### ### # ### #
#   #   # #       #   #
### # ### ### ### #####
#   #   #       #     #
# ### # ### ####### ###
#     #     # # #     #
##### ####### # ##### #
#       #         # # #
# # # ### ######### ###
# # #                 #
# # # # # ### # ##### #
# # # # #   # #   #   #
# # # # # ####### #####
# # # # #       #   # #
# ##### # ##### ### # #
#     # #     #   #   #
# ### ### # # ####### #
# # #   # # # #       #
# # ### ### ###########
#     # #             #
#######################
