#######################
#   # #     #         #
# # # ##### # ##### # #
# #   #   #   # # # # #
# ### # ####### # ### #
# #         # # #     #
########### # # # ### #
#                 #   #
##### # ########### # #
#   # # #           # #
# ### ### ### ####### #
#       # #     #     #
####### # ##### # ### #
#     # # #     # #   #
# # ####### ### ##### #
# #   #   # #       # #
# ### ### ### # ### ###
#   # #   # # # #   # #
# # # ### # ##### ### #
# # #       #   # #   #
##### ##### ### # ### #
#     #               #
#######################
