#######################
#     #               #
# ##### ### ##### ### #
#   # # #   #   # #   #
### # # # ##### # ### #
#     # # #       # # #
##### ######### ### # #
#     #     # # #     #
##### # ### # ####### #
#         # #       # #
####### # # ####### # #
#   #   # #           #
# # # # ### ##### ### #
# #   #   # #     #   #
### ### # ### ### ### #
#     # # #   #   #   #
# ### ############# ###
#   #   #           # #
# ### ### ##### # # # #
# #   #   # #   # # # #
### ### ### ##### # # #
#   #   #         #   #
#######################
