#######################
#     # #     #       #
# ### # ### ### ##### #
# #   #   # # #     # #
# ### ### # # # # ### #
#   #           #   # #
####### ##### # #######
#       #     #   #   #
####### ##### ##### ###
#       #       # # # #
# ##### ##### ### # # #
# # #   #           # #
# # # # ### ### ##### #
# #   # #   #         #
# ##### ##### ####### #
# #     #           # #
# ####### ### # #######
# #       #   #   #   #
### ##### ### ### # # #
#   #   #   #   # # # #
# ##### ### ### ### # #
# #         #       # #
#######################
