#######################
#   # #   #           #
# ### ### # ##### # ###
# #   # #     #   #   #
# # # # ### ### #######
#   # #     # #     # #
##### ##### # ####### #
# #   #   #     #     #
# # ##### # ##### #####
#       #     # #   # #
# # # # # ### # # ### #
# # # #     # #   #   #
### # # # ### # # # # #
# # # # # #   # #   # #
# # ### ### ### ##### #
#   #   #       #   # #
# ### ### ### ### # # #
# #   #   #       # # #
# ########### ####### #
#     #   #   #       #
# ####### ####### # ###
# #               #   #
#######################
