#######################
#   #   #   #         #
# # ### # ### ####### #
# # #   #   #     #   #
# ##### ### # ##### ###
# #       # #   #   # #
# ####### # # ####### #
#   #         #   #   #
### # ### ##### # # # #
# #   #     #   #   # #
# ####### # # ### #####
# #       #     #     #
# ##### ### # ####### #
# #   # #   #     #   #
# # # ### ### ### #####
#   #     #   # #     #
####### ### ### # ### #
#       #     # #   # #
# ####### ### # # # # #
# #         # #   # # #
# ##### ### # ####### #
#     #   # #     #   #
#######################
