#######################
#   #       #         #
# # # ### ####### # # #
# # #   # # #     # # #
### # ### # ####### ###
#   # #       #   # # #
# # ##### # ##### # # #
# # # #   # # #       #
# ### ##### # ####### #
#   # # #       # # # #
### # # ##### ### # # #
# #         # # # #   #
# ##### # ### # # ### #
#     # # # # # #     #
# ### # # # # # ### ###
#   #   # # # # # #   #
######### # # # # # ###
#             #       #
### ##### ### # #######
# # #     #           #
# ### ### ##### # #####
#     #   #     #     #
#######################
