#######################
#                   # #
##### ##### ####### # #
#   # #   # #     #   #
# ### # # # # ####### #
# #   # #           # #
# ##### ###############
# # #   #   # # #     #
# # ### # ### # # ### #
# # #   #     # #   # #
# # # # ##### # # # # #
#     #   #   # # # # #
### ####### ### ### ###
#   # # # #   # #   # #
# ### # # # ### ### # #
# #       # #     # # #
# # ### ### # ##### # #
# # #   #             #
# ##### # ##### #######
# #       #   #     # #
# # # # # # # ### ### #
#   # # #   #   #     #
#######################
