#######################
#               #     #
### ####### ### # #####
#   #     #   #     # #
# # # ##### # # # ### #
# # #       # # #     #
# # ######### # # # ###
# # #         # # #   #
# ##### # # # # # # ###
#   #   # # # # # # # #
### ### # # # ##### # #
#     # # # # #   # # #
########### ### # # # #
# # #         # #     #
# # # ##### ### # #####
#     # #   #   #   # #
# ### # ### # ### ### #
#   # #     #   # #   #
### ##### ### # ##### #
# # #   # # # # # # # #
# # ### # # ### # # # #
#     #     #         #
#######################
