#######################
#         #     #     #
# ####### # ##### ### #
#   #   #   #     # # #
# ### ######### ### # #
#     #         #   # #
# # ### # ####### #####
# #     #     #     # #
# ####### ### ### ### #
#     # # #       #   #
# # ### # # ##### # ###
# #     # #     #     #
# # ####### ### ##### #
# #   #       #     # #
# # ######### ##### ###
# #   # # # #   # #   #
# ##### # # # ### #####
#   #   #           # #
# # ### ######### # # #
# #   #   #   #   #   #
# ### # ### ##### #####
# #             #     #
#######################
