#######################
#     #         #     #
# ### # ##### # ##### #
# # #   # # # #     # #
# # ### # # # ### ### #
# #   # #   # # #   # #
# ### ### ### # ### # #
# #       #   # # #   #
# # ##### ##### # ### #
# #   # # #     #     #
# ### # ### ###########
# #   #   # # #       #
# # ### ### # ####### #
# #   # # # # #   #   #
# # ### # # # # # ### #
#         #     # #   #
# ############# # # # #
#     #         #   # #
# ### # ####### ##### #
#   # #   #     # # # #
### # # ##### ### # # #
#   #       #     #   #
#######################
