#######################
#   #       #     #   #
# # # # # # # ### ### #
# # # # # # # # # # # #
# ### ####### # # # # #
# # #       #   # #   #
# # # ##### # ### ### #
#   # #       # # #   #
### ##### ##### ### ###
# #   #   #   #   #   #
# ### # # # ##### # # #
#   #   # # #     # # #
# ####### # ##### # # #
#     # # #   #   # # #
# # # # # ### # ### # #
# # #       # # # # # #
# # ####### # # # # ###
# # # # # # # # # #   #
# ### # # # # # # ### #
#   #     #           #
### ##### ######### # #
#   #               # #
#######################
