#######################
#   #             #   #
# # # ##### # ### ### #
# #   #   # # # #     #
####### # # ### ### # #
#       #   # #     # #
### ### # ### ### ### #
#   # # # # # #   # # #
### # ##### # ### # # #
#   # #     #     #   #
# ### ##### ### # ### #
#   # #         #   # #
##### # # ######### # #
#     # # #     #   # #
##### ### ### # # # ###
#         #   #   # # #
# # # ##### # ### # # #
# # # #   # # # # #   #
# # # ### ##### # ### #
# # #   #           # #
####### ######### # # #
#       #         # # #
#######################
