#######################
#         #   # #   # #
# ######### ### ### # #
# # #   # # #   #   # #
# # ### # # ### # ### #
#   # # #             #
### # # ####### # ### #
#   #     #     #   # #
# ##### # # # # # # # #
# #   # #   # # # # # #
# # # # ### # # ### ###
#   #   #   # #   #   #
# ##### # ### ##### ###
# #     # # #   #     #
########### # ### ### #
#       #       #   # #
# ### # # # # ##### # #
# # # #   # # #     # #
### # ### ### ##### # #
# # # #   #     # # # #
# # ### ### # # # # ###
#         # # # #     #
#######################
