#######################
#             #       #
# # ##### # ##### ### #
# #   #   #     #   # #
# ##### ####### ##### #
# #   # #             #
# # # ######### # #####
# # #         # #     #
### ######### ### # # #
#   #     #     # # # #
# # # # # ##### ##### #
# # # # #   # #     # #
# ##### ### # ##### # #
#   #   # #     #     #
####### # ### # ### ###
# #   #   #   #       #
# ### # ######### # ###
# #   # #     # # # # #
# # ### ##### # ### # #
# #     #     #       #
# ####### ### ### ### #
#         #         # #
#######################
