#######################
#   #     #         # #
# # # ####### ##### # #
# #   #       #   #   #
### ##### # # # # #####
# #   # # # #   # # # #
# # ### # # ####### # #
# #     # #     #     #
# ##### ### # ### #####
# # #   #   # #   #   #
# # ### ### ### ##### #
#     #   # # #       #
# ##### # # # # # #####
#     # #   #   #     #
# # ### ### ### #######
# # # # # #         # #
### # # # # # ##### # #
#   # # # # #     #   #
# ### # # ##### # ### #
#   #   # #   # # #   #
# ### # # # # #########
#     #     #         #
#######################
