#######################
#   # #   #       #   #
# # # # # ####### ### #
# # #   #     #   # # #
### ######### # # # # #
#   #     #     #     #
# ### ##### ##### ### #
#   # #     #       # #
### # ### # ### ### ###
#   #     # #   #     #
# ############# # # # #
#     #         # # # #
##### ##### # # # ### #
#           # # #   # #
# # ##### ### ####### #
# # # # # #   #       #
# # # # ### # # ### ###
# #   #     # # #     #
# # ### ####### ##### #
# # #   #   #   #   # #
### # ### ### ##### # #
#   #     #       #   #
#######################
