#######################
#   #     #   #   #   #
### # ##### # ### ### #
#   # #     #   # #   #
### # ##### ### # ### #
#   # # #   # #       #
### # # ##### # #######
# # #   #       #     #
# # # ### ### ##### # #
# # #   # # #   #   # #
# # ### # # # # # ### #
#       # # # #   # # #
### ##### # ##### # ###
#   # # # # #   #     #
### # # # # # ##### ###
# #   #           #   #
# # # ### ####### ### #
# # #   # # #   #   # #
# # ##### # ### #######
#   #   #     # #     #
### # ### ### # # #####
#           #         #
#######################
