#######################
#     #         # #   #
# ##### ####### # ### #
# #     # #     # #   #
# ####### ### ### # # #
#   # # # #   #     # #
### # # # # ### ### ###
# # # #     # # #     #
# # # # ### # # ##### #
#       #     # #   # #
# ### # # ### # # #####
#   # # # #   #   #   #
# ### ##### # # ### ###
#   # #     #     # # #
# ############### # # #
# #           # # #   #
# ### ####### # # # ###
# #   #   # #     #   #
# ####### # # # # ### #
# #     # #   # #   # #
##### # # ##### ### # #
#     #           #   #
#######################
