#######################
#               #   # #
# ### ### ##### # # # #
# #     #   #     #   #
# ##### ### ###########
# #   # # # # # #     #
##### ### # # # ### ###
#     #   # #       # #
##### # # # # # ##### #
#   #   # #   #       #
# ####### # ### # #####
#           #   #     #
# # ### ######### #####
# #   # #       #   # #
# # ### # ####### ### #
# #   #     #     #   #
### ##### # ####### # #
# #   #   #   # # # # #
# ### ### ##### # # ###
# # #   #       #   # #
# # ### # ####### # # #
#       #         #   #
#######################
