#######################
#       #       # #   #
# # ### ####### # # # #
# # # #             # #
### # ##### ### # # # #
# # #   #     # # # # #
# # # # # # # # # ### #
#   # #   # # # # # # #
# ##### # ### # ### # #
#   #   #   # #     # #
### # # ### ### ##### #
#   # #   #   #   # # #
# ### # ##### ### # # #
# # # # #   # #   # # #
### ### ### ####### # #
# #               #   #
# # ############# # # #
#       #       # # # #
# ##### ### ######### #
# #   #   #   #     # #
# # # ##### # # ### # #
#   #   #   #     #   #
#######################
