#######################
# # #             #   #
# # ####### ####### ###
# #   #       #     # #
# ### ### ### # ##### #
#   #   # #           #
### ### # ### ### ### #
#   #   #   # #     # #
# # # ### # ##### # ###
# #   #   #     # #   #
# ### ### # # ### # ###
#   # #   # # #   # # #
### # # ### ####### # #
#   #   #         #   #
# # # ### # ### #######
# # # # # # # #       #
# ### # ##### ####### #
#   #     #   # #     #
### ##### # # # # #####
#     #   # # #   #   #
# ##### ### # ##### # #
#     #     #       # #
#######################
