#######################
#                 # # #
# ######### # ### # # #
# #   # #   #   #   # #
### ### ####### ### # #
# #     #       #   # #
# # # # # ######### # #
#   # #   # #         #
##### ##### ####### # #
# #     #       #   # #
# ######### # ####### #
#   #       # #       #
### # ####### # ##### #
#   # # #   # #   # # #
# ### # ### # ### # ###
#   # #   #     # #   #
### ##### # ### # ### #
# # #   #   #   #   # #
# # # ####### # ### # #
#   #   #     #       #
# ##### # ##### ##### #
#         #       #   #
#######################
