#######################
# #   # #     # #     #
# # ### # # # # # ### #
# #   # # # # #     # #
# ### # # ####### # ###
# # # # # #     # #   #
# # # # # # # ### ### #
#   #   #   #       # #
### ### # ##### ##### #
#         # #       # #
# ### # # # ##### # # #
# #   # #       # # # #
##### ##### ######### #
#     #         #   # #
### # ### # ##### ### #
#   #   # #   #   #   #
# ####### ####### ### #
# #   #             # #
# ### ### # ####### ###
#     # # #       #   #
##### # ######### ### #
#     #           #   #
#######################
