#######################
#     #       #       #
# ### ####### ### # # #
#   # # # #   #   # # #
# ### # # # ### # # ###
# #       #     # #   #
# ##### ### ##### ### #
# #   # #   #       # #
##### # # ######### ###
#     #   #     # # # #
### # # ##### # # # # #
#   #   #   # #       #
# # ##### # ######### #
# #   #   #           #
### # ### ### # # ### #
# # # #   #   # #   # #
# ### # ### ### ### ###
#     # #   #   #     #
# ##### ##### ####### #
# #   # #   # # #     #
### # # ### # # ##### #
#   #     #   #       #
#######################
