#######################
#         #   #   #   #
# ### # ##### # ##### #
# # # #   #     # #   #
# # ##### # ##### # ###
# # #   # # # #   #   #
# # # # # # # ### # # #
# #   # # #     #   # #
# ### # # ### # ##### #
# #   # #   # # # #   #
### ### # ##### # ### #
#   #   # #     # # # #
# # ##### # ##### # # #
# # #   #   #   # # # #
# # ### # ### ### # # #
# #         #         #
##### ##### # ####### #
#     #           #   #
##### ### ### ### ### #
# # # #   #   # #   # #
# # ### ####### # ### #
#       #           # #
#######################
