#######################
#     #   #       #   #
# ### # # # ##### ### #
# #     #       #   # #
########### ######### #
#       #       #   # #
### ### ### # ##### # #
#   #       #         #
##### # # # # # #######
#     # # # # #     # #
##### # # # ####### # #
#     # # #     # #   #
# ##### ##### # # ### #
#   #       # #     # #
### # # ####### # ### #
#   # # #       # #   #
# ##### # ####### # ###
# # #   #     #   # # #
# # # ### ######### # #
#   # #   #       #   #
# ##### ##### ### ### #
#     #     #   #     #
#######################
