#######################
# #       #     #     #
# # ##### ### # ##### #
# # # # #     # #   # #
# # # # ####### # # # #
#   #       #     #   #
# ### ### # ### ##### #
# #   #   #         # #
# # # # ### ### ### ###
# # # # # # # # #     #
### ##### # # ### #####
#   # #   #   # #   # #
# ### ### # ### # ### #
# #   #         #   # #
# ### # # ##### ##### #
# # #   # #           #
### # ### ##### ### # #
# # #   #     # # # # #
# # ##### ##### # ### #
#         #   # #   # #
# ##### ### ### ### ###
#   #       #         #
#######################
