#######################
#   #   #       #     #
### ### ##### ####### #
#     # # # #   # # # #
##### # # # ### # # # #
#   #   #       #     #
# ### ##### ######### #
#   # #               #
# # # ### ##### # # # #
# # # # # #     # # # #
# # # # # ##### # #####
# #   #   #     # #   #
# ######### ### ### # #
# #         #       # #
# ####### ##### ##### #
#     #   #       #   #
##### # ### ####### ###
#         #     # #   #
### ##### # ### # ### #
# #   #   # #   #     #
# ### ### ### # ### ###
#     #     # #   #   #
#######################
