#######################
# # #         #   #   #
# # ######### ### ### #
#   #       # #     # #
# # ### # ### # ### # #
# #     # #       # # #
# # ##### ##### # # # #
# #   # #   #   # #   #
### ### ##### # # # ###
#   # #   #   # # #   #
### # ### # ######### #
# # #   #   #       # #
# # # ##### # ##### ###
#     # #   # #   #   #
##### # # ### ### ### #
#   # #     # #   #   #
# # # # ##### # # # ###
# #             # # # #
# ### ######### # # # #
# #           # # #   #
# # ### ### # ### ### #
# # #     # # #     # #
#######################
