#######################
# #   #       #   # # #
# # # ### ### # ### # #
#   #     #         # #
# ######### ##### ### #
# # #   #     # #     #
### ### # ### # ### ###
#     #     #     #   #
# ####### ####### # # #
#   #           # # # #
# # # ### # ######### #
# # #   # # # #     # #
# ##### ### # ### ### #
#     # #   # # #     #
# ### # ### # # #######
# #       #   #       #
# ### ######### # #####
#   #           #     #
####### # ##### ##### #
#       #   #   #     #
### ##### ####### ### #
#     #   #       #   #
#######################
