#######################
#             #       #
# # ### ### # # ##### #
# # #   #   #       # #
# ### ### ### ##### # #
#   #   #   #   # # # #
# # ##### ### ### # # #
# #   #     # #   # # #
# ### # ##### # # # ###
# #   # #     # #     #
# # ########### # # ###
# #   #     # # # #   #
# ### ##### # # # #####
#   # #     #   # #   #
# ### # ### # ##### # #
# #       # #   #   # #
# ####### # # ##### ###
# #       # #     #   #
# ############# ##### #
# # # #       # # #   #
# # # # ##### # # # # #
#   #       #       # #
#######################
