#######################
# #               #   #
# # ### ### ### ##### #
# #   #   #   #     # #
# ##### # ######### # #
#       #     #   #   #
# ######### # # ##### #
# #       # # # #   # #
# ### ### ### # # ### #
#       #   # # #     #
# ### ##### ### ### ###
# #     #     #       #
# ##### # # # ##### ###
#     # # # #     #   #
# ### # # ########### #
#   # # #   #       # #
# ########### # ### ###
#         #   #   #   #
# # ############# ### #
# #     #         # # #
### ### # ### ##### # #
#   #       #       # #
#######################
