#######################
#   #       #         #
### ### ##### ####### #
# #         #   #     #
# ##### ### ### # ### #
#   # #   #     # #   #
# # # # # ### ####### #
# #   # #   #   #     #
# ####### ####### #####
#         #   # #   # #
# ### ### # ### ##### #
#   #   #   # #   #   #
# # ######### # # # # #
# #   #   #     #   # #
# ### # ### # #########
#   #   # # #         #
# # ##### # ######### #
# #     #   # #     # #
# # ### # # # ### ### #
# #   #   #   #   #   #
# ### ### ##### ### ###
# #   #       #       #
#######################
