#######################
#     #       #       #
# ### # ########### ###
# # #   # #   #   # # #
# # ##### # ### # # # #
# #   #   #     #   # #
# # ##### # ##### # # #
#   # #   # #   # # # #
# ### ### # # ##### # #
# # #     #     #   # #
# # # ##### ### ### # #
#   #       #     #   #
# ### ####### ####### #
#       #       #   # #
### ##### ##### # # ###
#   #     # # #   #   #
# # # ##### # ### ### #
# # # #     #   #   # #
### # ### # # ### # # #
#   #   # # # #   # # #
##### ##### # # # ### #
#           #   #   # #
#######################
