#######################
#     #   #       #   #
# ##### # # ##### # ###
# #     # #   #   #   #
# # ##### # # # # # ###
#       #   # # #     #
# # ####### ######### #
# #   #   #         # #
# ### # ### ####### # #
# # # #     #       # #
# # # # ##### ### #####
#   # #     # # #   # #
### # # # ##### # ### #
# # # # #       #     #
# ### ### ####### #####
#       #       # #   #
####### ### ##### # # #
# #     #   #     # # #
# # ### ### # ##### ###
#     #   # #         #
# ### ##### # ### ### #
#   #     # #   # #   #
#######################
