#######################
# #   #               #
# # # ### ######### ###
#   # #   #       #   #
# ### ##### ##### # # #
#   #   # #   #   # # #
# ##### # ##### ##### #
# #   #     #         #
### # # ### ##### # # #
# # #   #     #   # # #
# # ######### # ##### #
#   #   #   #   #     #
# ### # # # ##### # ###
#     # # #       #   #
######### # ####### ###
#         #   #       #
# # ##### ### # ##### #
# #   #   #   #     # #
##### # # # ####### ###
#     # # # #   #   # #
# ##### # # ### # # # #
# #     # # #     #   #
#######################
