#######################
#     #     #     #   #
# # # ### ### # ### ###
# # # #     # # # #   #
# # ### ### ### # # # #
# # #   #     # #   # #
# ### ######### ##### #
#         # #   #   # #
# # ####### ### ### # #
# #                 # #
# ############# ### # #
# # #         #   # # #
### ### ### # ### # # #
#     # #   # #   #   #
# ##### ### # # # # ###
#         # #   # #   #
### ####### ##### # # #
#   # #     # #   # # #
# ### ####### ### # ###
#     #   #   #   # # #
##### ### # # # # # # #
#         # #   # #   #
#######################
