#######################
#       #     #       #
##### ### ### ### # # #
#     #   #   #   # # #
# ########### # ### # #
#       #   #   #   # #
####### # ##### # #####
#   # #       # # #   #
### # ####### # # # ###
#   # #   #   # #   # #
# ### # # # ### ##### #
#   # # #   #   #   # #
### # # ##### ##### # #
# #         # #     # #
# # # ##### # ### ### #
#   #     #   #   #   #
### ####### ##### # ###
#         #       #   #
# ### # # ### ##### # #
#   # # #   #     # # #
# # ##### # ##### # # #
# # #     #     #   # #
#######################
