#######################
# # # #               #
# # # # ########### # #
# #   #   #     #   # #
# ### ### ### ### #####
#   #     # #   #     #
### # ### # ### ##### #
#     # #   # #   # # #
##### # ##### ### # # #
#     #   #   #   # # #
### ### # # # # # # # #
#   #   #   #   #   # #
# ### ############### #
#       #   #   # #   #
### ##### ### # # # ###
#     #   #   #   # # #
# # ### ### ### # # # #
# #           # # # # #
# ################# # #
#     #       #     # #
# ##### ######### ### #
#               #     #
#######################
