#######################
#       #     # #     #
# ##### # ### # # ### #
#     #   # # # #   # #
### ##### # ### ### ###
# #     #   #     #   #
# ##### # ### ##### # #
#       # #   #   # # #
# ####### # ### ### ###
# #   #           #   #
# # ### ####### # ### #
#   # # #       #   # #
### # ########### ### #
#   #             #   #
# ### ##### # ### # ###
#   # #   # # #   #   #
### # ### # ### # ### #
#   #     #   # #     #
# ##### # ### # # # ###
#   # # # #   # # #   #
### # ##### ### ##### #
#         # #       # #
#######################
