#######################
# #   #           #   #
# # # ### # # # # # ###
#   # #   # # # #     #
##### ### ##### # ### #
#   #   # # # # # #   #
# ##### ### # ### # ###
# #             # #   #
# # # ######### # # ###
#   #       # #   #   #
# ####### ### ### #####
# #       #         # #
# ####### # ######### #
#   #     #           #
### # ### ##### ### # #
#   #   #     # #   # #
# ######### ##### #####
# #         # #   #   #
# ####### ### # ##### #
# #   #     #   #     #
# # # ### ### ### ### #
#   #   # #       #   #
#######################
