#######################
#   #     #     #     #
# # ### # # ##### # ###
# # # # # #   # # #   #
# # # # # # # # # ### #
# # #   #   # # #   # #
# # ######### # ##### #
# #               #   #
# ##### ####### # # ###
# #   # #       #   # #
# # ##### # # # # ### #
# # #     # # # # # # #
# # ### # # # # # # # #
# #   # # # # # #   # #
# # # ### ####### ### #
#   #   # #           #
### ##### # # ##### ###
#   # #   # #   # # # #
### # # ### ##### ### #
# # # #   #     #   # #
# ### ### # ####### # #
#         #           #
#######################
