#######################
# # #     # # #       #
# # # ##### # # # ### #
# # #   #   #   # #   #
# # # # # ##### # #####
#   # #       # # #   #
# ### ####### ### # ###
# #       #       # # #
# ### # ### ####### # #
#     #   #   #   #   #
### ########### # # ###
#   #       #   # #   #
# # # # # ### ##### ###
# # # # #             #
# # ### ##### ##### # #
# #   # #         # # #
# ##### ########### # #
# #   #     # #   # # #
# ### ##### # # ### # #
#           #     # # #
### # # # # # # ##### #
#   # # # #   #   #   #
#######################
