#######################
# #         #         #
# ##### # ### ####### #
# #   # #     #   #   #
# # # # ######### # ###
#   #   #   # # # # # #
### ##### ### # # # # #
# # # #   #     #   # #
# # # # ####### ### # #
# #   #             # #
# ########### ### ### #
# #         #   #   # #
# # ####### ##### # # #
#   #     #     # # # #
### # # ### ### # # # #
#   # #     #     # # #
# ##### ######### ### #
#     # #   #         #
##### # ### # # #######
#     #     # # #   # #
# ### ##### # ### # # #
#   #     # #     #   #
#######################
