#######################
#   #         #     # #
# ### ####### # ##### #
#   #     #   # #   # #
### ##### ##### # # # #
# #       #   # # # # #
# ### ### # ### # ### #
#       #     # #     #
# ########### # # # ###
# #           # # #   #
# # ##### # ### ### ###
# # #   # # #   #     #
# # ### ### # ### # ###
# # # # # # #   # # # #
# ### # # # ### ### # #
# # # # #     # #   # #
# # # # # ##### ### # #
# # # #   #   #       #
# # # # ##### ##### # #
#   #   #           # #
### ### # ##### # #####
#   #       #   #     #
#######################
