#######################
#     #   #     #   # #
# ####### # # ##### # #
# #         # #   # # #
# # ######### ### # # #
# # # #       #   #   #
# # # # # ##### ### ###
#   #   # #           #
# ##### # # ### ### # #
#     # # #   # #   # #
##### # # ##### ##### #
#     # #   #       # #
# ##### ### ### # # ###
#   #   #   # # # #   #
# # # ##### # ### # # #
# # #     # #     # # #
# ####### # ######### #
#     #   #           #
# ### ### ##### ##### #
#   #   # #   #   #   #
### ####### # # # #####
#   #       #   #     #
#######################
