#######################
#         # #         #
####### ### ### # #####
#     #     #   #   # #
# ### ##### ####### # #
# # #       # #       #
# # ######### ####### #
# #     # #   #       #
# # ### # ### # ### # #
# # #     # #   # # # #
# ### # ### ### # # # #
#     # #       #   # #
# # ##### ####### # # #
# # #         #   # # #
# # # ### ######### # #
# # # #   #         # #
### ### ### ######### #
# #   #   # #       # #
# ### ##### # ####### #
#     #   # #   # # # #
# # ### # # ### # # # #
# #     #       #     #
#######################
