#######################
#   #     #   #       #
# # # ### # # ####### #
# # # # # # # #   #   #
# ##### # ### # ### ###
# # #     #   # # # # #
# # # # ### ### # # # #
# #   #           #   #
# # ##### ##### ### ###
#   #       #     #   #
####### # ##### ### ###
#       #   #     # # #
########### ##### # # #
# #             # #   #
# # ### ### ### # ### #
#   # #   # #   #   # #
# # # # ### # ####### #
# # #   # # # #       #
# ####### ### ####### #
#   #       #         #
### ### # # # #########
#     # # #           #
#######################
