#######################
# # #   # #   #       #
# # ### # # # ##### ###
# #     #   #         #
# # ########### ##### #
# #       #   #     # #
# ### ### # ##### ### #
#   #   #       # # # #
# # ##### ######### # #
# #               # # #
# ### ### ######### # #
# #   #     #   #   # #
# ### # ### ### # ### #
#   # #   # #       # #
# ### ####### ####### #
# #   #     #         #
### ### ##### ####### #
#           #   #   # #
### ########### # ### #
# #   #     #     # # #
# ### # ##### ##### # #
#             #       #
#######################
