#######################
#         #         # #
# ### # ### ####### # #
#   # # #     #   #   #
##### # ### # # #######
#   # #   # #   #     #
# # # ##### ##### #####
# #               #   #
# ####### ##### # # # #
#       # #     # # # #
# # ### # ### ##### # #
# #   # # # #   #   # #
### ####### # # # ### #
#           # #   #   #
# # # ####### ####### #
# # # # #           # #
### # # # ######### # #
# # # #   # #       # #
# ### # ### ######### #
#   # #     # #       #
# ### # ##### # #######
#     #       #       #
#######################
