#######################
#                 #   #
# ### ########### # ###
# # #           # # # #
# # ####### ### # # # #
#     #     #   # # # #
# ### ######### ### # #
# # # #       #     # #
# # ### ####### ##### #
# # #   #       #     #
### # ### ####### # ###
#         #   #   # # #
####### # # # # ##### #
#     # #   # # #   # #
##### # ### # # # # # #
#   #   #   #     #   #
### # ##### ##### ### #
#         # # #     # #
# ####### ### # ### ###
#     #   #   #   #   #
# ### ##### # ### ### #
#   #     # #     #   #
#######################
