#######################
#   #             # # #
### ##### ######### # #
#         #   # #   # #
# ### ##### # # # ### #
#   #       #         #
# ############# # # ###
# #             # #   #
####### ### # # # ### #
#     #   # # # # #   #
# ### # # # ### ### # #
# # #   # # # # # # # #
# # # ### # # # # # ###
#   # # # # #   #     #
### # # # # # ####### #
# # #   # # #       # #
# ### # ####### ##### #
# # # #     #   # # # #
# # # # ##### # # # # #
# #   # #     # # #   #
# ##### ##### ### ### #
#           #       # #
#######################
