#######################
#       #       #   # #
# ##### # ### ### ### #
# # #   # #       #   #
# # # ### ##### ### ###
# # #     #           #
# # ##### ######### # #
# # #     #       # # #
# # # # ##### ####### #
# #   #           #   #
### ### ### # ####### #
#   #   # # #       # #
# ####### # ##### # # #
#   # #     #     # # #
### # # ##### # ##### #
#   #     # # #   #   #
# ##### ### # ### # ###
#   # # #     #   # # #
### # # # ##### ##### #
#   #   # #   #   #   #
######### # # ### # # #
#         # #       # #
#######################
