#######################
#         #     #     #
### # # ##### # ### ###
#   # #       # #   # #
# ############# # ### #
#     #     # # #     #
##### # ### # ### #####
#   #   # #   # #   # #
# ##### # ### # # # # #
#     # # # #   # #   #
### ##### # ### ##### #
#   # #             # #
# ### ############# # #
#   # #               #
# # # # # # ###########
# #     # #     #   # #
####### # # ####### # #
#   #   # #     # #   #
# # # ### # ### # # ###
# #   #   # #   # # # #
############# # # # # #
#             #       #
#######################
