#######################
#       # #     #   # #
# ### # # # ### # ### #
#   # #   #   #       #
### # ####### ### #####
# # # #     #   #     #
# ### # ### ### ##### #
#   # #   #     #   # #
# # # ########### # # #
# # #     # #     # # #
# # ### # # # ### ### #
# # #   #   #   #   # #
### ### ### ####### # #
#   #   # #       #   #
# ####### ####### ### #
#   #   #       #     #
### ### # ### ### # # #
# #   # # #       # # #
# # ### ### ##### # ###
# #     # # # #   # # #
# ### ### # # # ### # #
#             #   #   #
#######################
