#######################
#         #   # #     #
# ### ### # # # # ### #
# #     # # #       # #
# # # ### # ######### #
# # #   #     #       #
##### ##### ###########
# #     #             #
# # ##### # ######### #
#   #     #   #     # #
##### ### ### ### # # #
# # # #     #   # #   #
# # # ### ##### ##### #
#       # # # #   #   #
### # # ### # ##### ###
#   # #           # # #
# ### ### ####### ### #
#   # # #       #     #
### ### ### # # #######
# # #     # # #     # #
# # # ### # ######### #
#   #   #             #
#######################
