#######################
#   #       #   #     #
### # ####### # # ### #
#   #     # # #   #   #
# # ##### # # ##### ###
# #   #     #   #   # #
# ### # ####### # ### #
# #   # #     # #     #
# ##### # ### # ### ###
#         #   # # # # #
# # ### ##### # # # # #
# #   #     #   #   # #
# ### # # # ######### #
# #   # # #   #       #
# # # ####### # ##### #
# # # #     # #   #   #
# ### # ##### # # #####
# #   #     # # #     #
# # # # # # # # #######
# # #   # # # #       #
### ##### # ######### #
#     #   #           #
#######################
