#######################
#         #   #     # #
### ##### # ####### # #
#   #     #   #   #   #
# ### # ##### # ### ###
#   # #   #   # #   # #
### ### # ### # # ### #
#   #   #     # # #   #
##### ######### # ### #
#   # #   # #     #   #
# # # # # # # ####### #
# # #   # #       #   #
# # ##### # ####### # #
# #     # #   # #   # #
# ### ### ### # # #####
# # #   #   # # #   # #
# # ### ### # # ### # #
# #         # # #     #
# # ####### # # ##### #
# #     # #   #     # #
# ### ### # ### # ### #
#   #     #     #     #
#######################
