#######################
#             #       #
# ##### # # # # ##### #
#   # # # # #     #   #
# # # # # ######### ###
# # #   #     #     # #
### # ####### ##### # #
# # #       #   #   # #
# # ### # # ### # # # #
#   #   # # #   # #   #
##### ##### ####### # #
#     # #   # #     # #
# ##### # ### # ### # #
#   #     #   #   # # #
### # ##### ##### ### #
#   # #     #     #   #
# ### # ######### #####
# #   # # #           #
# # ### # ##### #######
# # #     #   # #     #
# # ##### # ### # ### #
# #       #       #   #
#######################
