#######################
#   # #     #     #   #
# # # ### ### ##### # #
# #     # #         # #
# ### ### # ######### #
# # #     #   #   #   #
# # ### ##### # ### ###
# #   # #     #   # # #
# # # ### ####### # # #
#   #   # #   # #   # #
# # ### # # ### # ### #
# #   #   #   # #     #
### # ### ### # ##### #
#   # #       #     # #
##### ######### ### ###
#   #     #   #   # # #
# ####### # # # # ### #
#   #   # # #   #     #
# # # # # # # ####### #
# # # #     #       # #
# ### # ############# #
#     #     #         #
#######################
