#######################
#                     #
####### ### ####### ###
#   #   #   #       # #
# # ##### ### ### ### #
# #     # #     # # # #
####### ####### ### # #
#   # #   #           #
# # # # ##### ##### # #
# #   #     # #   # # #
# ####### ### ### # # #
# #   # #   #   #   # #
# # # # # # ### ### ###
#   #     #   # #     #
# # ######### ### # ###
# #     #   #   # # # #
# ##### # # ### ### # #
# # #   # # #   #     #
# # # ### ### ####### #
#   # #             # #
# ### # ### ##### # # #
# #   # #   #     #   #
#######################
