#######################
#                 #   #
# ### ####### # # # ###
# # #   # #   # # #   #
### ### # ### # ### # #
#   #     # # #   # # #
# ####### # ### # # # #
#       # #   # #   # #
# # # ##### ### ##### #
# # # #         #     #
### ####### ##### # ###
#       #   # #   # # #
# ##### # # # # ### # #
#   # #   # #   #   # #
### # ##### # # ##### #
#   #     # # # #     #
######### # # ### ### #
# #       # # #   # # #
# # # ##### # # ### # #
#   # # #   #   #     #
# ### # # ####### #####
#   #     #           #
#######################
