#######################
#       #           # #
# ####### ####### # # #
#       # #       # # #
# ##### # # ####### # #
# #   #   #       # # #
# # ########### ### # #
# # # #   #   # # #   #
### # ### # ### # #####
#   # #   #   # #     #
# ### # ##### # ##### #
# #       # # #     # #
# # ##### # # ### # # #
#   #   # #   # # # # #
# # # # # # ### ### # #
# # # #   # #       # #
### ##### # # ####### #
# #     #     #       #
# ##### ### ### ##### #
# #       #   # #   # #
# # # ##### ##### # # #
#   #   #         #   #
#######################
