#######################
#       #       #     #
# ##### ##### ### ### #
# #   # #   #     #   #
# # # # ### ##### # ###
# # # #     #   # #   #
# ### ### ### ####### #
# # #   # #     #   # #
# # ### # ##### # # # #
# #     #   #     #   #
# ##### ### ### # # # #
# #   #   # #   # # # #
# # # ### # ####### ###
#   #   #       # #   #
####### ##### ### # # #
# #   # # # #     # # #
# # # # # # # ####### #
# # #     #       #   #
# # ############# # ###
#   #   #     #       #
# ### # ### # ####### #
#     # #   #         #
#######################
