#######################
#           #   #     #
# ##### ### # ####### #
#   # #   # #   # #   #
##### ### ##### # # # #
#   #           #   # #
# ######### ### ##### #
#     #   #   # #     #
# ### ### # # # # # ###
#   # # #   # # # #   #
# # # # ### # ### ### #
# # #   #   #     # # #
# ####### ######### # #
# # #   #     # #   # #
# # # ### ### # ### ###
#     #   #   #     # #
##### ### # ##### ### #
#   # #   #     #     #
### # # ##### # # ### #
#   #       # #   #   #
# # ### # # ##### ### #
# #     # # #       # #
#######################
