#######################
#     #       #     # #
# ##### ####### ### # #
#     #     #   # # # #
##### ##### # ### # # #
#     #   # #   # #   #
# ##### # # ### # ### #
#       # # #   # #   #
### ##### # # ### # ###
# # #   #   #   # # # #
# # # ##### ### # # # #
#   #     #     # # # #
# # ### ### ##### # # #
# #   #         # # # #
### ############# # # #
#   #         # #     #
# # # ####### # ##### #
# # #   # #   # # # # #
# ####### ### # # # ###
# #     #         #   #
# # ### ### ### ##### #
#     #       #       #
#######################
