#######################
#     #         #     #
# # ### ####### ##### #
# # #   #     #   #   #
# # ### # ####### # # #
# #   #   #         # #
##### # # # ######### #
#   #   # # #   # #   #
# ##### # ### # # #####
#   #   # # # #       #
# # # # ### # ### ### #
# # # #     # # # # # #
# # ### ### # # # # # #
# # # #   # # # # # # #
# ### ### ##### # # # #
# #           #   #   #
# # ##### ### ##### ###
# # #   # #     #     #
# # # # ### # # ##### #
#   # #   # # #       #
# ####### # ##### ### #
#       #   #       # #
#######################
