#######################
# #               #   #
# # # ### # ### # # # #
# # # #   #   # #   # #
# # ### ##### ####### #
#   #   #   #       # #
# ######### # ##### # #
# #       #   #   # # #
# ####### ### # ##### #
#     #   #     #     #
##### # # # ##### ### #
#   # # #   #   # #   #
# ### # # ### # ### ###
#     # #     # # # # #
# ##### ### ### # # # #
# #   # #   # #   # # #
# # ### ##### ##### # #
#   #   #   # #     # #
# ### ### # # # # ### #
# #       #   # #   # #
####### ####### ### # #
#       #       #     #
#######################
