#######################
# #     #       # #   #
# # # # # # ##### # # #
#   # #   #       # # #
# ############# # # # #
# # #           # # # #
# # # ### ### ##### # #
# # #   #   # #   # # #
# # ### ### ##### # # #
# #   #   # #   # # # #
# # ##### # ### # # ###
#   # #   #   #       #
### # # ####### # # ###
# # #   #   #   # #   #
# # ### # # # #########
#     #   # # # #     #
# ######### # # # #####
# # #   # #   #   #   #
### # ### ### # # ### #
#         # # # #     #
# ##### ### # # ### ###
#     #         #     #
#######################
