#######################
# #   #         # #   #
# # # ### # ### # ### #
# # #   # #   #   #   #
# ##### ##### ##### # #
#   #   #         # # #
# ### # ##### # # ### #
#   # # #     # #     #
# # # # ####### ##### #
# #   #     #     #   #
# ##### ####### # # ###
#   # #         # # # #
### # ######### # ### #
# #   # #       #     #
# ### # ##### ### #####
# #     #       #     #
# ####### # ### ##### #
#     #   # #       # #
### ### # # ####### # #
#       # #   #   # # #
# ####### ##### # ### #
#     #   #     #     #
#######################
