#######################
#           #         #
# # # ##### # ##### # #
# # # #     # #   # # #
### # # ##### # # ### #
#   # #   #   # #     #
# # # ### # ###########
# # #   #         #   #
# ##### ##### ### # # #
#   #       # #     # #
### ########### ##### #
#   # # #       #   # #
# ### # ##### ### # # #
#     #       # # #   #
##### ######### # # ###
#   # #       #   # # #
# ### # # ### # # ### #
#     # # # # # #   # #
##### # # # # # ##### #
#     # # #   # #   # #
# ####### ##### # # # #
#             #   #   #
#######################
