#######################
#       #   #         #
# ##### # # # ####### #
#     #   #     # #   #
# ### # ### ### # #####
#   # # # # # #       #
# # # ### # # ### #####
# # # # # # #   #     #
# ##### # # ### # ### #
#       #   #   # #   #
############# ### # ###
#               # #   #
# ##### ##### # # ### #
# # #       # # #   # #
# # # # ### # ####### #
#   # #   # # #     # #
######### # # # ### # #
#         # # # # #   #
####### ##### # # ### #
#     #     # # #     #
# ### ##### # ### #####
#   #       #         #
#######################
