#######################
#       #     #       #
# ####### # # # ### # #
#   # #   # #   # # # #
### # # ### ##### ### #
#   # #   #     #     #
# # # ### # ##### ### #
# # # # # # #   #   # #
# # # # # ### # ### # #
# # #       # # #   # #
# ########### # # ### #
#       #     #   #   #
####### # ### ##### ###
#       #   # #   #   #
# ######### ### # ### #
# #   #     #   # # # #
# # # ### ### ### # # #
#   #           # # # #
# ### ### ######### # #
#   # # #   #       # #
##### # ##### ##### ###
#             #       #
#######################
