#######################
#                   # #
# ####### ### ##### # #
#     # # # # #     # #
# # # # # # # ### ### #
# # #   #   # #   #   #
# # ### ##### ##### # #
# #   # #     # #   # #
# # # # ####### # #####
# # # #       # # #   #
# # ######### # # # # #
# #   # #   # #     # #
# ##### ### # ##### # #
#   # # #   #     # # #
### # # # ####### ### #
#         #   #   #   #
####### ### # # ### # #
#       #   # #     # #
# ### # # ### ##### # #
# #   # # # #     # # #
# ### # # # ##### #####
#   # #         #     #
#######################
