#######################
#       #   #         #
# ####### # # # ### # #
#         #   #   # # #
# ### ########### ### #
#   # # # # #     #   #
# ### # # # # ### # ###
# #   #   # # # # #   #
### ### ### ### ##### #
#       #   #   #     #
####### ### # ### #####
#     #   #   # # #   #
### ### # # ### # # # #
#       #   #   # # # #
### # ####### # # # # #
#   #       # # #   # #
# ### ##### # ####### #
#   #     #     #   # #
### ### ########### # #
# # # #       #     # #
# # # ######### ##### #
#   #                 #
#######################
