#######################
#         #       #   #
####### # # ### ##### #
#     # # #   #   #   #
# ##### ##### # # # # #
#       #     # # # # #
# ####### ##### ### ###
#   #     #       #   #
### ##### ### ##### # #
#       #   # #     # #
# ### # ### # ####### #
# #   #     #   #     #
# # ############# ### #
# # #   #     #   # # #
# ### ### ##### ### ###
# # #           #     #
# # # ############# ###
# #     #     #   # # #
# # ### ##### # # # # #
#   #         # # #   #
# # # ######### # # # #
# # #           #   # #
#######################
