#######################
#         # #   #   # #
# ######### # ### ### #
#   #             #   #
# # # ####### ### ### #
# # #     #     # #   #
### ####### # # # # ###
#     #     # # #     #
# ### # ### ######### #
# #     #   #       # #
# ####### # ##### # ###
# #       #   #   #   #
### ####### ### ##### #
#   #           #     #
# ##### # # ##### # ###
# #   # # #   # # #   #
### # # # ### # # #####
#   #   # # # # #     #
# ####### # ### ### # #
#       # #     #   # #
####### # ##### ##### #
#       #         #   #
#######################
