#######################
#       #       #     #
##### ### ##### # #####
#       #     # #     #
# ##### ##### # ##### #
#   #   #     # #   # #
# ### ### # ### # ### #
# #   #   #   #     # #
### ### ##### ### # # #
#     # #   # #   # # #
# ##### ### # # ### # #
#       #   # # # # # #
##### ### # # ### # # #
#   #     # #   #     #
# # ##### ##### ##### #
# #     # #     #     #
# ##### ### ##### ### #
#     # #   #     #   #
# ### # # ##### # # ###
# # # #   #     # # # #
# # ############# # # #
# #               #   #
#######################
