#######################
#     #     #     #   #
# # ### ### # ### # ###
# # #   #   # #       #
# ### ### ### ### #####
#       #   #   #   # #
# ######### ### ### # #
#   # #       #   # # #
### # # ##### ### ### #
# #   #     #   # #   #
# # ### ### ### # # # #
# # #   #     # #   # #
# ### ### ##### ##### #
#   # #   #   #   # # #
### # ### ### # ### # #
#   #   # # #   #     #
# ####### # # ### # # #
#   #     #   #   # # #
### ### ##### # #######
# #     #     #     # #
# ######### # ### # # #
#           #     #   #
#######################
