#######################
#   # #   #     #     #
### # # # # ### # ### #
#   # # # # #   # # # #
# ### # # # # ### # # #
#   #   #   #     # # #
### ####### ####### # #
# #   #       #   #   #
# ### ##### ### # #####
# # #     #     #     #
# # # ##### ######### #
# #   # #   # # #     #
# # # # # # # # ##### #
#   #   # #   #   #   #
### ##### ####### # ###
#   #           #   # #
# ########### ### ### #
# #           #   #   #
# ### # # ######### # #
#   # # # #       # # #
# ####### # ####### # #
#                   # #
#######################
