#######################
#     #           #   #
# ### # # ### # # # ###
# #     # # # # # #   #
####### # # # ### ### #
# #     # # # #       #
# # ##### # # # ##### #
# #   #   #   # #   # #
# # # ##### ### # # # #
# # #     # #   # #   #
# ### ##### ##### ### #
#     #     #   # #   #
### ######### # # # ###
#   #   #     #   #   #
# ##### # ######### # #
# #     #     #     # #
# # ### ##### # ### ###
#   #       # #   # # #
##### ####### ### # # #
#   # #       # # # # #
# # # # ####### # # # #
# #   #         # #   #
#######################
