#######################
#         # #       # #
# ####### # # ##### # #
# #   #   # #   # #   #
# # # # ### ### # #####
# # # # #   #     #   #
### # # # ### ### # # #
#   # #   # #   #   # #
# ### ### # ### ### # #
# #     # #     # # # #
# ##### # ### ### # # #
#   # # #         # # #
# # # ####### ### # # #
# # #   #     #   # # #
### # # # ### # ### ###
#   # # # #   # # # # #
# ##### # # ### # ### #
#     #   # #   # #   #
# ### # ##### ### # # #
# # #   #     #     # #
# # # ### # ##### ### #
# #   #   #       #   #
#######################
