#######################
#     #           #   #
### # # # ######### # #
#   # # #   #     # # #
# ### ##### # ### ### #
# #   #   # #   #     #
# ### # # # ### # ### #
#   #   # #     # #   #
### ##### # ### # #####
#   #   # # #   # #   #
# ##### ##### ### # # #
#   # #       #     # #
### # # ####### # ### #
#     #   # # # # # # #
# ######### # # # # # #
#       #   #   # # # #
### ##### ### ### # # #
# #   #         # #   #
# ### ####### ### ### #
#   #     #   #     # #
# ####### # # # ##### #
#           # #     # #
#######################
