#######################
#                 #   #
# ############### # # #
# #     # #         # #
# # ### # # ######### #
# # # # #     # #   # #
# # # # ####### # # # #
# # #   #         # # #
# # ##### ######### # #
# #   #     # # #   # #
# ### # ##### # # #####
# #     #     #       #
# # ##### ##### ##### #
# # #       # #     # #
# ######### # # ##### #
# #         #   #     #
# # ##### ####### #####
# # #       #   #     #
# # # ####### # # ### #
#   #       # # #   # #
# ########### # ##### #
#             #       #
#######################
