#######################
#     #   #         # #
### # # # ##### # # # #
#   # # #     # # #   #
# ### # ##### # # ### #
#   # #     #   #   # #
# # ### ### ######### #
# #     # #   #       #
######### ### ##### ###
#   #     # #     #   #
# # # ##### ### # #####
# # # #     #   #     #
# ### ##### # ####### #
#   #       # # #     #
### ##### ### # # #####
#   #   #       # #   #
# ### # # ##### ##### #
# #   #   #   #   #   #
# # ######### # # # ###
# # # #   # #   # #   #
# # # ### # # ####### #
#           #         #
#######################
