#######################
#     #   #         # #
# ##### # # ##### ### #
#       #   #     #   #
############# ##### # #
#   #         #     # #
# # # ########### #####
# #   #     #         #
# ######### # ### ### #
#   #       #   # #   #
# # # ##### ####### ###
# # # #     #     #   #
# # # # ##### ### ### #
# #   #     #   # #   #
# ######### ### # # ###
#   #   # #     # #   #
### # # # ####### # # #
#     #     # # #   # #
# ##### ##### # ##### #
# #     #   #   # # # #
### ####### ### # # # #
#         #           #
#######################
