#######################
# #           # #     #
# # # ####### # # # ###
# # # #   #   # # # # #
# # ### # # ### # # # #
# #     # #     # # # #
# ####### ######### # #
#   #     # # #   # # #
# ### # ### # # # # # #
# #   # #     # #   # #
# # ##### ######### # #
# #     #           # #
# ##### ### # ### ### #
#     #     #   #     #
# # ########### # #####
# # #   #   #   #   # #
# # ### ### # # # # # #
# #   #       # # # # #
# ### ######### ### # #
#   # #   #       # # #
### # ### # ####### # #
#   #             #   #
#######################
