#######################
#             #       #
# ### ####### ####### #
#   #       #   #     #
# # ####### # # # #####
# #     #   # # # #   #
### # ### ### # # # # #
#   #   # # # #   # # #
# ##### ### ##### # ###
#   #   #       # #   #
### ### # # ##### ### #
# #   # # #     #   # #
# ### # # ######### # #
# #   #       #     # #
# # ############### # #
# #     #     #   #   #
# # ### ##### # # ### #
# # # #     #   # #   #
# # # ##### # ### #####
# # # #     # #   #   #
# # # ### ##### ##### #
#       #             #
#######################
