#######################
#   #           #   # #
# ### # # ##### # # # #
# #   # #   #     # # #
# ##### # ########### #
#       # #       #   #
######### # ##### # # #
#           #   # # # #
# ########### ### # # #
# # #     # #       # #
# # # # # # # #########
#     # # #   #       #
# ##### # ####### # ###
#     # #         # # #
##### # ### ##### # # #
#     # # # #     #   #
# ##### # # # ####### #
#     # #   #       # #
##### # ######### ### #
#     # #     #     # #
# ####### ### # ##### #
#         #   # #     #
#######################
