#######################
# #     #     #       #
# # ### # ### # # ### #
# # # #   #   # # # # #
# # # ### # ##### # ###
#     # # # #     # # #
# ##### ### # ##### # #
# #   #   # #     #   #
### # ### # # ### ### #
#   #   # # # # #   # #
# ##### # # # # ### # #
#     #   # #   #     #
##### # ### # ### ### #
# #   #       # # # # #
# # ##### # ### # # # #
#   #   # # #   # # # #
# ### # # # # # ### ###
# #   # # #   #     # #
####### # ######### # #
#       #     #   # # #
# ############# # # # #
#               #     #
#######################
