#######################
#     #       #       #
# ##### ##### # # #####
# #     #   #   #     #
# # ##### # # ### # # #
# # # #   # # #   # # #
# # # # ### ####### # #
#   # # # # #     # # #
# ### # # # # ### ### #
#   #     # # # #     #
# # ##### # # # #######
# #       # #         #
# ######### ######### #
# #       # # #       #
### ### ### # #########
#   # #   # # #   #   #
# ### # # # # # # # # #
#   #   #   # # #   # #
# ### ### ### # ### # #
# #   # # # #   # # # #
### ### # # # ### ### #
#       #       #     #
#######################
