#######################
#                 # # #
# ##### # ### ### # # #
# #     # #   # #   # #
# ####### # ### # ### #
# # #     #   #       #
# # # # ##### ####### #
# # # #     # #     # #
# # # ##### # # ##### #
#   # #     #       # #
# ##### ### # ##### # #
#     #   # # #   # # #
##### ### # ### # # # #
#     #   #     # # # #
# # ### ####### # ### #
# # #   #       #   # #
# ### ####### ##### # #
#   #       #   #   # #
### ####### ##### ### #
# #   #     #   # #   #
# # ### ##### # # # ###
#   #       # #   #   #
#######################
