#######################
#     #       #       #
# ### # ### # # ### # #
# # # # #   # # #   # #
# # # # # ### ### ### #
#   # # # # #   #   # #
##### # ### ### ### # #
#   # #     #   #   # #
# ### ### ### # # ### #
# #   # # #   # # # # #
# # ### ### # ### # # #
# #         # #   #   #
# ####### # ### ### ###
#   #     #   #   #   #
### ### ##### ### ### #
# # #   #   #     # # #
# # ####### # ##### # #
#           # #   #   #
# ######### # # ### ###
# #         # #   # # #
# ######### # # # # # #
#         #   # #     #
#######################
