#######################
#               #     #
# ##### ####### # ### #
# #   #       #   # # #
# # # ############# # #
#   #   # #       #   #
##### # # # ##### ### #
#     #   # # #     # #
# ### ##### # # ##### #
# #   #     #   # #   #
# # ### ##### ### ### #
# # #   #   #     #   #
# ### ### # ### ### # #
#   # #   # #     # # #
### # # # # ##### # # #
# #   # # #   #   # # #
# ### # ##### # ### # #
#   # #   # # #   # # #
# # # ### # # ### ### #
# # # #     # # #   # #
# ### ####### # ### # #
#             #     # #
#######################
