#######################
#   #                 #
# ### ######### ##### #
#   # #   #     #     #
### # # ### ###########
#   #   #   #         #
# ### ### ### ####### #
# #   #   #       #   #
# # ### ####### ### # #
# # # #   #   # # # # #
# # # ### ### ### # ###
#   #     #     # #   #
##### # ### ##### ### #
#     # #           # #
# ##### # ### ##### # #
# #   #   #       # # #
# # # ##### ##### ### #
#   #   #   #   # # # #
####### # ### # # # # #
#     # # #   # # #   #
# ### # # # ##### ### #
#   #   #   #         #
#######################
