#######################
#   #         #       #
# ####### ##### ### # #
#       # #     #   # #
##### # # # ##### ### #
#   # # # # #     #   #
# # ### # # # #########
# #     #   #     #   #
# ##### ####### ### ###
# #     #   # # #   # #
# # ##### ### # # # # #
# #   # #   # # # # # #
# ##### # ### # ### # #
#       #   # #   #   #
# ####### ### ### ### #
# #     # #           #
# # ### # # ####### ###
#   #   #   #       # #
##### ##### # # ##### #
#   #       # #   #   #
# ##### ##### ### ### #
#           #   #     #
#######################
