#######################
# #             #     #
# # ### # ##### ##### #
# # #   # # # #     # #
# # # ### # # ##### # #
# # #   # #     #   # #
# # ##### # ##### # # #
# # #   # #     # #   #
# # # ### # ### ##### #
#   # #   #   #     # #
# ### ### # ######### #
# # #   # # #       # #
# # ### ### # ### ### #
# #       # # # #     #
# ##### # # ### #######
#     # #   #   #   # #
##### ##### # ### # # #
#     #         # #   #
### ### ### ##### ### #
# #     #   #     #   #
# ####### # # ##### ###
#         #   #       #
#######################
