#######################
#       # #           #
# ##### # # ##### ### #
#     #   # #   # #   #
##### ##### # ##### ###
#   # #   # #   #     #
# # # # ### # # # #####
# # # #     # #   #   #
# # # ####### ##### # #
# # # #   #     #   # #
# # # # # # ### ##### #
# # #   #     # #     #
# # ##### # ##### ### #
# #   #   #   # #   # #
# ### ##### ### ### # #
# # #   #           # #
# # ### # ######### ###
# #   # #   # #   #   #
# ### # ### # # ##### #
# #   #   # # #       #
### ##### ### ### #####
#                     #
#######################
