#######################
#             #   #   #
### ### ##### ### # # #
#     #   # #   #   # #
# ### ### # ### ##### #
#   #   #   #   #     #
####### ##### ### ### #
#     #   #       #   #
# ### ### # ####### ###
#   #     # # #   #   #
### ####### # ### ### #
# #   #   # #   #   # #
# ### # # # # # # ### #
#   # # #   # # #   # #
# # # # ##### ##### # #
# # # #     # #   # # #
# # # ##### # # # # # #
# # #     # # # #   # #
# # ##### # # # ### # #
# #       # # #   #   #
# ######### # ### #####
#       #   #         #
#######################
