#######################
#   #     #     # #   #
# # # ### # # # # # # #
# #     #   # #   # # #
# ##### ##### ##### ###
#   # #     #     #   #
### # ##### # ### ### #
#         # #   #     #
### ####### ### #######
#     #   # #       # #
# # # ### # ####### # #
# # #     #   # # # # #
### ########### # ### #
#       # #         # #
# ##### # # # ##### # #
# # #   #   # #   #   #
### # ####### # # ### #
#   # #       # #   # #
# # # # ########### # #
# # #   #           # #
# # ##### # ######### #
# #       #           #
#######################
