#######################
#     #       # # #   #
##### ### ### # # # # #
#   #       #   #   # #
# ######### ### # #####
# #       #   # #     #
# # # ### # # ####### #
#   #   # # #   #     #
# ##### # # ### ### ###
#     # # #   #   #   #
# ### # # ####### ### #
#   # # #         #   #
# ### # ######### # ###
# #   #   #     # #   #
# # ### ### ### ##### #
# # #   # #   # #     #
# # # ### ### ### ### #
# # # #     #   #   # #
# # ### ### ### ##### #
# #     #       #     #
# ####### ##### # ### #
#     #       #   #   #
#######################
