#######################
# #         #   #     #
# # ####### # # # ### #
# # #     #   # #   # #
# # # ### ##### ### # #
# # #   #     # #   # #
# # ####### # # # ### #
#   # #   # #   # # # #
# # # # # # ##### # # #
# #   # #   # #     # #
# ### # # ### # ##### #
# # # # # #     #     #
# # # # ######### #####
#   # # #         #   #
### # ### # ######### #
#   #     # #   #     #
### ######### # ### # #
#   #         #   # # #
# ##### ####### # # ###
#       #   #   #   # #
######### # # ####### #
#         #           #
#######################
