#######################
#   #     #           #
# # # ### # ##### #####
# # # #   # #     #   #
# ##### ### ####### # #
#     #   # #       # #
# # # # ### # ####### #
# # # #   #   # #   # #
### # # # ##### # # # #
#   # # #   #   # #   #
# ##### ##### # # ### #
#     #     # #   #   #
# # # ### # ##### # ###
# # #     #       # # #
# ##### # # ####### # #
#     # # # #       # #
##### ##### ### ##### #
#   #     #   #   #   #
# ####### ### ### ### #
# #       # # # #   # #
# # ####### # # ### # #
#         #   #       #
#######################
