#######################
# #       # #       # #
# # ##### # # ##### # #
# #     # # #     #   #
# ### ### # ##### ### #
#   #   #   #     #   #
# ##### # ### ####### #
#       #   #       # #
# ##### ####### ### ###
#   # #       #   #   #
### # ##### # ### ### #
#   # #     #   #   # #
# ### # # ##### ### # #
# #   # #   #   #   # #
# ### # ##### ####### #
#     #   #     #   # #
##### ##### ### # # # #
#     #   # #   # #   #
# ##### # # ##### ### #
# #   # # #     #   # #
# ### # # # ### ### # #
#   #   #   #       # #
#######################
