#######################
#             #     # #
# ########### # ### # #
#           #   #   # #
# ##### ### ##### ### #
# #     #   # #   #   #
### ######### # ### ###
#   #         #   #   #
# ### ##### ##### ### #
# #     #     # #   # #
# # ### ##### # ### # #
# #   #     #   # #   #
# ####### ### ### ### #
#       # #       #   #
# ### ### # ####### ###
#   #   # # #     #   #
# ##### # ### ### # # #
# #       #     # # # #
### ############# # ###
#       #     #   #   #
# ####### ##### ##### #
#         #           #
#######################
