#######################
#     #         #   # #
# ### # ### # ### # # #
# #   #   # #     #   #
# # ##### # ##### ### #
# #       #     # #   #
# ####### ####### # ###
#   #     #     # # # #
##### ##### ### # # # #
#   # #   # #     # # #
# # # # ### ####### # #
# # # # #     #   #   #
# # # # ##### # # #####
# #   #   #   # # #   #
# ####### # ### ### # #
# #       #   #     # #
# ##### # ### ####### #
#       # # #         #
# ######### ####### ###
# #     #     #   # # #
# # ### # ### ### ### #
#   #     #           #
#######################
