#######################
#   #       #   #     #
# # # ##### # # # # # #
# #       #   # # # # #
# ####### ### # ### ###
#     #     # #   #   #
##### # ############# #
#     # #         #   #
# ### # ##### ### # # #
# # # #     #   #   # #
# # # ##### ### ##### #
# # # #     #   #     #
# # # ### ### ### #####
#   #   # # # #   #   #
##### # # # # ### # # #
# #   # #   #   # # # #
# # ### # ### # ### # #
# # #   #   # #     # #
# ### ##### ######### #
#   #   # #     #   # #
# # # ### ##### # # # #
# #           #   #   #
#######################
