#######################
#           #       # #
# # ####### ##### # # #
# #       #     # #   #
# # ##### ##### # ### #
# # #   # #   #   #   #
### # ####### # #######
#   #         #       #
# ##### ### ######### #
#       # # #     #   #
# ### ### # # ### # ###
#   # #     #   # #   #
### ### ####### # ### #
# # # # #   #   #     #
# # # # # ########### #
# # # #   #         # #
# # # # ### ##### # # #
# # #   #   #   # # # #
# ##### ####### # # # #
#     #   #     # # # #
# ####### # ### # ### #
#           #   #     #
#######################
