#######################
#     # #             #
# ##### # ####### ### #
# #     # # #     #   #
# ### # ### # ### # ###
#   # # #     # # # # #
### # # # ##### ### # #
#   # # # #       # # #
# ##### # ### # ### # #
#     #       # #     #
##### ######### ##### #
#   # #   #       #   #
# ### # # ####### # ###
#   #   #       # # # #
# # ##### ##### ### # #
# #     #   # #     # #
### # ##### # ####### #
#   # #     #     #   #
# # ### ####### # # # #
# # #   #     # # # # #
# ### ### ### # # ### #
#         #     #     #
#######################
