#######################
# #     #           # #
# # ### # # ####### # #
# # # # # #   #   #   #
# # # # ### # # # ### #
#   # #   # # # # # # #
# ### ### ### ### # # #
#     #   # #   #     #
### ### ### # # ##### #
# # #   # # # #     # #
# # # ### # # ##### # #
#   #     #   #     # #
# ####### ##### ##### #
# #         #   #   # #
# # ### ##### ### # ###
# #   # #   #   # #   #
# ### ### # ### # ### #
#   #   # #     # #   #
####### # ##### # # # #
#       #   #   # # # #
# ######### # ##### # #
#           #       # #
#######################
