#######################
# #           #       #
# # # # ##### ##### ###
# # # # #   #     #   #
# # ### ### ##### ### #
# # #     #     #     #
# # # ### # ##### ### #
# # # #   #     #   # #
# # # # ####### ### # #
# # # #       #   # # #
# # # ####### # # ### #
# # # #   #   # #   # #
# # # ### # ### ### # #
#   #   # #   # #   # #
####### # ### # # ### #
#     #     # # #   # #
# ### ####### # ### # #
#   # #     # # #   # #
# ### # # # # # # ### #
# #   # # #   # #   # #
# ### ### ##### ### # #
#   #     #       #   #
#######################
