#######################
#   #     #   #       #
# # # # ### # ##### # #
# # # #     #       # #
### # ### ########### #
#   # # # #     #   # #
# ### # # ### ### # # #
# #     #   #   # # # #
# # ####### # # # # # #
# # #     # # # # #   #
# # ### # # # # # #####
# # #   # # # #   #   #
# # # ### # # ####### #
#   # #   # # #       #
##### # ### # ### ### #
#     #     #   #   # #
# ##### ####### ### # #
# #     #     #   # # #
# ####### ####### # # #
#         # #   #   # #
# ##### ### # # ##### #
#     #       #   #   #
#######################
