#######################
#       #   #         #
##### # # # # ### #####
#     #   # #   #     #
# ######### ### ##### #
# #       # #       # #
# # ##### # # ####### #
# #     #   # #       #
# ##### ##### # ##### #
# #   #   #   #   #   #
# # # ### ### ### # ###
#   #   #   #   # # # #
# ##### ### ##### ### #
# #   #   #       #   #
# # ##### ######### ###
# #     # #       # # #
# ##### # ####### # # #
#     # # #         # #
##### # # # ### ##### #
#     # # #   # #     #
# ##### # ### ####### #
#       #             #
#######################
