#######################
#     #     #       # #
# # ### ### # # # ### #
# #       #   # #     #
##### ##### ### ##### #
#   # #   # #   # #   #
# # ### # ### ### # ###
# #     #   # #   #   #
# ######### # ### ### #
#   #   # #   #   #   #
### ### # # ##### # ###
#       #   #   # #   #
# ####### ##### # ### #
# #     #       #   # #
# ### ####### ##### # #
#   #       # #     # #
# # # # ##### # ##### #
# # # #     # #   #   #
### # ##### # ### # ###
#   #     # # # # # # #
# ####### # # # # # # #
#     #   #     #     #
#######################
