#######################
# #   #     # #       #
# # # # ### # # ##### #
# # #   #     #     # #
# # ##### ####### ### #
# #     #   # #   #   #
# ##### ##### # # # ###
#     #       # # # # #
# # ### ##### # ### # #
# #       # # #   #   #
# ##### # # # ### # ###
# # #   # # #   # #   #
# # # ### # ### # ### #
#   # # # #     #   # #
### # # # ##### ##### #
# # # # #     # #     #
# # # # ### ##### ### #
#   # #   #   #   #   #
# ### # # ### # #######
# # # # #   #   #     #
# # # # ### ##### ### #
#   #   #         #   #
#######################
