#######################
#   #     #       #   #
# # ### # ####### # # #
# #     #   #   # # # #
# ######### # # # # # #
#   #     #   # #   # #
# # # ### ##### ##### #
# # # #     #   #     #
### # # ##### ### ### #
#   # # #   #   # #   #
# ##### # # ### # #####
# #   #   #     #     #
# # # # ######### ### #
# # # #   #       #   #
# # # # # # ####### # #
#   # # # #   #     # #
##### # # ### # ##### #
#     # # #   #   # # #
####### # ##### # # # #
#       #     # # # # #
# ### ####### ### # # #
#   #       #     #   #
#######################
