#######################
#   #       #     #   #
### # ##### # ### ### #
#   # #     #   #     #
# ### # ##### # ##### #
#     #   #   #     # #
# ####### ####### # # #
#       # #     # # # #
####### # # ### ### # #
#       #   #   #   # #
# ############### #####
#     #   #     #     #
##### ### # # ### ### #
#   #   #   # #   # # #
# ##### ##### # ### # #
# #   #   #   #   # # #
# # # ### # ##### # # #
# # #   # #         # #
# # ### # ########### #
# #   # #       #   # #
# ### # ####### # # # #
#     #           #   #
#######################
