#######################
#     #     # #       #
### # ### # # # # #####
#   #     # #   # #   #
# ### ### # ##### # # #
#   # #   #       # # #
# # # # ######### ### #
# # # #   #     #   # #
# # ##### # ### ### # #
# # #   # #   #   #   #
# # # # # ### ### #####
# #   # #   #   #     #
### ### ### ##### # ###
#   #   # #     # #   #
# ### ### ##### ##### #
# # # #     # #       #
# # # # ### # ####### #
# # # #   #     #   # #
# # # # # ####### # # #
#   # # #   #   # #   #
##### # ### # # # #####
#     #   #   #       #
#######################
