#######################
#   #     #           #
# # # ### # ######### #
# # # # # #     #     #
# ### # # ##### # #####
#     # #   #   #     #
# ##### ### # ####### #
# #       #   #     # #
# # ####### ### ### # #
# #   #   #     # # # #
# ### # # ##### # # ###
# #   # #       # #   #
# # # # ######### ### #
# # # #   #         # #
### ##### # # ### ### #
#         # #   # #   #
# ######### ### ### ###
#   #   # #   #   #   #
### # # # ### ### ### #
# #   # #   #   #     #
# ##### ### ### ##### #
#           #   #     #
#######################
