#######################
#       #         #   #
# ##### # ##### # # # #
#   #   # #     # # # #
# # ##### # ##### ### #
# #       #   #       #
# ########### ####### #
#     #     #       # #
##### # ### ####### # #
#   # #   #     # # # #
# # # ####### # # # # #
# # # #   #   #   # # #
# ### # # # ##### # # #
# #     #   #     # # #
# # ############### # #
# #   #             # #
# # ### ############# #
# # #   # #   #   #   #
# # # ### # ### # ### #
# # # #   #     #     #
# # # # ### ###########
#   #   #             #
#######################
