#######################
#           #       # #
# ######### # ##### # #
# #       # # # #     #
# # # ##### # # # #####
# # # #     # #   #   #
# # ### ##### ##### # #
# #     #   #       # #
# ####### # # ####### #
# #     # #   #       #
# # ### # ####### #####
#   #   # #     #   # #
##### ### # ####### # #
# # #   # #   #   #   #
# # ### # ### # # # # #
# # #   #     # # # # #
# # # ########### # # #
# #   #           # # #
# # ### ##### ##### # #
# #     #   #       # #
# ####### # ######### #
#         #           #
#######################
