#######################
#           #   #     #
##### ### # # # ##### #
#   # #   #   #       #
# # ### ############# #
# # #   #           # #
# # # ##### ### ##### #
# #   #   # #   #     #
# # ### # ### ### #####
# # #   #   #       # #
# ### ##### ####### # #
#   #   #         # # #
# # ### # ####### # # #
# #     # #   # # #   #
# ##### # # # # # #####
#   # # #   #   #     #
### # ######### #######
#   #         #     # #
# ####### ######### # #
# #     #     #   # # #
# ##### ##### # # # # #
#           #   #     #
#######################
