#######################
# #     #   #     #   #
# # # ### # # # # # # #
#   #   # #   # # # # #
# ##### ####### # ### #
# #   #       # #     #
# ### ####### # ##### #
#     #   #   # #     #
##### # # # # # # #####
#   #   # # # # #     #
# # ##### # # # ##### #
# #     # # # # #   # #
##### ### # ### # # # #
#     #   #   # # # # #
# ### # ##### # ### # #
# #   # #   # #   # # #
# ##### ### # ### # # #
# #   #   # #   # # # #
# # # ### # ### # # # #
# # #     # #   # # # #
# # ####### # ### # # #
#           #     #   #
#######################
