#######################
#     #         #   # #
# # # ### # ##### # # #
# # #     # #     #   #
# # ################# #
# #               #   #
# ########### ### # ###
# #     #   # #   #   #
# # ### ### # ####### #
# # #   #   # #     # #
# # # ### ### # # ### #
#   # #     #   # #   #
##### ##### # ### # ###
#           # # #   # #
# ######### # # ##### #
# #       # # #   #   #
# # ##### ### # # ### #
# #   # #   # # #   # #
# ### # ### # # ### # #
# # # #   # #   #   # #
# # # # # # ##### ### #
#   #   # #           #
#######################
