#######################################
#   #         # # # #   # #   #       #
### ######### # # # ### # ### # #######
#   # # #     # # # # #   # #     #   #
### # # ##### # # # # # ### ### ##### #
# # #   #     # # # #   # #   #     # #
# # ### ##### # # # # ### # ### ##### #
# # # #   # # # # #   #   #       # # #
# # # ### # # # # # ### ### ####### # #
# #       #   #   #       # # #   # # #
# ####### ### # ######### # # # ### # #
# #   # # #     #   # # # # #     # # #
# # ### # ##### ### # # # # # ##### # #
#   # # # #     #     #   #     #     #
# ### # # ##### # ####### # ##### #####
#   #   #   # #   # #       # # #     #
### # ##### # # ### ### # ### # # ### #
# #             # #   # #     # #   # #
# ############# # # ### ####### # #####
# # #     #   #   # # # #   # #     # #
# # ##### ### ### # # # # ### # ##### #
#   #   # #   #   # # #   #         # #
### ### # ### # ### # # ### ####### # #
# # #         #     # # #   #     #   #
# # ######### # ##### # # ### #########
# # #   #         #             # #   #
# # ### ####### ### ##### ####### # ###
#     # #   #   #   #   #           # #
### ### ### ### # # # ############### #
# # # # #   # #   #     # #     #     #
# # # # ### # # ######### # ##### #####
# # #   #   # # #       # # #         #
# # ### ### # # # ####### # # # # #####
#                   #         # #   # #
########### ### ##### ### ### ####### #
# # #       #       #   #   #       # #
# # ####### ### # ### ####### ####### #
#           #   #           #         #
#######################################
