#######################################
#       #   #         #   # # #   # # #
####### ### ####### # # ### # # ### # #
#       #   #   #   #   # # #       # #
####### ### ### ##### ### # # ####### #
#     #     # # #   #   # # #   # # # #
# ### # ### # # ### # ### # # ### # # #
# #     #             #           #   #
################### ### ####### ### ###
# # # #   # #       # # #     # #   # #
# # # ### # ####### # # # ####### ### #
#                     #       #   # # #
##################### # ####### ### # #
#         # # #     #           # #   #
####### # # # ### # # ########### # ###
#       #   # #   #         # # # #   #
########### # ##### ### ##### # # ### #
#                 #   #     #         #
# # # # ######### # # # ##### ##### # #
# # # # #           # #     # #   # # #
########### # ##### ######### # #######
#           # #         # #           #
# ### # ### # ##### # # # # ###########
# #   # #   #   #   # #               #
############# # # # # # ### ##### # # #
# #           # # # # #   #   #   # # #
# ######### # # # # # # ######### #####
#           # # # # # #         #     #
### # # ### ### ##### # # ### ### # ###
#   # # #     # #     # # #     # #   #
### ####### # ### # # ####### # # ### #
#   #       # #   # #       # # #   # #
### # ##### # ##### # # # # ### ##### #
#   # #     # #     # # # # # #     # #
### # # # # # # # # # # ### # #########
#   # # # # # # # # # # #       #   # #
# # # # ##### ### ### # # ##### # ### #
# # # # #     #     # # #   #         #
#######################################
