#######################################
#   # #     # #   #   #         # #   #
### # ##### # ### ### # ### ##### # ###
# #   #     # #   # #     # # #   #   #
# ### ##### # # ### # # ##### # ### ###
# # # # # #     # #   #   # # # # # # #
# # # # # ### ### ### ##### # # # # # #
#   #     #     # # # #     # # # #   #
### ### ### ##### # # # ##### # # # # #
#     # #   # # # # #     # #   # # # #
##### # # ### # # # # ### # # ### # ###
#     # # # # #         #       # #   #
##### # # # # # ################# # # #
#   # # #       #                   # #
### # # # ####### #####################
# #   #   #       # # # #           # #
# ### # ### ####### # # # ########### #
#   #       # #       #   # # #     # #
# ##### ##### # ####### # # # # ##### #
# # #       #   #   #   # #     # #   #
# # # # ##### ### ### ##### ##### # ###
#     # # #       # #   # #           #
# ####### # ####### # ### # ###########
#     # # #     #           #     # # #
# ##### # # ##### ####### ### ##### # #
#                       #             #
# ### # ### ######### ### # ###########
# #   #   #         #   # #           #
### ### # # ### ################# #####
#     # # #   #                 #     #
# ### ##### ### ####### # # ##### #####
#   #     # #       # # # #     #     #
# ##### # # ### # # # ##### ######### #
#     # # # #   # #       #   #     # #
# ### ##### # # # ### ######### #######
#   #     # # # # #         # #     # #
# ### ### ##### ######### ### # ##### #
#   #   #   #           #             #
#######################################
