#######################################
# # #         #     #   #   #       # #
# # # # ### ####### ### ### ##### ### #
#     # #         # # #     #     #   #
######### ####### # # ##### ##### ### #
#         #   #           #     #   # #
### ######### ########### ##### ### # #
#     #             #   #             #
### ############### ### ##### # ### ###
#   #                         # # #   #
######### # # ########### ##### # # ###
#         # # #           #     #     #
# # # ########### # # # ##### # # # # #
# # # #           # # # #     # # # # #
##### # ########### # # ### # # # # # #
#     # #           # # #   # # # # # #
################### ####### # ##### # #
# # #       #       #       # #     # #
# # ####### ### ####### ######### # # #
#   #   #       #       #         # # #
### ### ####### # ######### # # # # ###
#     #         # #         # # # #   #
##### ### ### # # ####### # # # ### # #
# # #     #   # # #       # # #   # # #
# # # ### ### ### ####### # ### ### # #
#     #   #   #   #       # #     # # #
####### ####### # # # # # ### ##### # #
# #     #       # # # # # #     #   # #
# # # # # ### ### ##### ### # # ##### #
# # # # # #   #   #     # # # # #     #
# ########### # ### ### # ### ### ### #
#             #   # #   #     #   #   #
######### # # # ####### ### ### ##### #
#         # # #   #     #   #     #   #
######### ##### # ### # # # ### ##### #
# #       #   # # #   # # # #   #     #
# ####### # ### ##### # # # ### ### # #
#         #     #     # # #   #   # # #
#######################################
