#######################################
#                                   # #
# ########### # ### # # ##### ##### # #
# #       #   # #   # # #     #       #
### ##### ####### ####### # ######### #
#   #       # #   #       # #   #     #
##### # ### # ####### # ####### # # # #
#   # # # #           # #         # # #
### ##### ######### # ### ##### # # # #
#                   # #   #     # # # #
### ##### # ### ### ####### # # # ### #
#   #     # #   #   #       # # # #   #
### # # ####### # # ########### # # # #
#   # # #       # # #   #       # # # #
# ### ####### ### # # # ######### # # #
#   # #       #   # # # # #       # # #
########### ### # # ### # ##### # ### #
#   # #     #   # # #           #   # #
### # # # # # # ### ### # # ### ### # #
#       # # # # #   #   # #   #   # # #
# # # # ### # ### ######### # # ### ###
# # # # #   # #   #         # # #     #
### ####### ####### # ######### # # # #
#     #     #       # #         # # # #
##### # # # ##### # # ##### # # ### # #
#     # # # #     # #   #   # #   # # #
# ### # ### # # # ####### ##### ##### #
#   # # #   # # # #         #   #     #
# ### # ############# # # # ### # # # #
#   # # #             # # #   # # # # #
### ### ############# # ### ######### #
#   #   # # #         # #           # #
######### # ####### # # # # # ### # # #
# #                 # # # # #   # # # #
# ### # ### ######### # ##### ####### #
# #   # #   #         # #         #   #
# ##### ######### # ####### ### ##### #
#           #     # #         # #     #
#######################################
