#######################################
# #           #     #     #   # #     #
# ########### ##### ### # ### # ##### #
#   #     # # #         #             #
### # ### # # ######### ########### # #
# #   # #     # #     # #           # #
# ##### # # ### ##### ##### ######### #
#       # #       #         #         #
####### ### # ### # ########### # ### #
#     #     # #     # #         # #   #
# # # ############### ############# # #
# # # # # #       #                 # #
##### # # ####### # # ########### # ###
#                   # #       # # #   #
### ####### ### ############# # ### # #
# # # #     #   # #                 # #
# # # ########### ### ##### # # # # # #
# # #     #           #     # # # # # #
# ##### # ##### # # # ### ### ##### # #
#     # #       # # # #     # #     # #
# # # ##### # ### ######### # # ### ###
# # #     # # #   #         # # #     #
####### # ##### # # ### # ### # # ### #
#       #       # # #   #   # # #   # #
# # # ### ######### ### # # ##### # ###
# # #   # #         #   # # #     #   #
# # # ####################### # # # ###
# # # # #   # #               # # #   #
####### # # # # ####### # # # # ### # #
#     #   #     # #     # # # # #   # #
##### # ######### # ##### # ##### ### #
#   #   #           #     #     #   # #
### # ##### ### # ### ### ### ### #####
# #   #     #   #   # #   #   #       #
# ### ### ##### ##### # # ### # # # ###
#     #   #     #     # #   # # # #   #
########### ### ##### # # ### ### ### #
#           #       # # # #     #   # #
#######################################
