#######################################
# #     #   # # # #                   #
# # ##### ### # # # # ######### ##### #
# # #   # #         #     #         # #
# # # ### # ##### # # ### ### ### ### #
# # #           # # #   #   #   #   # #
# # # ####### # # ### ### ####### ### #
#           # # #   #   #       #   # #
### # # ######### ##### ###############
#   # #         #     #               #
# ### # # # ######### # # ####### #####
#   # # # #         # # #       #     #
# # # # # # ##### ####### ### # # #####
# # # # # #     #       #   # # #     #
# ##### # ### # ##################### #
#   #   #   # #                     # #
# # # # ##### # ######### # ###########
# # # #     # #         # #           #
# # ##### # # # ##### ####### ####### #
# #   #   # # #   #         #       # #
# ####### ################### # # #####
# #             #   #       # # # #   #
# # # ##### ##### # # # ### # ####### #
# # # # #       # #   #   # #   #   # #
# # ### # # ##### # ### ######### ### #
# #     # #       #   #       # #     #
# ### # ##### ### # # ######### # #####
#   # #     # #   # # #     #   # # # #
### # # # ### ### # # # ##### ### # # #
#   # # #   #   # # #               # #
# # ### ### ### # # # ####### ### ### #
# # #     #   # # # #       # #       #
# ##### # # # # ### # ##### # # # # # #
# #     # # # # #   #     # # # # # # #
# ### ### # # ### # # # # ### # ##### #
#   # #   # #   # # # # #   # #   #   #
# ####### # ##### ### ### ######### ###
#       # #     #   #   #       #     #
#######################################
