#######################################
#     #   #             #     # # #   #
# ##### ##### ############# ### # ### #
#     # # #   #   # #   #     #   # # #
# ##### # ### # ### # ##### ##### # # #
# #   # # # # #     # # # # #     # # #
# # ### # # # # ##### # # # ##### # # #
#   # # # #   # #   #   #   #   #   # #
### # # # ### # # ### ### ##### ### # #
#     # #   #                 #   #   #
### ### ### # ################### # ###
#     #   #       # # # # # #     # # #
##### # ### ####### # # # # # ##### # #
#       #   #     # # #   # #       # #
# # ### ### # ##### # # ### # ####### #
# # #       #   # # #   #   #         #
####### ##### ### # # ##### ### ##### #
#   # #   # # # #       #           # #
# ### # ### # # # ######### ######### #
#   #   # # # # # #   #   # #     # # #
### ### # # # # # ### # ### # ### # # #
# #   # # # # #   #   # #       #   # #
# ### # # # # # ### ### # ### ### # ###
#   #         #   # #       #   # #   #
# ##### ####### ### ### # # ###########
# # # # # # #           # #     # #   #
# # # # # # # ######### ### ##### # ###
# #   #             # #   #           #
# ### # ##### ####### ####### ##### ###
#     #     # #             #     #   #
##### # # # ### # ### ### # # #########
#     # # #     # # # # # # # #       #
##### # # # # ##### ### ##### # ### # #
#       # # #               #     # # #
### ### ##################### # # # ###
#   #           #       #   # # # #   #
# # ### ######### ##### # # # # ##### #
# #   #               #   # # #     # #
#######################################
