#######################################
# #         #       # #     # #     # #
# ######### ####### # ##### # ##### # #
#   #   # # #               #   # #   #
### ### # # ############### ### # # # #
# #       #     #   # #       # # # # #
# ##### # ##### ### # ##### ### # # # #
#   #   #   # # #     # #           # #
### ####### # # # ### # # # # ### #####
#     #           #       # #   #     #
##### ### ### ### # # ### # # ##### ###
#         #   #   # # #   # # #       #
### # ### # ####### ### ### # ### # ###
#   # #   # #       #   #   #   # #   #
# # # ##### # # # # # # # ### ### ### #
# # #   #   # # # # # # #   # #   #   #
# ### # ##### # ### ### # # ### # # # #
#   # # #     #   # #   # # #   # # # #
# ### # ### # ### # # ### # ### ### # #
# #   # #   # # # # # #   # #   #   # #
# # # ######### ##### ### ##### ##### #
# # # #               #   #     #     #
# # ##### ### # # ##### ##### # # # # #
# #   # # #   # # #     #     # # # # #
# ### # # # # # # # ### # # # # # # # #
#   # #   # # # # # #   # # # # # # # #
####### # # ### ####### ##### # # # # #
#   #   # #   # #   # #   #   # # # # #
# # ### ### # ### ### # # ### # # # ###
# #     #   # #         # #   # # #   #
##### # # ### ######### ##### # # #####
#     # # # #   #           # # #     #
### ####### # ######### # # # # # # # #
# #   #         #       # # # # # # # #
# # # ### ### ### ### ##### ### # ### #
#   # #   #   # # # #     # #   # #   #
############# # ### # # ### # # # # # #
#               #     #   # # # # # # #
#######################################
