#######################################
#           #   # #                   #
########### ### # ##### # #############
#                 # # # # #   # #   # #
####### ######### # # ### # ### # ### #
# #     #       # #   #       #   # # #
# ##### ####### # ### ### ### ### # # #
#   #   #     #             # # # # # #
# # # ##### ######### # ####### # # # #
# #   # # #     #     # # #     #     #
##### # # ##### ####### # # ##### #####
#     #             # # # # #   # # # #
##### # # ######### # # # # ### # # # #
# #   # # #           # #   # # #     #
# ### # ############# # # ### # # #####
#     # #   # #       #     #     #   #
########### # # ##### ##### ### ### ###
#     # #   #   #   #       # #   #   #
### # # ### # ##### ####### # # ### ###
#   #       # # #   #           #     #
##### ### # ### # # # ####### ### #####
#     #   # #     #   #               #
### # ##### ####### ####### ### # #####
#   # # #           #     #   # #     #
####### ####### ####### # # # # # # ###
#   #       #   #       #   # # # #   #
### ####### ##### ### ##### # ### # ###
#   #             #   #     #   # #   #
# # ### ####### ##### ### ### ### # # #
# #     #       # #   #   #   #   # # #
# ### ### ### ### ### ##### # # # # # #
# #   #   #     #     #     # # # # # #
##### ##### ### # # # ##### # # ##### #
#     #     #   # # # #     # #   #   #
################### # # # # ### # # # #
# # #         # #   # # # #   # # # # #
# # ######### # # ### ##### ######### #
#                 #   #           #   #
#######################################
