#######################################
# # #   # # # # #   # #   #       #   #
# # # ### # # # # ### ### # ######### #
# # # # #   # #   #     # #       #   #
# # # # ### # ### ##### # # ####### ###
#   # # # #   # # #     #     # # # # #
### # # # # ### # ##### # ##### # # # #
#     # #   # # # # #   # # #         #
# ##### ### # # # # ### # # # # #######
# # # # # # # #   # #       # #       #
# # # # # # # ### # ##### ### #########
#   # #   #     #   #   #   #   #     #
# ### ### # ##### ##### # ### ### #####
#   # # #         # #         # # # # #
# ### # ### ### ### # ### ##### # # # #
#     # # #   # #     #       # #     #
# ##### # # ############# ##### # #####
# #   # # # #     # # # #   #         #
# # ### # # # ##### # # # ##### ##### #
#     # # #     #   # # #           # #
##### # # # ##### ### # # ####### ### #
#         # # #               # #   # #
### ### ### # # ##### ### # # # #######
#   #               #   # # #       # #
# ### # ############# ### ######### # #
# # # # # #         # #           #   #
### ### # # # ##### ##### # ### # ### #
# # #       #     #     # #   # # # # #
# # ### ### ### # ########### ##### ###
#       #     # #         #     # #   #
# # ### # # # # ##### # # # # ### # ###
# # #   # # # #     # # # # #         #
# # # # # ##### ######### # # ##### ###
# # # # #     #         # # #     #   #
# # # # ### ###########################
# # # #   #                   #   # # #
### # ### ############### # # # ### # #
#   # #               #   # #         #
#######################################
