#######################################
# #   #                   # # #       #
# # ####### ############### # # ### # #
#   # #     #   #       # # # # #   # #
### # ##### # ### ####### # # ##### ###
#   #   # # #                 # # # # #
# ### ### # # ### ############# # # # #
# #     #       #   # #         #   # #
# ### ######### ##### ### ####### ### #
# # #   # #         # #     #   #     #
# # # ### ##### ##### ### ### # # #####
#   # # #     #       #       # #     #
# ### # # ##### ######### # ##### #####
# #       # #     # # #   #     #   # #
# ### ##### ### ### # ### ### ### ### #
# #   #     #   # #   #     # #   # # #
# ### # ####### # ### ### ##### ### # #
#   # #   #   # #   #     #     #     #
# ### # ### ### # ##### ### ##### ### #
#   # # #   # # #       # #   # #   # #
### # # # ### # # # ##### # ### # ### #
#   #         # # # #   # # # # # # # #
### # ######### # ### ### # # # # # ###
#     # # # #                         #
##### # # # # ######### ######### # # #
# # #           #     #       # # # # #
# # ### ### # ### ### # # ##### ### # #
# #       # #       # # #     #   # # #
# ### ####### ### ##### ### ### ##### #
#           # # #   # # # #     # #   #
# # # # ####### # ### ### ##### # ### #
# # # #         #       #     # # # # #
# # # # ### ############# ####### # ###
# # # # #             #   # #   #   # #
# ##### # # # ### ##### ### # ### ### #
#     # # # #   #           # #     # #
# # ####### ####### ######### ### ### #
# # #             #                   #
#######################################
