#######################################
# #   #           # # # #   #   #     #
# ### ########### # # # ### # ### #####
#           #     #         # # #     #
# ######### ##### ######### # # ### # #
# #                               # # #
##### # # ################### ##### ###
#     # # #           # #             #
####### ####### ##### # # # ### #######
#       #       #   #     #   #       #
# # # ####### ##### # # # # # # # # ###
# # # #   #   #       # # # # # # #   #
# # # # # # # ### ### # # ### ### ### #
# # # # #   # #   #   # #   #   #   # #
################# # # ##### # ####### #
#                 # #   #   #       # #
# ####### ############# ##### # ##### #
# #       #   #       # #     #     # #
# ########### ##### # ##### # # ##### #
# # #               #       # #     # #
### ########### ####### ### ### #######
# #   #         #         #   #       #
# ### ##### ######### ### # ######### #
# #         #         #   #       #   #
# ############### ##### # # # # ##### #
#   #             #     # # # #     # #
### ####### ### # # # ### # # ### #####
#   # #     #   # # #   # # #   #     #
### # ####### # # # ##### # # ####### #
#             # # #   #   # #       # #
### ######### ### # ### ### ####### ###
#   #         #   # #     #   #   #   #
# ### ####### ##### # ### # # # # ### #
# # # #   #     #   # #   # #   # #   #
### ##### # # ### # # # # # ###########
#   # #     # #   # # # # #           #
# # # ### # ### # ##### # # # # ### ###
# #       # #   # #     # # # #   #   #
#######################################
