#######################################
#     # # #   #     # # #     #   #   #
##### # # ### ##### # # # ##### ### ###
#     # # # #     #     #   # # # #   #
# ##### # # ##### ##### # ### # # ### #
# # # # # # # #       # # #   #     # #
# # # # # # # ####### # # # ##### ### #
# #     #   #   # # # # #     #   # # #
# ##### ### ### # # # # # ####### # # #
#       #       # # #   #     #     # #
####### ####### # # # ##### ##### ### #
# #                   # # #   # # # # #
# ########### ##### ### # ### # # # # #
#     # #     #         # #     #     #
##### # # ############# # # ##### #####
#     # # #       #   #     #   #     #
##### # ######### ### ### ### ### #####
#               #                     #
# # ####### # # # ### # # ####### # # #
# # #       # #   #   # #     #   # # #
# # ##### ### # # # # ### # # # #######
# # #     #   # # # #   # # # #       #
# ####### # ### ### # # ### # # # #####
#   #     #   # # # # # #   # # # # # #
####### ### # # # ### # # # # ##### # #
# #     #   # # #     # # # #         #
# # # ##### # ##### ### # ### ##### # #
# # # #   # # #     #   # #       # # #
# # # ### ######### ### ####### ### # #
#   # #     #       #         # #   # #
# ### ### # ### # # ##### ####### # # #
# #   #   #     # # #           # # # #
# # # # # ##### # ### # # # # ##### # #
# # # # # #     #   # # # # #     # # #
##### ############# ### # ### ####### #
#       # #     #   #   #   #       # #
# # # # # ##### ### ### # ### # ### ###
# # # # #             # #   # #   #   #
#######################################
