#######################################
# #   #       #             # #       #
# # ### ##### ############# # ####### #
# #   # #                 #   #   #   #
# ### ### # # # # ### ### # ### ### # #
#         # # # # #   #             # #
##### # ######### ##### ### ##### # # #
#     # # #       #     #     #   # # #
##### # # ########### ####### # # # # #
# # # # #   #   # #   #       # # # # #
# # # # ### ### # ### ##### # ####### #
#   # # #     #       #     #     #   #
### ####### # ### ### # # # ######### #
#         # #     #   # # #     #     #
# # ##### ##### ######### ### ### ### #
# # #         # #           # #   #   #
####### # ### ### # # ### # # # # # # #
#       # # #     # #   # # # # # # # #
### ### ### ######### # # # ### ##### #
#   #   #             # # # #     #   #
####### ### ####### ##### ####### ### #
#       #   #         #         # #   #
# # ##### ##### ### ### ### # ####### #
# #   #   #     #   #     # # #       #
############### # ##### # ### ##### # #
#   #   #       #     # #   # #     # #
# ### # ### ####### ### # ##### ### # #
#     #     #       #   # # # # #   # #
####### ####### ####### ### # ### # # #
#     # # #       #       #       # # #
# # # # # # # # # ##### ####### # # # #
# # #   #   # # #   #       #   # # # #
# ##### ### # # # ##### # ####### # # #
# #     #   # # # #     #       # # # #
# ######### # # # # ### # # ##### ### #
#     #     # # # # #   # #   #     # #
######### ### # ##### ### ### # # #####
#         #   #   #   #   #   # #     #
#######################################
