#######################################
#   #   # # #     # # #         #   # #
# ### ### # # ### # # # ######### ### #
# #       #   #   #         # #   #   #
# ####### ####### # ######### # ### ###
#                 # #     #       #   #
################# # # ##### ##### ### #
#   # #   #       # #     #     # # # #
### # ### ####### # # ##### ####### # #
#   #                     #   #   #   #
### ############# ######### ### # # ###
#   # #       # #   #     #     #     #
### # ####### # # ### ##### ### #######
# #   # # #           #     # # #   # #
# ### # # ##### ##### # ##### ### ### #
# #       #         # # # # #   # # # #
# ##### ##### # # # ### # # # ### # # #
# # #   #     # # #               #   #
# # ### ############# # # # # ##### ###
#       #             # # # #         #
####### ### ####### # # # ##### ### # #
# #   #     #       # # #     #   # # #
# ### ####### # # ### # ##### # # # ###
#         #   # #   # #     # # # # # #
### ##### # ### # # # ### ####### # # #
#     #     #   # # # #         # #   #
####### # # # # # ##### # # # # ### # #
#       # # # # #     # # # # # #   # #
# # # ### # ### ### # # ### # ####### #
# # # #   #   #   # # # #   #     #   #
# ### # # # ### ### ### ### # # ### ###
# #   # # #   #   #   # #   # #   #   #
### # ##### # # ### ### # ### # ### # #
#   #   #   # #   #   # # #   #   # # #
### # ####### # # # ##### ### ### ### #
#   #   #     # # #     # #   #     # #
### ### ##### # ### ##### ##### ##### #
#   #   #     #   #     #   #   #     #
#######################################
