#######################################
#   #   #       # # #   #   #         #
# ##### ####### # # # ##### ####### ###
#   # # # # # #   # # # # # #   # # # #
# ### # # # # ### # # # # # # ### # # #
#   # # #     # # # # # #     #   #   #
### # # ##### # # # # # ##### # ##### #
#     #   # #   # #   # # #   #   # # #
##### ### # ### # ### # # ### ### # # #
# # #     #   # # # #   # #   #   # # #
# # ### ### ### # # # ### # ##### # # #
# #     # #       #   # # #   # #     #
# # ### # ####### ### # # ### # # #####
# # #             #   # # # # # # #   #
# ##### ######### ### # # # # # # # ###
# # #   # #       # # #   #   # #   # #
# # ##### ####### # # # ##### # # ### #
#     #     #         #   #           #
# # ##### ########### ### ####### ### #
# #     #     #             #   # #   #
# ##### ##### ############# ### # #####
# #           #     # # #     # # # # #
### # ### # ####### # # ##### # # # # #
#   # #   #   #         # #   #   #   #
# ##### ##### ### ##### # ### # ### # #
# #     #         #   #             # #
# ####### # ######### ### ##### ##### #
# #   #   # #             # # # #   # #
##### ### ############# # # # # # ### #
#       # # # #     # # # #   # #   # #
### ### ### # ##### # ####### # ### ###
# # #   # #                           #
# # ### # # ### ### ##### ##### ### ###
#     #   # # # # # # # # #   #   #   #
# ##### # ### ### ### # ### # ### # # #
#     # #                   #     # # #
# # ### ### ### ####### # # # # #######
# #   # #   #   #       # # # #       #
#######################################
