#######################################
# # #                 #               #
# # ### # ### ##### ### ########### # #
#       #   # #   # #             # # #
######### # ### ##### ### ####### ### #
# #       #             #       #   # #
# # ### # # ### ### # ### # # ##### # #
#   #   # #   # #   #   # # #     # # #
# # ### ### # ####### ### # ### #######
# #   # #   #     #     # #   # #   # #
# ### # # # # ### # # ### # # # # ### #
# #   # # # #   # # # #   # # #     # #
# # ### ##### # # # # ##### ### ### # #
# # #     #   # # # #   #   #     #   #
# # # # # ##### # ### ### ### # # # # #
# # # # #   #   #   #   #   # # # # # #
# # ### # ### ### ##### # ##### # ### #
# #   # # #   #     #   #     # #   # #
# # # # ### # ####### # # ### ### # ###
# # # #   # #       # # #   #   # # # #
# # ####### ### ######### ######### # #
# #       # #       #           #     #
##### ########### ####### # # ####### #
#     #     #           # # #     #   #
# ####### # # # ####### # ####### ### #
# #       #   #       # #       #   # #
# ##### # ### ### ##### ##### # # # # #
# #     # #     #     #   #   # # # # #
####### # ### ### ### ##### # # #######
# #     # #     #   #     # # #       #
# # ##### ### # # ### # ##### # #######
#   #       # # #   # #     # #       #
# ### ### # ### ######### ##### ##### #
# #     # # #           # # #   #     #
# # ##### # # # ### # ### # ### ### # #
# #     # # # #   # # #   #   # #   # #
# # ### # # # # ### ######### ### ### #
# # #   # # # #   #             #   # #
#######################################
