#######################################
# # # # # #     # #   #   #   #       #
# # # # # ##### # # ### ##### ##### ###
#   # # # #     # # #   #   # #   # # #
### # # # ##### # # ### ### # # ### # #
#   #               #       #         #
### ### ########### ### ##### # #######
# #     #         #           #       #
# ############### ### #################
# # #   # #       # #       # #       #
# # # ### ### ### # # ####### # ##### #
# # #   # # # #               #     # #
# # ### # # ####### ### ####### ##### #
# #     #   #   # #   #           #   #
# ##### # # ### # # ######### ##### # #
#         #   # # #         # # #   # #
### ######### # # # ##### ### # ### # #
#   #           #       # # # # #   # #
########### # ### ######### ### #######
#           #                         #
######### # ### # # ### ##### ### # ###
#         #   # # #   #   # #   # #   #
### ### # # # # # # # # # # ##### # # #
# # #   # # # # # # # # #       # # # #
# ### ### ### ### ### ### # ### # # ###
#       # #     #   # #   #   # # # # #
##### ### ### # # ### # ########### # #
# #   #   #   # #   # #           #   #
# ### # # ##### ### # # # ### # # ### #
#   # # # # #   #   # # # # # # #   # #
### ####### ### # # ####### ######### #
#               # #         # #   # # #
# ############# ### ### ##### # ### ###
# #             #     #               #
# ### # ### # ### # ###################
# #   # #   # #   #   #         #     #
### ### ########### ### ##### # # # ###
#   #   #                   # #   #   #
#######################################
