#######################################
#         # # # #   #     #   #   #   #
######### # # # ### # ##### ### ##### #
#           #     # # # # #   #   # # #
### # # ### # ### # # # # # ### ### # #
#   # # #     #         # # # # #   # #
### # # ### # ##### # # # # # # ### # #
#   # # #   # #     # # # #         # #
# ##### ##### ##### ### # # ### ##### #
# #   # #     # # # #       #         #
# ### ######### # ####### ##### #######
# #   #       #   # #   # #           #
### ####### ##### # # # ### # # #######
# # #                 #     # #   # # #
# # ############### ####### ### ### # #
# #   #             # #     # # # # # #
# ### ##### ######### ####### # # # # #
# #         #             #     # #   #
# ##### ### ### ##### ### ##### # # ###
#       # # # # #     #     # # # #   #
# # ##### ### # # ######### # # # ### #
# # #   # # # # # # #   # #     #     #
##### # # # # ##### ### # ##### ##### #
#     #     #     #   #   #   #       #
### ####### ##### ### ### ### ### #####
#   # # #   # # # # #         # # # # #
##### # ### # # # # ######### # # # # #
# # #         #               # # #   #
# # ######### ############### # # # ###
# # #       # # #   #     #   # # #   #
# # ####### # # ### ##### ### # # # ###
# # #       #   # #   #               #
# # # ##### # ### ### ### ### #########
#     #     # #           #           #
### ##### ### ######### ####### ### ###
#     # #           #   # #       #   #
# ##### # ##### ### # ### ### # ### # #
# #       #     #     #       #   # # #
#######################################
