#######################################
# #     # #     # # #           #   # #
# # ### # ##### # # # ############# # #
#   #           #     # #   # #   # # #
######### ### # # # ### ### # # ### # #
# # # #   #   # # #   #   # #       # #
# # # ######### # ##### ### # ####### #
#               #         # #   #   # #
### ##### # ### # # ##### # # ### ### #
#   #     # #     #     #           # #
### ##### ##### # # ####### ######### #
# # # #   #     # #       #           #
# # # # ####### ####### ### ####### # #
#   #   # #     #     #   #     # # # #
# # # ### ### # # # # ### ####### ### #
# # # #       #   # #   #           # #
### ##### ##### # # # ####### # ### # #
#   #   # #     # # #       # # #   # #
####### ### # # # ##### # # ### # # ###
# # # # # # # # #     # # #   # # #   #
# # # # # # # ### # # # # ### ####### #
#           # #   # # # # #     #     #
####### # # ##### ##### ##### ####### #
#       # # #         #     #       # #
### # # ### ####### # # ###############
# # # # #   #       # #         #     #
# # ##### ####### ########### ### # # #
#       # #                 #     # # #
# ### ##### # # # # ##### # ### ##### #
# #     #   # # # #     # # #     #   #
### # ### # # # ### ### ####### #######
#   # #   # # # #   # #     # #       #
# # # ##### # ####### # ##### ### #####
# # #   #   # #                 #     #
# # ### ##### ### # ### ####### # ### #
# # #       #   # # #       #   #   # #
# ##### # ##### ##### ### # ###########
# #     #     # #     #   #           #
#######################################
