#######################################
#       #       # #   #     # # # # # #
####### ####### # # ####### # # # # # #
#   #       #       #     #   #       #
### ####### ### ######### ### ### # ###
# #       # #       # # #     # # #   #
# ### ### # ### ### # # ##### # ### ###
#     #         #         # # # # # # #
############# # # # ##### # # # # # # #
#     #       # # # #       #     #   #
# ### ### ####### # # ##### # ####### #
# #         #     # # #     #   # #   #
# ### ### ### ####### ##### ### # ### #
# #   #     # #       # # #     # # # #
# # ########### ####### # # ##### # # #
# # #         # #       #   # #       #
##### ####### # # ##### ### # ####### #
#     # #   #   # #   #       # #   # #
##### # ### ####### # ####### # # ### #
#   # #         # # #             # # #
### ########### # ####### ####### # # #
# #           #   #       #     # # # #
# ### ### ### # # ############# # # # #
# # # #   # #   #   #   #       # #   #
# # ##### # ### ### ### ##### # # ### #
#         # #   #             #       #
##### ##### ################# ### ### #
#     #         #   #     #   #   #   #
# ######### # # ### ##### # ####### # #
# #   #     # #     # # #   #       # #
##### ############# # # ############# #
# #                       # #         #
# ### ######### ##### # ### # # # # ###
#   # #   #     # #   # #     # # #   #
# ### ### # ##### ##### # ### ##### # #
#     # #   #     #         # #     # #
# # ### ### ### ##### # ##### ##### # #
# # #       #         #   #   #     # #
#######################################
