#######################################
#       # #                         # #
### ### # ######### ################# #
#     #       #   # #       # # # # # #
### ####### ### # # # # ##### # # # # #
# # # #   # # # #     # #         #   #
# ### ### # # ##### ### # ### ##### ###
# #   # # # # # # #   # # # #       # #
# ### # # # # # # # ##### # ######### #
#               # # # #     # #   #   #
############### # # # # ##### # ### ###
#   #     # # #   # #   # # # # #     #
### ##### # # # ### # ### # # # # #####
# # # # #   # #         #         #   #
# # # # ### # ### ####### ##### ### ###
#             #   #     #     # # #   #
##### ### ####### # # ### # # ### # ###
#   # #     # # #   # # # # # #       #
### ####### # # # ##### # ##### ##### #
# #   #     #   # # # # # # #       # #
# ### ##### # ### # # # # # ##### #####
#   #   # # # # #     # #     # #     #
### ### # # # # # ##### ### # # # #####
#             # #   #       #     # # #
# ### # ##### # # ### ##### ### ### # #
# #   # #         #       #   # # # # #
# ######### ### # ### ##### ##### # # #
# # # #     #   #         #       #   #
### # ########### # # ### ######### ###
#   #             # #   #           # #
### ### ##### ### # # # ##### ####### #
#       #     #   # # #     # # #   # #
### ####### ### # # # ### # ### # ### #
#     #       # # # #   # #       #   #
# # # ### # ####### # ### # # # # # ###
# # # #   #     # # #   # # # # # #   #
# ### ### ####### # # ### ### ### # # #
# #     #         # #   # #   #     # #
#######################################
