#######################################
# #   #   #             # # # # #     #
# ### # ### ### ######### # # # # #####
# #   #   #   # #     #         #   # #
# # ##### ### ### ##### ######### # # #
#   # # # # # #         # #   # # # # #
### # # # # # # ####### # # ### # ### #
#                   # #     # #       #
########### # ##### # ##### # # #######
#     #     #     # #     # # #   #   #
# # # ####### ####### ####### # ### ###
# # #         #         #         # # #
### ##### ### # ##### ### ##### ### # #
#   #     #       #         # #       #
### ### # ### # # ### # ##### # # ### #
# #   # # #   # #   # #       # #   # #
# ### # ##### ### ##### # ### # # # ###
#     # #     # #     # # #   # # #   #
### ### # ### # ### ##### ### # ### # #
# # #   # #       #     # #   #   # # #
# ### ### # # ### ##### # ##### ##### #
#     #   # #   #     # # #       # # #
### # # ### # ### # ############# # ###
#   # #   # # #   #   # # #           #
# ### # # ### ######### # ### # ##### #
#   # # # #   #             # #     # #
# # ### ##### # # ########### #########
# # #   #       #         #           #
# ##### # # ### # # # ### # # # # # # #
#     # # # #   # # #   # # # # # # # #
# # # # ####### ### # ### # # # # #####
# # # #   #     # # # #   # # # #   # #
# ### ####### # # ####### ########### #
#   #   #   # #     #   # #           #
# ##### ### # # # ### ##### # # ##### #
#   # # # #   # # #   #     # #   #   #
### # ### ### ##### ### # ######### # #
#   #                   #       #   # #
#######################################
