#######################################
#         # #     # #   #         #   #
######### # # # ### ### ### ### ##### #
#       #     # # # # # # #   # #   # #
### ### ####### # # # # # # ### # ### #
#   #   # #   # # # # #       #       #
# ####### ### # # # # # # # ###########
# #             #   #   # #       #   #
# ############# ### # ##### # # ### ###
#         #         #     # # #       #
### ##### ######### # # ####### ##### #
#   #                 #     #       # #
# ############# ### ############# #####
#   # #       #   #         # # #     #
# ### # ##### ##### # ####### # #######
# #   # #         # #     #       #   #
### # ##### ### # # # ##### ####### ###
#   #         # #   #     #         # #
# # ######### # ### ### ### ### ##### #
# #   #       # #     #       # # #   #
######### ### # # # # ### ####### ### #
#     #   #   # # # #   #         # # #
### ####### # ### # ##### # ####### # #
#     #     #   # #   #   #   # # # # #
##### ### # # ##### # ### # # # # # # #
#         # #     # # #   # #         #
# ### ### ##### # ### # # # # # #######
# #   # #   #   # #   # # # # #       #
# ### # # ######### # # # # ### # #####
# #     #   #       # # # #   # # #   #
### # # ### # ##### # # ####### ##### #
# # # #   # # #     # #       # #     #
# ### # ############### # # # # # # ###
# #   #         #       # # # #   #   #
# # # # ### # ##### # ### ### # # # ###
#   # #   # # #     #   # #   # # #   #
# ### ### ### # # ### # # ### # # # ###
# #   #     # # # #   # #   # # # #   #
#######################################
