#######################################
# #       # #   #   #   #   # # # # # #
# ### ##### ### # # # ### ### # # # # #
# #   # #   #     #   #               #
# ### # ### ### ############# ### #####
# #   # # # # #       # # #     # #   #
# ### # # # # # ####### # # # ##### # #
#     #   # #       # # # # #       # #
##### ### # ### ##### # # # ######### #
#           # #   # #   # # # # #   # #
# ######### # # ### # # # # # # # # ###
# #         # # # #   #   #       #   #
# ### ##### # # # # ####### ###########
# #     #     #   #                   #
# ### # # ### ### # ######### # # ### #
# #   # # #       #     #   # # # #   #
####### ##### ### # # # # #############
#     # #     #   # # #       #       #
##### ########### # ########### #######
#   #   # #                         # #
# # # # # ##### # ################### #
# #   #         #                 #   #
### ##### ####### ### ### ### ##### ###
# # #     #         #   #   #         #
# ##### ### ### # # # # ####### ### ###
#       #   #   # # # #       # #     #
####### # ### ### ### ### ### ####### #
# #     #   # #     #   #   #       # #
# ### # # # # # # ### # # # ### ### ###
# #   # # # # # #   # # # #   #   # # #
# # ############# # # ### ### ### ### #
#       #     #   # #   #   #   #     #
### ### ### ##### # ### # ### ### # ###
#     # # # # #   #   # #   #   # #   #
##### ### # # ### ### ##### ######### #
#     #             #     #     # #   #
# ### ### ### ### # # # ####### # # ###
# #   #   #     # # # #       #   #   #
#######################################
