#######################################
#         #           #       # #     #
# # ##### ####### ######### ### # #####
# # #   #   #     #   # # # #     #   #
# ### ##### # ### ### # # # ##### # ###
# #     #     # # # #   # #   #     # #
# ##### ####### # # ### # ### ### ### #
# #                 #     #   # # # # #
####### ####### # ### ####### # # # # #
#   #   #       # # # # # # # #   # # #
# ####### ##### # # # # # # # ### # # #
#         #   # # #           #   #   #
##### ####### ### ### ########### ### #
#   # #     #   # #   #   #     # # # #
### ####### ### # # ##### # ##### # # #
# # #               # # # #     # #   #
# # ######### # ### # # # ### ### # ###
# # # #     # # #     # # # # #   #   #
# # # ##### ####### # # # # # ### ### #
# #   #   # #       #     # # # # #   #
# ### ### # ############# # # # # ### #
# # # #   #   #     #   # #     #   # #
# # # ### ### ##### ### # # ### # ### #
# # #   # #   #     #   #   # #     # #
# # ### # ### ##### ### ### # ### ### #
#           #     #   # # #     #   # #
########### ##### ### # # ### ####### #
#   #       # #   # # # #   #   #   # #
### ####### # ### # # # ### # ##### # #
#     #       #             # #   # # #
### ######### ### ######### # # ### # #
#     #   #         # #       # #     #
### # ### ### ### # # # ### ### # ### #
#   # # # #   # # # #   # # #   #   # #
# ### # # # ### ######### # # ### # ###
# #     # # #                 #   # # #
# ##### # ######### ### ##### # # # # #
# #                 #     #     # #   #
#######################################
