#######################################
#   # #                   # #     #   #
# ### ################# # # # ####### #
# #   #           # # # # #       # # #
# # # ########### # # ### ### ##### # #
#   #         #     # #       #   # # #
############# ### # # # ### ### ### # #
#             #   # #   #           # #
# ### # # ### # ### # ##### ######### #
# #   # # #   #   #   #             # #
### # ##### # ######### ### ### ##### #
#   # #     #   # # #   #   #         #
############# # # # ##### # # # ### # #
#             #   #       # # #   # # #
######### ##### # ######### # ### # # #
#         #     #           #   # # # #
# ### ##### # ### # # ### # # # # # ###
#   # #     # #   # #   # # # # # #   #
# ##### # # # # ######### # # ### #####
# #     # # # # #         # #   #     #
######################### ### ### ### #
#                           #   # #   #
### # ### # ####### ##### # # ### # # #
#   # #   #   #     #     # #   # # # #
# ##### ##### # # ### ### # # ### # # #
#     # #     # # #   #   # # #   # # #
# # # # ######### # # ### ### # # # ###
# # # #   #       # # # #   # # # #   #
# ### # # ############# ### ### ### # #
#   # # #   #                 # #   # #
# ##### # ####### ### ### # # # # # ###
#   #   #   #     #   #   # # # # #   #
##### # ####### ####### # # # # # # ###
#     #     #   #       # # # # # #   #
# ####### ######### ### # ##### ### ###
# #     # #         #   # #   # # #   #
# # ### # ######### # # # ### # # # ###
# # #     #         # # #     # #     #
#######################################
