#######################################
# #   #   #     #     # # # #         #
# ### # ##### ### # ### # # ##### #####
#   # # #     # # #   # # #     #     #
### # # ##### # ### ### # ### ####### #
# # # # #   #       #   #   # # # # # #
# # # # ### ### ####### ### # # # # # #
#   # # # # #     # #   #   #         #
# ### # # # ### ### ### ### ### ### ###
# # # #   # #   # #   #   # # #   #   #
# # # # ### ### # ### ### # # # #######
# # #   # # #     # #   #       # #   #
# # # ### # ##### # ### ####### # ### #
#   # # #         # # #   #   #   #   #
# ### # ######### # # # ##### ### ### #
# #     # # #   #   #       #     #   #
# ### ### # ### # ##### ##### ##### ###
#     #   # # # #   #   #   # #   # # #
##### ### # # # # ### ##### # # ### # #
#               #   #     # # #       #
##### # # ##### # ##### ### # # #######
# #   # # #       # #   # # #       # #
# # # ########### # ### # # # # ##### #
#   #   # # #         #   # # #   #   #
##### ### # ### ####### ### # ##### ###
# #   #     #                 #     # #
# ##### # # ### ### # # # ##### ##### #
# # #   # # # # #   # # # #         # #
# # ### ### # # ### # ### # ######### #
#       #     # #   # #               #
####### # ### ########### # # ####### #
# #   # # #   # #   #     # #       # #
# # # ####### # ### ### # # ###########
#   #                   # #           #
### ####### # ##### ### # # ### # #####
#   #       # #     #   # # #   # # # #
### # ##### ############# # ##### # # #
#   # #       #           #   #       #
#######################################
