#######################################
# # #   #       # # #         # #   # #
# # ### ####### # # # ######### # ### #
#   # #   # # # #   #         # # # # #
# ### ### # # # # # ### # ##### # # # #
#   # #     #   # #   # # #   # #     #
# ### ### ##### ### ##### # ### # ### #
#   # #     #   # #     #     #     # #
### # ##### # ### # ##### ##### #######
# # # # #   # # # # # # #       # #   #
# # # # ### # # # # # # # ####### # # #
# # #     # #   # # #   #   #       # #
# # # ### # # ### # # ##### ### #######
# # # #   #   # # #       # #   #   # #
# # ##### ### # # # ##### # # ### ### #
# #       # #   #   # # # #       # # #
# ##### # # # # # ### # ##### # ### # #
#     # # # # #     # # # # # # #     #
# ####### # ##### # # # # # # ### # ###
#   # #           #   # #         #   #
# ### ########### ##### # ####### #####
#   # #   #     #   # #         #   # #
### # # # ##### # ### ### # # # # ### #
# #   # # #           # # # # # #     #
# # ##### ### ######### # ### ##### # #
#     # # # # # #           #     # # #
### ### # # # # # ############# ### # #
#     #       #     #       # #   # # #
### ######### # ##### ####### ####### #
#   #   # # # #           #         # #
# ##### # # # # ### ### # ### ####### #
#   #             # # # #   # # # # # #
# ### # ### # ### ### ####### # # # ###
#   # #   # #   #   #       #       # #
### ### ### # # ##### ##### # ### ### #
# #       # # # #         #     #     #
# # # # # ####### ########### ### #####
#   # # #                 #   #       #
#######################################
