#######################################
#     #       #     #   #   #       # #
##### ####### # ### ### ### # ##### # #
#   # #     # # #   # #     # # #     #
# ### # ### # ### ### # ##### # ##### #
#     # # # # #     # # #   #     # # #
### ##### # # ##### # # ### # ##### ###
#   #   # # #   #   #   # # #   #   # #
# ##### # # ### # ### ### # # ##### # #
#   # # # #   # #   #     #       #   #
# # # # # ### # ### # ##### ####### ###
# #       # #       # # # #           #
######### # ##### ### # # # ###########
#     # # #   # #     #   #           #
##### # # # # # ##### ### # ### ##### #
# #   # # # #   #             #     # #
# # ### # ### ### ### ######### ##### #
# #   #     #   # # #         #     # #
# ### ##### # ##### # ### # ####### ###
#   # # # #   # #       # #       #   #
# ### # # ### # # ### ##### ######### #
# # #   # # #   #   #     #   #     # #
# # ### # # # ### # # ######### ##### #
#   # #       # # # #     #   #     # #
### # ### # # # # ### # ### # # ##### #
# #       # # #     # #   # #       # #
# ##### ### ### ########### ##### #####
#       #               #   #   # # # #
# # ### ### # # # # ### # # # # # # # #
# #   # #   # # # # #     # # # #   # #
# ##### ### # # # ######### # ####### #
#     # #   # # #       #   # #     # #
# # # # ### # ############### ##### # #
# # # #   # #       # #   # #   #   # #
# # ######### # ##### ### # # # ### # #
# #     #     #   # #         #   # # #
### # # ### ### # # ##### ######### # #
#   # #   # #   #                     #
#######################################
