#######################################
#       #               #     # #     #
# # # # ### ######### ### ##### # #####
# # # #         # # # #     #     #   #
# # ##### # # ### # ### ##### ##### # #
# # #     # #     #       #   #     # #
# # # # # ### ##### ####### # # # #####
# # # # #   #             # #   #     #
####### # # # # ########### ### ### # #
#       # # # #               #   # # #
# # ### # ##### ################# #####
# # #   #     #   #         #   #     #
# # ### # ### # # ### ### ### ####### #
# # #   # # # # #   #   # # #       # #
# # ##### # # # ### # ##### # # ##### #
# # # #     # #   #           # # #   #
# ### ### # ##### # # ### # ##### # ###
# #       #     # # #   # #     #   # #
# # ##### # ##### ##### # # ####### # #
# #     # #     #   #   # #   #   #   #
# ##### ### ### ### ### # ##### ##### #
#   #   # #   #   # #   #   #   # #   #
# ### ### ##### # # # # # ### ### #####
# #     # #     # # # # #             #
# # # ### ### # # ####### # ### ### # #
# # #       # # #   #     #   #   # # #
# # # ######### # # ### # # # ##### # #
# # #         # # #   # # # #     # # #
# # ##### # # ##### # ### # ### ### ###
# #     # # #     # # #   #   #   #   #
# ##### # ##### ##### ####### # # ### #
# #   # #     # #       # # # # #   # #
# # ### # # ### ### ##### # # # # # # #
# #     # # #   #           # # # # # #
# ### # # ##### ### ### ##### ####### #
#   # # #   #   #     #   #     #     #
# # ##### # # ##### # ####### ####### #
# #     # # #     # #     #     #     #
#######################################
