#######################################
# #         #     #   #     # #       #
# ######### ### # # ####### # # ##### #
# #     # #   # #   #       # # # # # #
# ##### # # ##### ##### ### # # # # ###
#   #   #   # #     # # # # #         #
# ### # ### # ##### # ### # ######### #
# #   #   # #   # # #     # #     # # #
# ####### # ### # # ##### # # ##### # #
#       #   # #       # # # #       # #
####### # ### ### ##### # # ### ##### #
# #   # #           # # # # #       # #
# ### # ########### # # # # ### ### # #
#             #   #     #   #   # # # #
############# ### ##### ### # ### ### #
#   #         # # # #   # # # #     # #
### # ####### # # # # # # # # # ##### #
# #   # #   #     #   # # # #     # # #
# ##### ### ##### # ### # # # ##### # #
#         # # # # # #       #         #
######### # # # # ### ### # # ### #####
#       #     #       #   #     # #   #
### ### ##### # # # ####### # ##### # #
#   # #   #   # # #   #     #       # #
### # ### ### ########### # # # ### # #
#   # #     # #       #   # # #   # # #
##### ### ### ##### ### ### # # # ### #
#     #         #   #   #   # # # #   #
##### ### # ### ### # # # ### # # ### #
# #   #   #   #       # #   # # # #   #
# ### ##### ### # ### # # ##### # # # #
#   #       #   # #   # #   # # # # # #
# # ######### ##### ### # ### ##### # #
# #             #     # # #     #   # #
# # # ####### # ### # # ####### # # # #
# # # # # #   # # # # #         # # # #
# ##### # # ##### ########### ### ### #
# #                         #   #   # #
#######################################
