#######################################
#     #     #         #   #     #     #
### # # ### # ####### # ### ####### # #
# # # # #     # #   # #     # # # # # #
# # ######### # ### ### ##### # # ### #
# # #   #       #   # # # # # # # # # #
# # ### ##### ##### # # # # # # # # # #
# #     #     # # # # # # # # # # #   #
# # ######### # # # # # # # # # # # ###
#   #   # #     # # # #     #       # #
# ### ### ##### # # # # ##### ### ### #
#     #   #   # #       # # # # #   # #
# ####### ### # ##### ### # ### ### # #
#       #     #   #   # #   # # # # # #
### ##### ### # ##### # # ### # # # # #
#     # # #   #     #   #   # #     # #
# ##### ##### # # ##### ### # ##### # #
#       # # # # # # #         #       #
# # ##### # # ### # ### ### ##### #####
# # # # #     #     # # #   #   # #   #
# ### # ##### # ##### ##### # ### # ###
# # #       #   #     # # #     # #   #
# # ### ### ### # ##### # ### ### # ###
#   # # #     # #   # #   #   # # #   #
### # ####### # ### # # ##### # # ### #
# #   #           # # # # # #     #   #
# ### ####### ##### # # # # ### ### ###
# # # #       #       # #   # # #     #
# # # ####### ### ##### # ### # # #####
#   # # #         # # #     #     #   #
### # # ##### ##### # ### ##### ### ###
# # #   #       # # #       #     # # #
# # # ######### # # ####### # ##### # #
#     # #       # # #   # #   #     # #
### # # ####### # # ### # ### # ##### #
#   #     #     # #     # # #     #   #
# ##### ##### # # ##### # # # ##### ###
# #           #                       #
#######################################
