#######################################
# #   #         #       #   # #       #
# # ### ####### ### ##### # # ####### #
# #     #   #   #       # # # # #   # #
# ####### ### # # ######### # # # ### #
#     #   # # # #     # # # #   # # # #
# # # # ### ### ##### # # # # ### # # #
# # #       # # # # # #       #     # #
### ####### # # # # # ####### # ##### #
#   # #   #               # # #       #
##### # ################# # # # #######
# #         # # # # # # #     # # # # #
# ####### # # # # # # # ##### # # # # #
#     # # # #     #     # #   # #   # #
# # ### ### # ### # ### # ### # # ### #
# # # #   #   #     # # #   # #       #
# # # # ############# # ### # # #######
# #     # #   # # #           # # #   #
####### # # ### # ##### # ### # # # ###
# # # #   #         #   # # #   # #   #
# # # # # ####### # ####### ### # # ###
#     # # #   # # #           # # # # #
### ##### ### # # ### ####### # # # # #
# #     #   # #   # # #   #   # # #   #
# ##### ### # ##### ##### ### # # # # #
#           # # # # # #   #         # #
####### ### # # # # # ### ####### # ###
# # #   # #   #   #     # # #   # # # #
# # # ### # ##### ### ### # # ### # # #
#   # #         #   #           # # # #
### ### ### # # ### ### # # # ### ### #
#       # # # #         # # #       # #
##### ### # ##### ### ### # ### ##### #
#     # # # #     #     # #   #       #
# # ### # ##### ### # # # # # # ### ###
# # #           # # # # # # # #   #   #
############# ### # # # # # # ### ### #
#             #     # # # # #   #   # #
#######################################
