#######################################
#   #   # #   #   # # #           # # #
# ##### # ### # ### # ########### # # #
#   # # # #       # #   #   #       # #
# # # # # ##### ### # ##### ####### # #
# # # #     #     # #     #           #
### # ### # ### # # ##### ####### # # #
# #       #     #               # # # #
# ##### # ### ### ######### # # # # ###
#   #   # #   # #   #       # #   #   #
# # # # # # # # # ##### # ####### # # #
# #   # # # # #   #     # #       # # #
# # # # # # ##### ############### ### #
# # # # # # #     #             # # # #
# # ### ##### ### ### ######### ### # #
# # #     #   #     # #               #
##### ########### # ##### ##### ### # #
#     # #         # #   #   #   #   # #
####### ####### ####### ##### # # # ###
#     #         # #     # #   # # #   #
# ######### ##### ##### # ### # # # # #
# #         #   # # #         # # # # #
# # ##### ### ### # # ### # # # ### ###
#   #   # #           #   # # #   #   #
####### ##### # # ####### # ##### ### #
#   #   # #   # # #       #   #   #   #
# ##### # ### ### # # # # # ### ##### #
# #         # #   # # # # #   # #     #
# ######### ### ### ### ##### # # # # #
#               #     # # # # # # # # #
# # ################# # # # # # ##### #
# # # #       #     # #     # # #     #
### # ####### # ### # ### ### ##### # #
#   # #   #     #     # #   #   # # # #
##### ### # ######### # ### ##### # # #
# #     #     # #         # #       # #
# ##### # # ### ### # # # # ### # # ###
#         # #       # # # # #   # #   #
#######################################
