#######################################
# #   # # #   # #   #   #             #
# ### # # # ### # ##### # ### ##### ###
# #   # # #   # #   #   # # #     #   #
# ### # # # ### # ##### # # ##### #####
#   # # #       # # # # # #     # #   #
# ### # # ####### # # # # # ### # # ###
# #   # #   # # #   #         # # #   #
# ### # ### # # ### ####### # # # # # #
#       #       #   #     # # # #   # #
##### ### ####### ### ##### # # #######
# # # # # #   #       # #   # #       #
# # # # # # ### ####### # ####### #####
#   #   # #       # #   #   #   #   # #
### ### # # ##### # # ### ### # ##### #
# #   # #       # # # #   #   #       #
# ### # # ######### # # ##### #########
#   #   # # #   # # # #   #         # #
# ##### # # # ### # # # ### ######### #
#   #       # #     #         # # #   #
### ### ##### # ##### # ### ### # # ###
# # #     # # #       #   # # #       #
# # # # ### # # ##### ####### # # #####
#     # # #   # # # # #         #     #
####### # # ### # # # # # #############
# # #               # # #             #
# # ### ####### ####### # # ### #######
# #     # # #   #       # #   #       #
# ##### # # ##### ######### ### # ### #
#     #               #   #   # #   # #
##### ### # ##### ##### # # ### # ### #
#         #     #   #   # # # # #   # #
##### # ### ######### ### ### # # #####
# #   #   #           #       # #     #
# ####### # # # # # # # # ##### # # # #
#       # # # # # # # # #   #   # # # #
# ##### # ### # ### # ##### ### # # ###
# #       #   #   # #   #   #   # #   #
#######################################
