#######################################
#     #     #   # # # # #   #   # # # #
# ### # ##### # # # # # # ### ### # # #
# #     #     #       # #   #     # # #
####### # ### ##### # # # ### ##### # #
#   # # #   #   # # #   # #           #
# ### # # ####### ### ### # # ####### #
# # #   # #       # # #     #     # # #
# # ### # # ####### ### ##### # ### # #
# # #     # #   #     #     # #   #   #
# # ### ### # ### ### # ######### # # #
# # # #       #   # #           # # # #
# # # # ### # # ### ######### ##### # #
# #       # #               #     # # #
# ### ### # ######### ### ##### #######
#   #   # # #       #   # #     # # # #
# ### ### ### # ######### ### # # # # #
#   # # # #   #         # #   #     # #
# ### # ### ### ### ############# # # #
# #         # #   #             # #   #
# # # # ##### ######### # # # # ##### #
#   # #               # # # # #     # #
# # ### ### # ##### # ######### ##### #
# # #     # # #   # # # #     #   #   #
# # ##### # ### ####### # ######### ###
# #     # #             #   #   # #   #
# # ### # ### ##### ##### ### ### # # #
# #   # # # # #   #               # # #
# # # ##### # ### ####### # ##### # ###
# # #   #   #           # #     # # # #
# ######### ### # ### ### ### # ### # #
#             # # # #   # #   #   # # #
# ### ######### # # ######### ### ### #
# #           # #           # # # # # #
# # # # ##### ### # ########### ### # #
# # # # # #   #   #   # #   #   # #   #
# ### ### # ##### ##### ### # ### # # #
#   #     #     #                   # #
#######################################
