#######################################
#       #   # #             # # # #   #
# # # # # ### ### ####### ### # # ### #
# # # #   #     # # #     #   #   #   #
##### ### ### ##### ### ##### ### ### #
#   # #     #   #   #       # # # # # #
# ##### ### ### ### # ### ### # # # # #
#   #   # #   # # #   # #   # #     # #
### ##### ### # # ##### ### # ### ### #
# #   # # #   #   #   # #   #   # #   #
# # ### # ### ### ### # ### # ### ### #
#   #   # #   # # #   #   # # #   #   #
### # ### ### # # ### ### # # # # # ###
# #   #           # #     # #   #   # #
# ### # ##### ##### ##### # ##### ### #
#     # #   #   #       # # #   # #   #
# ##### ### ### ####### # # # ### ### #
#     # #         # #   #     # # #   #
##### ########### # # # ### ### # ### #
#         # # #   #   # #   #   # #   #
##### ### # # # # ##### # ##### # ### #
# #   #   # #   #     #     #         #
# ####### # ######### # ### ### # # ###
#     #   #       # #   #       # #   #
# ### # ######### # ##### ####### # # #
# # #   #       #         #       # # #
### ### ####### # ### ##### ####### ###
#     # # #   #     # #   # # #       #
# ##### # ### ####### ### ### ### # ###
#   #   #   #     #   #       #   #   #
# ### ##### ### ############# # # # ###
#   #                 # #   #   # # # #
### ############### ### ### # # ##### #
#   #   #     #       #       #       #
# ##### ##### ##### # ####### ### ### #
#         # #       # #   #     #   # #
# ####### # ##### ### # # # ######### #
# #                 #   #       #     #
#######################################
