#######################################
#                     #               #
### # ####### # ### ### ### ###########
#   #       # # # #   #   # #         #
# # # ########### ##### # # # # #######
# # #   #   #           # #   # # #   #
# ##### # ### ### ### # ######### # # #
#   #           #   # #             # #
##### # # # # # # # # # ### # # # ### #
#     # # # # # # # # #   # # # #   # #
##### # ############# # # # ### # # # #
#     #         #   # # # # #   # # # #
### ### # ##### # ####### ### # # # # #
#   #   #   #           #   # # # # # #
### # # # # ### ### ### # ### ### #####
# # # # # # #   # #   # # # # #   #   #
# ### # # ### ### # # # # # ### ### # #
#     # #   #     # # # # # # # #   # #
### ### ### # # # # ####### # ### ### #
#   #     # # # # # # # # #   #   #   #
# ### # # # # ####### # # # ##### ### #
# #   # # # #       #       #       # #
# # ### # ######### # ##### # ####### #
# # #   #   # # # # #   # #   # # #   #
### ### # # # # # # # # # # ### # ### #
#   #   # #       #   #   #         # #
### ### ### # ##### # # ### ### #######
#   #   #   #     # # #   #   #   # # #
# # ### # # # # # ### ####### ##### # #
# #   # # # # # #   #   #     # #     #
### ### # # # # # # # ### ### # # # ###
# #   # # # # # # # #   # # #     # # #
# # # # # ### ### ### # ### # ##### # #
#   # # # #     # #   # #         #   #
# # ##### ### # # ######### ### #######
# #     # #   # #     #     #   # #   #
# # ####### # ######### # # # # # # ###
# #     #   #         # # # # #       #
#######################################
