#######################################
#         #       #   #       #       #
# ############### ### ####### # #######
# #     #   #     #   #   #           #
# # # # # # # ### # ##### ##### #######
# # # # # #   # #       #           # #
# # # # ##### # ####### ####### ##### #
#   # #   #   #       # #   # # # #   #
######### ########### # ### # # # # # #
# #   #   # # #   #       # # # # # # #
# ### # ### # # # # # ##### # # # ### #
#   # # # #     # # # # # #     #   # #
### # # # ####### # ### # # ##### ### #
#     # # #     #   #     # #   # #   #
# # ### # ##### # # ##### # ### # ### #
# # #     # #     #     # # #   # #   #
# # ##### # ########### # # ### # ### #
# #         # #     # # #       #   # #
# ####### # # ##### # # # ####### ### #
# #   #   #             # #   #     # #
##### ################# # ### # ##### #
# #       # #   # #         # #   # # #
# ##### ### ### # ### # ##### # ### # #
# #   #   #     # # # #   #   # # #   #
# ### ### ##### # # ### ##### # # # # #
#         #   # #                   # #
### ### # ### # ### ### ### ###########
#   #   # #         #   #             #
### ##### ### # # ######### ##### # # #
# # #   #     # # #   # # # #   # # # #
# ##### # # ##### # # # # # # ##### # #
#   #     # #     # #             # # #
# ######### ##### ##### ### # # #######
#       #   #     #     #   # # #     #
# ##### ##### # # # # # # # # ### #####
# #   # #   # # # # # # # # #         #
##### # ### ### ##### ### ##### # ### #
#                   # #       # # #   #
#######################################
