#######################################
# #     #     # # # #     #   #   #   #
# ### # # ### # # # # ####### # # # ###
# # # #   #   #   # #   #   #   #     #
# # ### ####### ### # # ### ######### #
# #   # #   #   # # # #   #   # # # # #
# ### # # ##### # # # ####### # # # # #
# # #         #   # #   #   #   #     #
# # # ####### # ### # ##### ### ##### #
# # #   #   # #   #   # # # # # #   # #
# # ### ### ##### ### # # # # # ### # #
# #     #   #   #   # #   #   # # #   #
# ##### ### ### ### # ### # ### # ### #
#           #   #       #   # #   #   #
### # ### ### # ##### ##### # ### ### #
#   # #     # #     # #         #   # #
########### ####### # ######### ### # #
# # #         # # #         #   #     #
# # ### ##### # # ######### # ### #####
#   #   #             #       # #     #
### # # ### ### # # # ####### # ### ###
# #   #   #   # # # #         #       #
# ### # ##### ############### # ### ###
# #   # #       # #     #     #   # # #
# ##### ####### # ### ### # # # # ### #
#         #     # # #     # #   #   # #
# ######### # ### # ######### # # ### #
#     #     #   # #   #       # #     #
# # ####### ### # # ### ##### ### # ###
# # #       #   #   #     #     # #   #
# ### ############# ##### # ### ### ###
# # # # #   #   #         #   # #   # #
# # ### # # ### ### # ##### # # ##### #
# #   # # # #       #   #   # #       #
# # # # ### ################# # ##### #
# # # #                 # #   #   #   #
# ### ##### ##### ##### # ### # ##### #
# #         #       #         # #     #
#######################################
