#######################################
#   #         # # #       # #         #
# ### ### ### # # ##### # # ######### #
#     # #   #   #     # # #           #
####### # ##### # ####### ########### #
# #   #     #   # # # # #             #
# ### ##### ### # # # # # #############
# # #     # # # # #   #   #   #     # #
# # ### ### # ### # ##### ### # ##### #
#       # #   # #     #   #   # # # # #
##### ### # ### ### ##### # ### # # # #
#     # #           #   # #   # # #   #
### ### ######### ### # # # ### # ### #
#   #   #     #   # # #   #       # # #
### # ####### # ### ### ### ####### # #
#     # #   #   #     #   #   #       #
##### # # ##### # ### ### # ### ##### #
# # #   #     #     #   #   #       # #
# # ### # ####### # ####### ### ### ###
#   # #   #   # # #         #     #   #
# ### ### ### # # ########### #########
# #   #   # #     #   #   #   # #     #
# # ##### # # ##### ##### ### # # ### #
#     # # # # # # #     #   # #   # # #
##### # # # # # # # ####### # # ### # #
# #   #     # # #       #   #   #   # #
# # ##### # # # # ####### ### ### #####
# #       #             #   #         #
# ############# ######### ### #########
#       #   #     # #     # #         #
### ### ### # ### # # ##### # ### #####
#   # # #     # #       #       #   # #
##### # # ##### # ######### ######### #
#   # # # #   # #       # #         # #
### # # ##### # ### ##### # ### ##### #
# # #         # #       # #   # #   # #
# # ######### # # ####### # # ### ### #
#                           #         #
#######################################
