#######################################
#           #   #   #           # #   #
# ### # ### ### # ##### ####### # # ###
# #   # #       # #     # #     #     #
# ##### # ##### # ####### ##### ### # #
#   # # # #             #     # # # # #
##### ################# ### # # # # ###
#         #                 # #   # # #
######### # # # ##### ##### ##### # # #
#     #   # # # #   # #   #     # # # #
# ### ### ### ##### ##### # # ### # # #
#   #   #     #     # #     #   # # # #
# ##### # ######### # ####### # # # # #
# #       # # # #   #         #     # #
# ######### # # ### # ######### # ### #
#   #       #   # # # #         #     #
### # ### ##### # # ########### # #####
# # #   #   # # # #   # #       #     #
# # ##### ### # # ### # ####### ### # #
# # # #   #   #           #       # # #
# ### ### ### # ##### # # ##### # # ###
#   #         # #     # #       # #   #
# ######### # ####### ##### # # # ### #
#   #       #         #     # # #   # #
### # # # ####### # # ####### # # ### #
#     # # #       # # #       # #   # #
##### ####### ### # ####### # # # #####
#     #       # # #     #   # # # #   #
# # ### # # ### # # # ####### # # # # #
# # #   # # #     # #   #     # #   # #
# # ##### ##### # ##### # ### ### # # #
# # #     #     #     # # #     # # # #
# ### # ######### # ### ### # # ### # #
# # # #       #   #   # # # # # #   # #
### # # # # ##### # ##### ### # ##### #
#   # # # #   #   #   #     # #     # #
# # # # # ##### # ### ### # # # ### # #
# #   # #   #   #   #   # #   #   # # #
#######################################
