#######################################
#   #   # #     #     # #       #     #
### ### # # # # ##### # # ##### # ### #
# # # # # # # #     #   #     # #   # #
# # # # # # ######### ### ####### ### #
# # #   #       #     #         #   # #
# # ### # ########### # ##### # # # ###
# #   #     #               # #   #   #
# # ##### ##### ####### ### ### #######
# # #     # #       #   #     # #     #
# # ### # # # ####### # ##### ### ### #
# #   # #     #   # # #     # #     # #
# ### ### ##### ### ####### # # #######
#     #         # #   #   # #         #
### ### ##### ### # ### ##### # #######
#           # # # #   # # #   #     # #
# ### # ####### # # ### # ### # ### # #
#   # #           #         # # #     #
# ### ####### # ### ### ######### ### #
#   #       # #       #   # #   # #   #
# ### ####### # # # # ##### # # ### ###
#   #       # # # # # # # #   #   #   #
# ####### ### # ### ### # # # ####### #
#       #   # #   #         # #     # #
# ### ### ####### # ########### ### ###
#   #   #       # #       #   #   #   #
# ### ########### # ### ### # # #######
#   # #       #   # #       # #       #
# ##### # ##### ####### # ##### ##### #
#   #   #     #   # #   #           # #
# # # ############# # # ####### ### ###
# #               # # # #     #   # # #
# # ### ### # ##### ##### ### # # ### #
# # #   #   #         #   # # # #     #
##### ### # ######### ### # ##### #####
#       # #         #       #   # #   #
# ### ### ####### # ### ### # ### # ###
# #   #         # #   #   #     #     #
#######################################
