#######################################
#   #   #   #                         #
### ### ### ##### ##### # # ######### #
#       # # #     #     # # #     # # #
####### # # # # # ##### # # # # ### ###
# #     #     # # # # # # #   # #     #
# ### # ### ####### # # ####### ### ###
#     # #   # #       # #             #
# ##### ##### ##### # ######### #######
# #     #   # # #   # #       # #   # #
# ##### # ### # ### # ##### ### ### # #
#   # #     # # #   #           #     #
# ### ### ### # ######### ##### ##### #
# # #     # # #   #   # # #   # #     #
### ##### # # ### ### # ##### # ##### #
#                 # #   # # #     # # #
# ### # # ### ### # ### # # ##### # # #
#   # # # # # #     #   #   # #       #
########### # # # # # # ### # ##### ###
#             # # #   # #       #     #
# ########### ### ### # # ##### ### # #
# #   #   # # #   #   #   # #     # # #
# # # # ### ### # ####### # ##### ### #
# # #     # #   # #       #     #   # #
##### ### # # ### ### ######### ### # #
#     #   #   #     # #   # #       # #
# ####### # ########### # # ####### # #
#   #       #   # #   # # #   # # #   #
# ### ### ### ### # # # ### ### # # ###
# #   #   #   #     #   #   #         #
########### ########### # # # ### ### #
#               # # #     #   #     # #
# ####### ### ### # ##### ### ####### #
# # #     # # #   # #     #       #   #
### # ##### # ### # ### ### ### ##### #
#       #     #         #   #   #     #
# # ####### # ### # ####### ### # ### #
# #     #   #     #       # #   # #   #
#######################################
