#######################################
#           #                         #
# ### # ### # # ############# ### ### #
# #   #   #   # #     #         #   # #
########### # ####### ##### # # # ### #
#   #       # # # #       # # # #   # #
# ####### ### # # # ##### # # ### # # #
# #   #   #   #       #     #   # # # #
# ### ### ######### # # ### # ### #####
# # # #   #         # # #   #   #     #
# # # ######### ##### ####### # ##### #
# #           # #       # #   #     # #
# ######### # ##### # # # # # ##### ###
# #         #       # #   # # #   #   #
# ### ####### # # ##### ### ### ##### #
#     #       # # #     #           # #
######### ### # ##### ####### ### #####
# #     #   # # #     #   #     #   # #
# # ### ### # # # # # # ### # # ### # #
# # #       # # # # #   #   # # #     #
# # # ##### # # ### ### # # ##### ### #
#   # #     # # #   #   # #     # #   #
### ### ##### ### # # ### # # ### # # #
# # #   #     #   # #   # # # #   # # #
# ####### ##### # ### ######### # ### #
# # # #   #     #   #       # # # #   #
# # # ##### # # # # ### ### # # # # ###
#       #   # # # #   #   # # # # #   #
# ### ### # # ##### ####### # ##### # #
#   #     # # #       #   #       # # #
### # ##### ### # ### # # ##### ### # #
#   # #     # # # #     # #     #   # #
# # ### # ### ##### # ##### # ### #####
# #   # #   #   #   #     # # # #   # #
# ### # ### # # # ### ### # # # # # # #
# # # # #   # #     #   # # #   # #   #
# # # ####### ######### # # # ### # # #
#   #     #   #         # # #   # # # #
#######################################
