#######################################
#       # #       #   #   #       # # #
# ##### # # ### ### # ### ##### ### # #
#   # # # #   #   # #         # #     #
# ### # # # # ##### ### ####### ### ###
# # #   # # #     # # # # #     # #   #
# # # ### ##### ### # ### # ##### # # #
# # #   #     # #       #       #   # #
### ### # ##### # ### ####### ### ### #
# # #       #   #   # #       #   #   #
# # # ##### ### # # ### # ####### # ###
# # # # #     # # #     #         #   #
# # ### # ##### # ### # # ########### #
#   # #     # #   # # # # #         # #
# ### # ### # ### # ####### ##### # # #
#   #   # # #     # #   #   # # # # # #
### ##### # # ##### ### # # # # ### # #
# #   #         #   # #   #       # # #
# ### # ##### # # ### # ### ####### ###
# # # # #   # #       #   # #     # # #
# # # ### ### ########### # # # # ### #
# # # #   #     #   #     #   # # #   #
# # # # ### ##### ### ####### ##### # #
#         #     #           #       # #
### ##### ### ##### ################# #
#   #           #     # #         #   #
# # # ### # ####### ### # ####### # ###
# # # #   #     # #   # #       # # # #
####### # ### ### # # # ### ##### # # #
#       #   #       # # #       # #   #
### ##### # ### ####### ### ### #######
#   #     #   #     #         # #     #
# ####### # # # # # # ####### ### #####
#   # #   # # # # # #       # #     # #
# ### ### ######### ### ####### ##### #
# # #       # #       # #     #   # # #
### ##### # # ####### # # # ##### # # #
#         #     #         #           #
#######################################
