#######################################
#           #       #   #   #     #   #
# ########### # # # # ##### # ### # ###
# #   # # #   # # # #     #   # #   # #
# ### # # ##### ##### ### # ### ### # #
#   # # #     # #   # # #     #   #   #
### # # ### ### # ### # ### # # #######
# # #   # #   #   # #     # #         #
# # ### # # ### # # # ### ##### #######
#   # #         #   #   #     # #     #
# ### ### ########### # ######### # ###
# # #   # # #         #           # # #
# # ### # # # ##### ####### ######### #
#         # #   # #       #       # # #
####### ### # ### ### ######### ### # #
#   #   #     #     #     #     #   # #
# # ### ### ### ################# ### #
# #               #     # # #   #     #
# ##### ##### ##### ##### # ### # # ###
# #         #   #       #   #   # # # #
### ### ##### ### ####### ### ### ### #
#   #       #     #               # # #
# # ### ### ####### ####### ####### # #
# # #     #             #   #         #
# # # # ##### # # # ### ##### # #######
# # # # #     # # #   #     # # #     #
# # # ##### # # ### # # # # # ### # # #
# # #   # # # # # # # # # #       # # #
# ### ### ### ### ################### #
#   # #     #                       # #
### ##### ### # ### ##### ##### ##### #
#         #   #   #   #       # #     #
### # # ##### ### ### # ### # # # # # #
# # # #   #     #   # #   # # # # # # #
# # # # # ##### # # ### ### # ##### # #
#   # # # #     # # # # # # #   #   # #
# # ### ### # ####### ### # ###########
# # #   #   #             #           #
#######################################
