#######################################
#   # #   #   #       #   # #     #   #
# # # ### # ##### ##### ### # ### ### #
# #     #   #       # #         #   # #
# ### ### ##### ### # ### ### # # ### #
#   #   # #     # #   # # # # # #   # #
##### # # ####### ### # # # ######### #
# # # # #   # #   #   # # #     # # # #
# # ### ### # # ### ### # # ##### # # #
# #   # #   # #     #     # #     # # #
# # ### # ### # ######### # # ##### # #
#     # #   #         # #   #         #
### ### ### ##### ##### # ### ##### ###
#     #     #     #   #       # # # # #
##### ##### # ##### ##### ##### # ### #
#     #     # #     # # #           # #
# ######### # # ### # # # # # ####### #
#     # #   #     #     # # #   # #   #
### ### ### ### ######### ####### ### #
# # # #   # #   # # #     #         # #
# # # ### # ### # # # ######### # ### #
#   # # #         # # # #   # # #   # #
### # # # ##### # # # # # ### # ##### #
#       #     # #     #               #
####### ### ########### ### ### # #####
# #                       #   # #     #
# # ### ### ### ######### # # ##### # #
#   #     #   #   #     # # #     # # #
### # # # ### ##### ######### # ##### #
#   # # #   #   #   # #       # #     #
# # ### # ### ### ### ############### #
# # #   #   #                     #   #
# # # # # ### ##### # ######### ### # #
# # # # # #       # #   # #   #   # # #
### # # ####### # ####### # # # ### ###
#   # #       # #     # #   # # #     #
# # ### # # # # # # # # # # # # ### # #
# #   # # # # # # # #     # # # #   # #
#######################################
