#######################################
#     #           #   #   # #   # #   #
# ### # # ##### ### # ### # # ### # # #
#   # # # #   # # # # #     # # #   # #
# # # ##### ### # # ### # ### # # #####
# # #       #     # # # # # #       # #
# ############# ### # # ### # ##### # #
# #   #   # #   # #   # #   #     #   #
# # ### ### ### # # ### ### # #########
#   # #   #                       # # #
### # ### ### ####### # ### ####### # #
# #         #   # # # #   #     # #   #
# # ####### ### # # # ### ### ### ### #
# # # #   # # # #   #   # #   #   #   #
# # # ### ### ### # # ########### ### #
# #   #   # #   # #   # #   #   # #   #
# ### # ### # ### ##### # ##### # # ###
# # # # #   # #   # # # #   # # # # # #
# # # # # ### ### # # # ### # # # # # #
#   # #   # # # # # # # #   # #   #   #
### # # ### # # # # # # ### # # ##### #
# #         # # # # #   # #           #
# ##### ##### # # # ### # # ######### #
# # #     # # # # #     #   #     # # #
# # # ### # # # # # ##### ### # ### ###
# #   #     #   # # # #       #       #
# ##### ### # ### # # # ####### # ### #
#       #                 # # # #   # #
# # ### # # ############### # ### ### #
# #   # # #         #     #   # #   # #
# # # # ### # ### ### ##### # # # #####
# # # # #   #   #           #   #     #
# ##### # # # ### # # ### # ### ##### #
#     # # # # # # # # #   #   #     # #
# ####### # ### # # ##### ####### ### #
# # # #   # # #   #     #   # # #   # #
# # # ### ### ##### # ####### # ### ###
# #           #     #             #   #
#######################################
