#######################################
#   #     #     # #     # #   #     # #
### # # ####### # ### # # # ### ##### #
#   # # #         # # #   #       #   #
# ### ### ##### # # ### ### ####### ###
#   # #   #     # #     #   #   #   # #
### # # ### # ######### # ### # ### # #
#     # #   #           # # # # #   # #
### ############# ### # # # ### ### # #
#       #     # # #   # # #     #     #
# # ### ### # # # ##### # ### # # # ###
# #   #   # #     #   # #     # # #   #
### # # # # ######### # ##### ### #####
#   # # # # #       #     # #     #   #
# ### # # ##### ### ##### # ##### ### #
#   # # #     # # #         # # #     #
############# ### ##### ### # # ### ###
#   # #         # #     #     #       #
### # # ### ##### ########### ####### #
#       # #     # #     # #   # # # # #
######### ##### # ##### # # ### # # # #
# # # #     #         #     # # #   # #
# # # # # ########### ### ### # # ### #
# # # # # #     #     #     # # #   # #
# # # ### ### # # ######### # # # ### #
#   #         # #     #   #   #   #   #
### ######### # ##### ### ### ### ### #
# # #   # #   # # #   # #     #       #
# # # ### ##### # ### # # ### ##### # #
#     #       #   # #     #   #   # # #
##### # # ### ### # ####### # ### ### #
#   # # # #   #   #   #     #     #   #
### # ####### # ##### ######### # ### #
#   # #   # #     # #           #     #
# ### ### # ### # # ### # ### ##### # #
#   # #   #     #       # # # #     # #
### # # # ##### ##### # ### ####### # #
#       #       #     # #           # #
#######################################
