#######################################
#   # # #   #                 #       #
# ### # # ##### # ####### ##### # ### #
# # # # #   # # #     # # # #   # #   #
# # # # # ### ### ### # ### # ##### ###
# #   #       # #   # #     #   # # # #
# ### ### ##### # # ### ##### # # # # #
#   # #   #   # # #   #   #   # #   # #
# ### # # # ### # ####### # ######### #
# #   # # # #   #     #         #     #
# # ### ### # # # ##### ####### # # ###
# # # #       # #     # #     #   # # #
# # # # ############# # # # ######### #
# #     # #               # #   #     #
# ##### # # ### # # ### ####### # ### #
#       # #   # # #   #   #   # # # # #
# # ### # # ####### ### ##### # # # # #
# # #             #   #     # #   # # #
# # # # ### ##### # # # ##### ##### # #
# # # # #       # # # #     #     #   #
##### # ##### ### # ######### ##### ###
#     # # #   #   # #                 #
# ### # # # # # # ##### ### ####### ###
#   # #   # # # #     # # #       # # #
# ### # ##### ### ##### # ####### ### #
#   # #     #   #     # #   # # # #   #
####### ############# # # ### # # # ###
#   #         #     #       #   #   # #
# # # # ####### ######### ### ####### #
# #   #   #             #   #     # # #
# # ### # ### # # ####### ### # ### # #
# # #   #     # #     #   #   # # #   #
##### # ### # # ####### ### ##### ### #
#     #   # # #       #               #
### # ##### ### # ### # # ##### #######
#   #   #   #   #   # # #     #   #   #
# # ##### # ### # # # # ##### # ##### #
# #     # # #   # # # #     # #       #
#######################################
