#######################################
# #       #       #       # #         #
# ##### ####### # # ####### # # ### # #
# # # #     #   #           # #   # # #
# # # ##### # ############### ### # ###
#   # #     # # # #       #     # #   #
### # ### # # # # ### ####### #########
#   #     #     #     #   #   # #   # #
# # # # ##### ### ##### ### ### # ### #
# #   #   # #     #     #     #   #   #
# ####### # # # ### # ### ### # ### # #
# #   #     # #     #       #   # # # #
# # # ### # ### ### ### # # ### # # ###
# # #     #   # #   #   # #   #   #   #
##### # # # # # # # # # # ### # ### ###
#     # # # # # # # # # #   # # #     #
# # ### ### ### # # ### ##### # # #####
# # # # #     # # #   #   #   # # # # #
##### # # ##### ### ### # ### # # # # #
#       #   #     #   # # #   #       #
# ##### # # # ##### # ### ### ##### # #
#     # # # #   #   #   #   # #     # #
# ### ### # # # # # # # ##### # # ### #
#   #   # # # # # # # #     # # # #   #
# ####### # ######### ### # ### #######
#     #   #         # #   #   #       #
# # # ##### ##### ### ##### ##### # # #
# # #     # #   #   # #   #   #   # # #
# ### # # # # # ### # # # ##### # ### #
#   # # # #   #   # # # #   #   # #   #
# # ### # # ##### ##### ### # ### # # #
# #   # # #     # #   #   #   # # # # #
# # ##### ### # ### ##### # # # # #####
# #   #   #   #     #   # # #   #     #
# ####### ### # ### # ### ##### #######
#       #   # # #   #   # #         # #
# ##### ### ### # # # # ####### ### # #
#     #   #   # # #   #     #   #     #
#######################################
