#######################################
#   #     #         # #   #     # # # #
# ### ### ######### # # ### ##### # # #
#   # # #         # #   # #   # #     #
### ### ####### ### ### # ### # ##### #
# #     #                 #     # #   #
# ### # # ### ######### # # # ### # ###
#   # # # #   #         #   # # #     #
### # ### # ##### ### ### ##### # ### #
#   # # # # #   # #   #     # # # #   #
# ### # ####### ##### ####### # ##### #
#       # #     #     #     # #       #
##### # # # # # ##### ### ### # #######
#     #     # #         #             #
########### ### ### ##### ########### #
#   #     # #   # #   # #         #   #
### # ### ### # # # # # # ##### ### ###
#     #   #   # #   #       # # # #   #
# ####### ######### ##### ### ### # # #
# #             #   #             # # #
### ########### # ##### ##### ### ### #
#   #   #   #     #         #   #   # #
# ##### ### # # ##### # ######### # # #
# #   #     # # #     #     # # # # # #
# # ####### # ### ### # # ### # # # ###
# #             #   # # #     #   # # #
# ### # # ##### ### ##### # ####### # #
# #   # #   #   #     #   # #     #   #
### ### # # ### # ### # ### ##### # ###
#     # # #   # # #   #   #     #     #
##### # # # # # # ### ### # # # # #####
# #   # # # # # # #   #   # # # #     #
# # ### # ### ####### # ### ##### ### #
#   #   # # #   # #   # #       #   # #
##### ##### ### # ##### ### # ##### ###
# #   # # #     #   #   #   #     #   #
# # ### # # ####### # # # ######### ###
#         #       #   # #         #   #
#######################################
