#######################################
# #   # #         #     #             #
# ### # # ######### # ########### # ###
#         #   #     #       #     # # #
# ### ####### # ####### ##### ####### #
#   #       #   # # #       #       # #
# ######### # ### # ######### ##### # #
# # # #     # #   #   #     # #     # #
### # ##### # # ### ####### # # ##### #
#   #   # #     #     #       #       #
### ### # # ##### ##### ##### #########
# #   # #     # #         #     #     #
# ### # # ##### # ### ########### ### #
#               #   #     #     # #   #
# # ##### ##### # ######### ####### ###
# # #         #   #       # # #       #
### # ##### ####### ##### # # # ##### #
# # # # # #             #   #   #     #
# # ### # # ########### ########### ###
# # #   #   #   #     # #       # # # #
# ##### # # # ### ######### ##### # # #
# #   #   #           # # # #   # #   #
# ### # # ### # ### ### # # # ### ### #
#     # #   # #   #     #   #     #   #
### ### ##### ### # ##### ### ##### # #
#       # # #   # # # # #       # # # #
# ### # # # # ### ### # # ####### # ###
# #   #   #     #       # #           #
### # # ### ### ### # ### # ######### #
#   # # # # #     # #           #   # #
# ### # # # # ##### # # # ### # # # ###
#   # #   # # #   # # # #   # #   # # #
##### ####### ### ### # ### ##### ### #
#           # #       # #   #   # # # #
##### ### # ######### ####### ### # # #
#   #   # #   #         #   # # # # # #
# ####### ######### # ### ### # # # # #
#           #       #           #     #
#######################################
