#######################################
#     #   #             # # # # #     #
# # ### ### ### ######### # # # # ### #
# # #   #   #       #   #     #     # #
### ### # ############# ### ##### ### #
# #   #   # #   #       #   # # # #   #
# ### ### # # ##### ####### # # ### ###
#   #   #     #     # #     # # # # # #
# ##### # ### # # ### ### ### # # # # #
# #     # # # # #     #       # # # # #
# # ##### # ### ####### ### ### # # # #
#   #       #     #   # #     #   #   #
# ##### ##### ##### ### # ##### ### # #
#   # # # # #         # #           # #
# ### # # # # ################# ##### #
#   #   # # # #     #   #           # #
### # ### # # ### ### ### #############
# #     #   #                         #
# ##### ### # ### ######### ### ##### #
#         #     #   #         #     # #
####### ### ########### ####### ##### #
# #         #       # #     # #     # #
# ######### # ####### # # ### ### ### #
# #   # #     #     # # # #       #   #
# ### # # ### # # # # ##### ### ### ###
#           #   # #     #     #   #   #
# ### ### # # # ##### # ######### ### #
# #     # # # #     # #     #     #   #
### ### ##### ##### ####### ####### # #
#     #     #     #   # # #   #     # #
##### # # ### # # # # # # # ###########
#     # # #   # # # #   #             #
# ########### ######### # ##### #######
#   #   #             # #     #       #
# # # # # ####### ##### ##### # # ### #
# # # #     #   #     #     # # #   # #
# ##### ### # ######### ### # ##### ###
# #     #           #     # #   #     #
#######################################
