#######################################
#           #     # #   #     #       #
# ####### # ### ### # ### # # # ### # #
# #   #   # #       # #   # # # #   # #
### # ### ######### # # # ########### #
# # # #       #   #     #   # # #     #
# ### ####### ### # # ####### # # #####
# #   #             #   #   #         #
# ### ##### ### ##### ### ### ####### #
# #           # #   # # # # # #   #   #
# ############### # # # # # # # # ### #
#       #         # # #         #   # #
### # # ### # ##### # ### ########### #
#   # #     #   #       # #         # #
### ### # # ### # ##### # # ### #######
# # #   # # #   # # #   #   # # #     #
# ### ####### # ### ### # ### # ### ###
#     #       # #             # #     #
# ### ##### # # ####### # # # ### ### #
# #     #   # # #       # # #       # #
# ### # ### ### # ##### # ### ### # # #
#   # # # #   # #     # #   # #   # # #
# ##### # ### # # # ####### # # ### ###
# # # # # #   # # #       # # #   # # #
# # # # # # ### # ### # ####### ### # #
# #   #   # # # #   # #   #   #   #   #
### # ### # # # ########### ### # #####
#   #     #   #     #       #   #     #
### # # ### # ### ##### ### # # ### # #
# # # #   # # # #   #   # # # #   # # #
# # # ### ##### ### # ### # # ### # ###
# # #   # # #       # #       #   #   #
# # ### ### ##### ### # ##### # #######
# # # #   # #     #   # #   # #       #
# # # ##### ########### # # # ### # # #
# # # #   #           # # # # #   # # #
# # # ### ########### # ### ####### # #
#   #                       #       # #
#######################################
