#######################################
#     #           #   #         #   # #
# ### ### ##### ### ### # # # ### ### #
# #       #   # # #     # # #   #     #
# ### ##### ##### ### ### ### # # #####
# # #     # # # #   # #   #   #   #   #
### # ##### # # ### ### # ### ##### # #
# # #       # # # #     #   #       # #
# # ### ##### # # # ############# #####
#     #   #   #       # #   #         #
##### # ### # # ### ### ### # ##### # #
#   #       #     # #     #   # # # # #
### ####### ######### ######### # # # #
#   #   # #   #     # # #       # # # #
# ### ### # # # ### # # # ####### # # #
#   # # # # # #   #   # # #       # # #
# ### # # ### # # # ### # # # ### ### #
#   #         # # # #       # #   #   #
# ### ######### # ### # # ##### #######
# #             #   # # #     # #     #
# # ### ### ### ##### ####### ### ### #
#   #   # #   #           # #     # # #
# ####### # # ######### ### ####### # #
#     #   # # #   #   # #         #   #
### # # # # # # ### # # # ##### # ### #
#   #   # # #       # #   # #   # # # #
# ########### # # # # ##### ##### # # #
#       #     # # # # #         # #   #
### # # ### ### ##### # # ######### # #
#   # #   # #       #   #     #   # # #
### # ##### ### ############# # # #####
#   #   # # #           # #   # # #   #
# # # ### # # ### ####### # ### ##### #
# # # #   # #   #         #         # #
# ### # ### # # # ### ############### #
# #       # # # # # #     #         # #
##### # ### ####### ######### ##### # #
#     #   #                     #     #
#######################################
