#######################################
#       #   #     # # #     # #     # #
####### ### ##### # # # ##### # ##### #
#           # #   #   # # #   # #     #
######### ### # # # ### # # ### # # ###
#   #         # #           # #   #   #
# # ### # ##### # ### ### # # ### #####
# # #   #     # # # # #   #   #       #
# ##### ########### ### ######### #####
#   #   # #       # # #     #     # # #
# # ### # # ##### # # # ##### # ### # #
# # #       #                 # #   # #
### ##### ##### ##### ### ##### ### # #
#         #         #   #     #   #   #
# ##### ### ##### # # # ### # ##### ###
# #     #     #   # # #   # #     #   #
##### # ### # ##### # ### ### # ### # #
#   # #   # # #     #   # #   #   # # #
# ##### # ### # # ####### ####### # # #
# #     #   # # #     #   #     #   # #
# # # # ### ##### ### ##### # ##### # #
#   # #   # #   #   # #     #       # #
##### ##### # # ### # ### # # # # # # #
#     #   # # # #   # #   # # # # # # #
# ### # # ### ### # ######### ### ### #
#   # # #         #   #       #   #   #
### ### # ### ### # # ##### ### ### ###
# # #   # # # #   # # #     #   #     #
# ######### # # ### # ##### # # # ### #
#   #       # # # # # #     # # #   # #
# ##### ### # # # ### # # # ##### # ###
#         # # #     # # # #   #   # # #
### ##### # # # ### ### # ### # ### # #
# #   # # #   #   #   # #   # # #     #
# ##### # ####### # ######### ####### #
# #   #   #   #   # # #     #   #   # #
# ### ### # ##### # # # ### # ### # # #
#         #       # #     #   #   #   #
#######################################
