#######################################
#             #   # #                 #
# ### ##### # ### # # ####### ### # ###
#   # #     # #           #     # #   #
# ########### ####### # ### # ####### #
# #   # # #   #     # # #   # # #     #
##### # # # ####### # ######### ##### #
#   #   #       #         #   # #     #
### ### ####### ####### ### # # # ### #
#         # # #           # #   #   # #
### ##### # # ##### ### # # ######### #
#     # # #     #     # # #   # #     #
# ### # # ##### ### # # # # ### ##### #
#   # #           # # # #   # #     # #
### ############# ### # # ### # ### ###
# # #   #   # #       # #         #   #
# # # ##### # # ########### ###########
#   # #   #     #     #           #   #
### # # # ##### # ##### ### ### # ### #
# # #   # # #     #     #     # #     #
# ####### # # # # ### ##### ### # ### #
# #   #       # #   #     #   # # #   #
# ### ### # ### ### ### ### # # # ### #
#         # #   #     #   # # # #   # #
# ####### ##### ### # ### # # # # #####
# #         #     # #   # # # # #   # #
# ##### ##### ######### ##### ####### #
#   # # # #           # #   #   #   # #
# # # ### # # # # ##### ### # ##### # #
# # # #     # # # #   #   #     #   # #
# # # ### ##### ##### ####### ### ### #
# # # # # #   #   # #         #     # #
# # # # ##### # # # ####### # # ##### #
# # # #         #   # #     #         #
# ### ######### ##### # ##### ##### ###
# #       # #         #   # #     #   #
# # # ### # ##### # # ##### # # #######
#   #   #     #   # #     #   #       #
#######################################
