#######################################
# #   #   # #   # # # #               #
# # ### ### # # # # # # ### ####### # #
#       #     # # #       #       # # #
# ### # ### ### # # # ############# ###
# #   # #   #   #   # #         #     #
####### # ### ### # ##### # ### #######
# # #   #   # #   #   # # # # #       #
# # # ##### ##### ##### # ### ####### #
# # #           #       #   # # # #   #
# # ##### ####### ######### # # # ### #
#   #   #   #   #       # #   # #   # #
### ### ### # ### ####### ### # ### ###
#     #   # # #       # # #   # #     #
##### # ### # ####### # # # ### # # ###
#   # # #   #   #       # # #   # # # #
### # # # ### # # # ##### # # # ### # #
# #   #       # # # #   #     # #     #
# # ### # # ### ### ### # # ### # # ###
#   #   # #   #     # #   #   #   #   #
# ### ### ######### # # ### ######### #
# #     #     #           #     # # # #
# # ### ######### ####### ##### # # # #
#   # # # #     #       # #   #   # # #
# ### ### # ### ##### ##### ####### # #
# #   #     #   #     #   # #       # #
# # # # ### # ######### # # # # ### # #
# # #     # #           #     #   # # #
# # ##### # # ######### # ##### # # # #
#       # # # # #     # #     # # # # #
# # ### ####### # ####### ########### #
# #   #               #           # # #
# ### ### ##### # ##### # # ##### # ###
#   #   #   #   #     # # #     #     #
# # # ######### # ### # ### ######### #
# # #       # # #   # #   #   # # #   #
##### ### ### ##### ### ##### # # # ###
#       #       #     #     #   #     #
#######################################
