#######################################
# # #   #   #           #     #       #
# # ### # ### ####### ####### ####### #
#   #     #     #   # # # # # # # # # #
# ### ### # # ### ##### # # # # # # # #
#   #   #   # # # #         # # #     #
# # ### ##### # # ### ##### # # # #####
# # #   #   # # # # # # #     # #   # #
# # # ##### ### # # ### ### # # ### # #
# #   #   # #   # # # #     # #   # # #
# ### ### # ### # # # ##### ##### # # #
# #     # # #   #     #   # # # #   # #
### ##### # ### ##### # ### # # # ### #
# # # # # #         #   #   # #   # # #
# # # # # ####### ### ##### # # ### # #
#   #         #         #   # # #   # #
# # ### ### # ##### # ##### # # # ### #
# #   # # # # # #   #     #   #   # # #
# ### ### # # # # ##### ### ### ### # #
# # #     # # #   #     # # #   #   # #
# # ##### ### ##### ##### # # ##### # #
#   #   #   #   #       #     #     # #
##### ##### # ######### ### ### ##### #
#     #       # # # #     #     #   # #
# ##### ####### # # ### ### ####### # #
#   # #         #     # #   #     # # #
# # # # ####### # # ### # ####### # # #
# # #   # #       #   #   # #   #   # #
### ##### ######### # # ### # ### ### #
# # #     #     #   # #   # #     #   #
# # ### ##### # # ### # ### ### # ### #
#   # # #     # # # # #     # # #   # #
# ### # # ### ##### # ### ### # ### # #
# #   #   #       #         #     # # #
# # # ####### ### ### # # # # ### ### #
# # #   #     #       # # #     #     #
# # # ############# ####### # ##### # #
#   #               #       #     # # #
#######################################
