#######################################
# #       #       #       # # #     # #
# ##### ######### # ####### # ### # # #
# #     # # # #       #           # # #
# # ##### # # # ####### ######### # # #
#   #           #   #   #       # #   #
# ##### ####### # ### ### # ###########
# #   # #     #         # # #   #     #
# # # ####### ##### # ##### ### # ### #
# # # # #     #   # #       #   #   # #
# # # # ##### # ##### ####### ### ### #
# # #   # # #         #     # #     # #
# ##### # # ### # ####### # # # ##### #
#     #         # #     # #         # #
# ### # ######### # ##### ########### #
# # #   #       #       # #       #   #
### # ##### ### # ####### # ##### #####
#     # # #   #   #   # #       #   # #
# ### # # ####### # ### # ### # ##### #
# #   # #   #       #   #   # #   #   #
# ##### # ####### # # ### ##### # # # #
# #     #         #       # # # #   # #
# ##### ##### ### # ####### # # ### ###
#   #           # #   #     # #   #   #
##### ### # ### # ##### ### # # # #####
#     #   # #   #     # #   #   #     #
### # # ####### ### # # # # ######### #
#   # #   #     #   #   # #         # #
# ####### # ##### # # ##### # ### ### #
# #       #     # # # #   # # # # #   #
# # ### # ### # # # # ### ### # # # ###
# #   # #   # # # # #   #   # #   # # #
# # # ### # ### ### ##### # # # ### # #
# # # #   # # # # # #   # # # #   #   #
##### # ##### # # ### ### ### ### ### #
#   # #   # #         #     #   #   # #
# # # ### # ##### ######### # ##### ###
# #   #     #             #   #       #
#######################################
