#######################################
#       #     #           #   #       #
####### # ### ######### ##### ### #####
# #   #     # # #       #         #   #
# ### # # ##### ### ### # ### ##### ###
#     # # # # #       # #   #       # #
### # ### # # ##### ##### # ######### #
# # #       #         #   # #   #     #
# # ##### ### ####### # ##### ### #####
# #   #     # # # #   # #   #   # #   #
# # ##### ##### # ### # ### ### # # # #
#   #         #     #   #     # #   # #
##### ####### ### ##### # ### # ### # #
#   # # #       # # # # # # #     # # #
# ##### ##### # # # # # # # ### ### # #
# #       # # # #   #   #     #     # #
# ####### # ### # ### ##### ###########
#   #   #       #   #         #       #
# ##### ### # # # ####### ### # #######
#     #   # # #     # #   #   # # # # #
# ##### # ######### # # # # ### # # # #
# # # # # # # # #       # #   #     # #
# # # # ### # # ### # ##### ### ##### #
#         #   #     # #   # #   # #   #
####### # # ##### # # # # ### ### ### #
#       #         # #   #   #   # #   #
### ####### ### # # # ##### ### # # # #
#   #       #   # # #   # #       # # #
##### ######### # ### ### ### ### ### #
#   # #         # #     #     # #     #
# # # # ### # # # ### ####### # # #####
# #   # #   # # # # #       #   # #   #
### # # # ### ##### ### ####### ### ###
#   # # # # # #   #           #       #
# # # ##### # # # # # ### #############
# # #   # #     # # # #   #       #   #
### # # # ####### ### ##### # # # ### #
#   # # #         #         # # #     #
#######################################
