#######################################
#   # #       # #           #         #
### # # ####### ##### ### ########### #
#   # # #     # #   # # # #           #
# ### # # ##### # ##### # ### ####### #
#   # # #   #   # # #       # #   #   #
### # # # ##### # # ##### ####### # ###
# #   # #     # #   # # #   # #   # # #
# # # # # # ### # ### # ### # ### # # #
#   #   # # # #   #   #   #   # # #   #
# ##### # # # ### # # ### ### # # ### #
# #   #   # # #     # #   # #     #   #
### # ##### # ##### ### ### ### ### ###
# # # #     #   #     #     #   #   # #
# # ### # # # ##### ### # ### ### ### #
# #     # # #   # #   # # # #       # #
# # ### ### ### # # # ### # # ####### #
# #   #   #   #   # #                 #
# ### ##### # ### ########### ### ### #
#   # #   # # # #         # # # #   # #
### ##### ### # ### # ### # # # # # ###
#           #   #   # #         # #   #
# ####### ##### # ### ##### ###########
#   #     #   # # # # # #   # #     # #
######### # ### # # ### # # # # ##### #
#   #   # # # # # # #     #       #   #
# ### ### # # # # # ##### ##### ##### #
# # # #         # # #     #   #       #
# # # # # ### ##### ### ### ##### # ###
#   #   # # #                   # #   #
# ### # # # ##### ####### # ##### # # #
# #   # # #       #       #     # # # #
# ##### ### ### # # ##### #############
#       #   #   # #     #       #     #
# ##### ### ### ########### # ### # # #
#   #     # #   # #   #   # #   # # # #
##### ##### # ### ### # ### # ### #####
#       #   #     #         #         #
#######################################
