#######################################
#   #     #     #   # # #             #
# ####### # ### ### # # # ### ### #####
#   #       # #     #       #   #     #
# # ######### ##### ### ##### # #######
# #     #   # # #         # # #       #
# ##### ### # # ### # # # # # ####### #
#   #       #       # # # #       #   #
# # ####### ### # ######### ####### ###
# # # #   #     #         # # # #     #
##### ### # # # ### ######### # # ### #
#   #   #   # #   # #     #     # #   #
### ### ##### # ### # # # ### ####### #
# #   #       #   #   # #     #     # #
# ### ##### # # ### # # # # ### #######
# #         # #   # # # # #   # #     #
# ######### ####### # ### # ### # ### #
#   # #   #   # # # # # # #   #     # #
# ### # # ### # # ### # # # # # ##### #
#     # # #       # # # # # #       # #
# ##### # ### # ### ### # ### ### ### #
#       #   # #       #   # # #   # # #
##### # ### # ####### ### # ####### ###
#   # # #         #   #         # #   #
### ### ### ### ### # ### # # # # # ###
# #     #   #     # # #   # # # # #   #
# ####### # ##### ### # ### ### # ### #
#   #     #   #     # # #     # #   # #
# # ##### ### ####### # ##### # ### # #
# #   #   #   #       #     # #       #
# ### # ### ### # ##### # # # ### ### #
# #   # # #   # # #     # # # # #   # #
### # # # ### # ######### # # # ##### #
# # #       # #     # #   # # #     # #
# # # ##### ##### ### # # # ##### # # #
#   #     #     # # # # # #       # # #
# ####### # ####### # # ### ##### ### #
#     #   #         #     #     # #   #
#######################################
