#######################################
#     # #   #       #             # # #
# ##### ### ##### ########### ##### # #
#   #   #           #   #             #
# # # ############# ### ### # # #######
# #   # #     #             # #   #   #
##### # ##### ##### # ####### # ### # #
#     # #         # #     #   #     # #
# ##### ######### ### ##### ### # #####
# # # #       #   #   #     #   #   # #
# # # ####### # # ### # # # ### ### # #
#       # #     #   # # # # # #   #   #
# # # # # ### # # # # # ##### ##### ###
# # # #       # # #   #     #   #     #
# # ####### ### ### ### # ### # # ### #
# #       # #   #   #   # #   # # #   #
# # ### # ### # # # # ##### ### ### # #
# # #   #   # # # # # #       #     # #
##### # ### ### ####### # ##### ##### #
#   # #   # #   #       #   #   #     #
### ############# ### # ### ### ### # #
#     #           #   # #     #   # # #
##### # ##### ### ##### # # # ##### # #
#   #   #       #   #   # # #     # # #
### # ### # # ### # ##### # ### ### ###
#     #   # # # # #   #   # #     # # #
# ####### # ### # ### ##### ####### # #
#       # # #   # #   #   #     #     #
# ### ### # # ### ##### ####### ##### #
#   #   # #     #     #       #     # #
# ##### ########### ####### ##### #####
#     # #       #     #               #
### # ### # ######### # ### # # ##### #
# # #     # #       # # # # # #     # #
# # ### ##### ##### ### # ##### ### # #
# #   # #     #   #   #       #   # # #
# ### # # ##### # ### ##### # ##### # #
#     # #       #   #       #     # # #
#######################################
