#######################################
#     #             #   #   #   # #   #
# ### # ########### # ### # # ### ### #
# #   #     # # # # # # # #   #   #   #
### ### ##### # # # # # ##### ### # ###
#     # # #   # #     #     #   #   # #
# ####### # ### ##### # ### # # # # # #
# # # # # #   # #   # # # #   # # #   #
# # # # # ### # # ### ### ### # # #####
#     #     # # # #     # #   #       #
##### # ##### # # ##### # # ### ### # #
# #   #     # #     # # # # # # # # # #
# ### ##### # ### ### # # # # ### # # #
#   # # #   #   #                 # # #
# ### # ### # ########### ##### # # ###
# #   # #                     # # #   #
# ### # ##### ### # # ##### ### # #####
# #           #   # #   # #   # # #   #
# ### ### ### # ####### # ##### # ### #
#     #   #   #   #           # # # # #
# ##### # ### ######### # # ### ### # #
# #     # #       #     # #   #   # # #
# # ### # ### # ### ### # ######### # #
# #   # # #   #   # #   #       # #   #
########### # # # # ##### ### ### # ###
#   #     # # # # #   #   #           #
### # ####### ### ######### ####### ###
# # #   #   #   # #   #   #   # #     #
# # # # # ### # ##### # # ### # ### # #
# #   #       #         # # # #     # #
# # # ### # # # ### ### ### # ####### #
#   # #   # # #   # # # #     #     # #
### # # ### # ##### # ### # ### #######
# # # # # # #   #   #   # #           #
# # # # # # ### # # ### # ##### ##### #
#   # # #     # # #     # #   # #   # #
# # # # ##### # ##### ####### # # # # #
# # # #     # #     #         # # #   #
#######################################
