#######################################
#     #   # #       #         #     # #
# ### ### # # # # # ####### # # ##### #
#   #     #   # # #   #     #       # #
# # # ### ##### # ####### ##### ##### #
# # #   #   # # #       # #         # #
### # # ### # ####### ### ### # ##### #
# # # #   #     #   # #   # # #       #
# # ####### # # ### # ##### # # #######
#   #   #   # #           #   #     # #
##### ######### # ### # # ##### # ### #
#               # #   # #       # #   #
# ##### ##### ### ####### ### # # # # #
# #     #       #   #     #   # # # # #
# # # ### # ##### # # # ##### # # # # #
# # # #   # #     # # # # #   # #   # #
### ### ##### ####### # # # ### # # ###
#     # # # # #       # #   #   # #   #
# ##### # # # ##### ### # # # ### # # #
# #     #       #     # # # #   # # # #
######### ### # ######### # ### ### # #
#     #     # #   #       # # # # # # #
# ### # # # # ######### # ### # # # # #
# #   # # # # #       # #   #   #   # #
# ##### ####### # ######### # ### # ###
# # #   #       #           #   # #   #
# # # ########### ### ##### # # ### ###
# #   #   #   # # #     #   # #   #   #
# ### ### # # # ### ##### ####### ### #
#       # # #     #     #       # # # #
######### # ####### # # ####### # # ###
# #     #   #       # #     #   #     #
# # ### ### # ####### # ### # ####### #
#   # #             # # #   #   #   # #
# ### ### ### ##### # # ####### ### # #
# #     #   # #   # # #       #   #   #
# ### ####### # # # # #################
#   #           # # #                 #
#######################################
