#######################################
# #             # #   #           #   #
# # ############# # ### ### ### ### ###
# #     #   #     #       #   # # #   #
# ### # ### # ####### # ### ##### ### #
#     #   # # #   #   # #     #   #   #
# ##### ### # ### ######### ### ##### #
#   #   #   #   # #     #             #
# ### # # ##### # # # ### ########### #
# #   # # #     # # #   #           # #
### ### # ### ### ### ### ######### ###
# # #   #         #     #     #   #   #
# ##### ### ########### # ##### ##### #
# #       #   #   #             #     #
# # ######### ### # ############# # ###
# #   #   # # # # # #   #     # # # # #
# ### ### # # # # # # ### ### # ##### #
# #     # #   # # #     # #           #
# ##### # # ### # ##### ##### # #######
#     #     # # #     #   #   #     # #
##### # ##### # ##### ### # ##### ### #
#     #         # #   # # #     # # # #
# ##### ##### ### ### # # # # ##### # #
#       # #   # # #     #   # # #     #
# ####### ### # # # ####### ### # ### #
#   #   #   #     # #         #   #   #
####### # ### # # # # ### ##### ### ###
#       # # # # # #   # # #   # #   # #
# ##### # # ### ####### # # ##### ### #
# #           #   #   # #   # #   # # #
# ### ####### ### ### # ### # # ### # #
# #   #           # # # #       # # # #
### ### # # # # ### # # # ####### # # #
#   #   # # # # #   #   #             #
# ### ####### ### # # ### ##### #######
# #     #         #   #       #     # #
### ####### ##### ####### ##### ##### #
#     #       #           #           #
#######################################
