#######################################
#       #     #     # #               #
####### # ### # ### # ##### ### #######
#   # #   #   # # # #         #   #   #
### # ##### ### # # # ##### # ### # ###
#               # # # # # # #   # # # #
####### ##### ### # # # # ### ##### # #
#     # #       # # # # #   # # #     #
# ### # ####### # # ### # # # # ##### #
#   # # #     # # # #     # #     # # #
##### # ### ### # # # ### # ##### # # #
#     # #   #   #   # #   #   # #   # #
# ### # # ######### # ####### # # ### #
# #   #   #     #   # #     #   # # # #
# # ### ### ####### ### # # ### # # # #
# # #   # # #   #   #   # # #     #   #
### ##### # ### # ####### ####### ### #
# #       #           # #             #
# # # ########### ### # ########### # #
#   # #   # # # #   #       #       # #
# ##### # # # # # # # ##### ##### # # #
# #     #       # # # # #   #     # # #
# # ### ############# # # # ##### # # #
#   #       #   # #   # # # #     # # #
####### ### # ### # # # ### ### # ### #
# # #   # #   #     # # #       # #   #
# # ##### # # ##### # # ##### # # # ###
# # #   #   # #     # # #     # # #   #
# # # # ### # # # ### # ####### ##### #
#   # # #   #   #   # #     #   #     #
# ### ### # ##### ### # # ### # # # ###
#     #   # #     #     # #   # # #   #
### ### # ### ####### # ##### # # ### #
#   # # # # # #   #   # #     # # #   #
# ### ##### ##### # # ####### ### ### #
# # #         # # # # #   #     # # # #
# # # ####### # # ### # ### # # # # # #
#       #               #   # # # #   #
#######################################
