#######################################
#       #     #   #     # #   #   # # #
# # # ##### # # ### # ### # ##### # # #
# # # #     # # #   #   # #       #   #
##### # ##### # ##### ### ####### ### #
# #     #         # # # #   #       # #
# ############# ### # # ### # ##### # #
#   #         # #     # #   #     # # #
### ### ##### # ### # # ### ##### ### #
#     #     # #     # # #       #   # #
# ####### ### ### # # # ####### # ### #
# #       #   #   # #       # #   #   #
# # ### ### ####### # ##### # # ##### #
# #   # #           # #   # #         #
# ### # ############# ### # ### # # # #
#     #   # #         # #       # # # #
# # ##### # ##### ### # ### ### ##### #
# #     #   # #   #       # # # #     #
# # ### ##### ##### ##### ### ####### #
# # # # #   #       # #   #   # #   # #
# ### ### # # ### ### ### ### # # # # #
#         # # #   #       # # #   # # #
### ####### # ############# # ### ### #
#   # #   # # #             # #       #
# ### # # # # # ##### ### # # # ##### #
#     # #   # # #     # # #     # #   #
####### ####### ####### ######### ### #
#   #     #   #   # # #   #       #   #
# # # ####### # ### # ### ####### # ###
# # # #   # #   #       #     #     # #
# # # # # # # ### # ### ### # # ### # #
# # # # # # # # # # #       #   #     #
### ##### # # # # ########### ##### # #
#       # #   #     #   #   # #   # # #
####### # ##### ##### ##### ### # # ###
#             # # #         #   #     #
# ### # ##### # # ##### ### # ####### #
#   # #     #   #       #     #       #
#######################################
