#######################################
# #         #       #     #   #     # #
# ####### ####### ##### ### # ##### # #
#     # # #   #   #       # #       # #
# ### # # ### # ##### ##### ### ##### #
# #   # # #     #   #     #   #   #   #
### ### # # # ##### # ### ### ##### # #
# # #   #   #   #   # # #     #     # #
# # ### ### ### # ##### # # # # ### ###
# #   #   # # #   #   # # # # # #     #
# ### ### # # # ### # # # ##### ##### #
# # #   #     #     #     #       #   #
# # ### ### ############### ##### #####
#   #         # # #   #         # #   #
# ##### ####### # # ### ############# #
# # #         #       # #   #   #   # #
# # ##### ##### ####### ### # # # ### #
#         # # #       #     # #       #
# # ### # # # # ##### # ### ### #######
# # #   # #   #   # # # #         # # #
# ### ### # # # ### # ### ######### # #
#   # # # # # #   # # # # #     #   # #
####### # ### # ### ### # # ##### # # #
# #       # #   #   #   # # #     #   #
# ####### # ### # ### ### # # #########
# #     #   #         # #   #     #   #
# # ### ### ##### # ### # ##### ### ###
# # #             # #           #     #
# ########### ### # # # ####### # #####
# # #   #       # #   #     # #     # #
# # ### # ####### # ### ##### ### ### #
# # #       #     # # #       #   #   #
# # # # # ####### # # ########### # ###
#     # # #   # # #       #     # #   #
##### ####### # ##### ##### ######### #
#       #     #                     # #
# ### ### ### ####### ##### ######### #
#   # #     #             #           #
#######################################
