#######################################
#   #   #             #   #           #
# # # # # # ######### # # ##### ### ###
# #   #   #   #     # # # # # # #     #
# ##### ######### ### ### # # ### ### #
# # # # #   # # # #   # # #   # # # # #
### # # # ### # # # ### # ### # ### # #
#   #   #   #     #     #   # #       #
### # # ### # ### # # ##### # ####### #
#   # # # #   #     #   #       # #   #
# ##### # ##### ##### # # # ##### ### #
#   # # #       # #   #   #     # #   #
### # ### ####### ############# # ### #
#   #   # # #   #       # # #   #   # #
# ### # ### # # ### ### # # ### ### # #
#     # #     #     # #     # #       #
####### ####### ##### # # # # ##### ###
#       # # #   # # #   # #   #       #
### ##### # ### # # ### ##### # ### # #
#   #     #   # #       #       #   # #
# ### ### ### ######### ##### ### ### #
#     #   #       #     #     #   #   #
### ##### ####### # ####### # ### # # #
#   #   #       # # #       #   # # # #
##### # ####### # # ### ####### ### ###
#     # #   # #     #     #     #   # #
# ##### # # # ### # ### # # ### ### # #
# #       #     # # #   # # #   #     #
# ### ####### # ### ####### ####### # #
# #       #   #       #     #       # #
# # ##### # ######### ##### # ### # ###
# # #     # # # #   #   #   #   # #   #
### # ####### # ### ##### ### ##### # #
#   #   #   # # #   #     #       # # #
# ##### # # # # ### # # # ########### #
# #   #   # #     #   # #   # #       #
# # # ######### # ##### ### # ####### #
# # #           #         #   #       #
#######################################
