#######################################
#       #   # #         #   #   # #   #
# ##### ### # # ######### ### ### # # #
# #         #           # # #     # # #
# # ### # # ### # ##### # # # ### # ###
# # #   # #     # #   #   # #   # #   #
### ############# ### # ### # ####### #
# #   #   #     #   # # # #   #   #   #
# # ### ##### ##### # ### ### ### # ###
#     #   #   #     # #     #     # # #
######### # ### ### # # ######### # # #
#                 #     #     #   #   #
# ####### ########### ### # ### ##### #
# #   # # #   # #     # # # # # #     #
# ### # ##### # # ##### ### # # ### ###
#   #   # # # #   #     # # #         #
####### # # # ### ### ### # ### #######
#   #   #   # #     #       #   # #   #
### ### ### # # ####### ### # ### # ###
#   # # # #   # # # #   #     # #     #
# ### # # # ### # # ####### ### # # ###
# # #       # # # #   #   # # #   #   #
# # ### ### # # # ### # ### # # # #####
#   #   #       #     #   # #   #   # #
### ##### ##### ##### # ### # # # # # #
# # # #     #     #           # # #   #
# # # ####### # ### ##### # # ### ### #
#   #       # #   # # #   # #   # #   #
# ### # # ####### # # # ######### #####
# #   # #   #   # #   #         #     #
# ### ### # # # # # ################# #
#     # # #   #         #   #     # # #
# # # # ##### ### # ##### ### # ### # #
# # #   #     #   #           #     # #
# # # # ### # ##### # # ######### #####
# # # # #   # # #   # # # #     #     #
# ##### # ### # # ### ### # # ####### #
#   #   # #   #     #       #       # #
#######################################
