#######################################
#                 # #   #     # #     #
# ##### # ######### # # ### ### # ### #
# #   # #         # # #     #     #   #
### ### ##### ##### ### # ### #########
#           #     #   # #   #         #
# # # ### # ####### # # # ##### # ### #
# # #   # #         # # # # #   # # # #
# ####### # # # # ### ### # # ### # # #
#     # # # # # # #   #   # #   # #   #
# ### # ######### ##### ### # # ##### #
#   #     #     # #           #     # #
# ### ### # ### ### # ######### ##### #
#   #   #   #       # # #     #     # #
# # ### ### ########### # ##### # # ###
# #   #   #       #         # # # # # #
# ##### ######### # ### ### # ### # # #
# #   #       #       #   #     # # # #
# ### # # # # ### ### ### # # ### # # #
#     # # # #   #   #   # # # #   #   #
# # # # # # # # # # # # # # ######### #
# # # # # # # # # # # # # #     #   # #
# ####### ##### ######### ### ### ### #
# #   # #   #   #     #     #     # # #
# # ### # # # ### ### # # # # # ### # #
#   #   # # #   #   # # # # # #     # #
### # # ##### # # # # ### ##### ##### #
# #   #   # # #   # #   # #     #     #
# # # ##### ##### ####### # ###########
# # # #       # #       # #         # #
# # # # ### ### # ### # ##### ####### #
# # # #   #     #   # #     #       # #
# # # ### ### ####### ####### ### ### #
#   #     #   #             #   # #   #
# ####### # ### # ####### ####### ### #
#   # # # # #   #   # #     #     #   #
# # # # ### # ##### # ### ### ##### # #
# #   #     # #     #       #       # #
#######################################
