#######################################
#   # #     # #   #           #       #
# # # ##### # # ### ######### # # #####
# # #     # #       #           # # # #
# ####### # ######### ############# # #
#     #   #     #   #     #   # # #   #
# ####### # # ### ####### ### # # ### #
# #   #     #     # # #     # #       #
# # ############# # # ##### # # #######
#       #     # # #     #       #     #
####### ##### # # # ##### ######### ###
# #   #     #         #         #   # #
# # # ##### ### ### # ### ##### # ### #
#   #   #   # # #   #         #   #   #
# ##### # ### ##### ####### ### ### ###
# #           # # #   #   # # #       #
# ### # # ### # # ### ### # # ### ### #
#   # # #   #             #     #   # #
####### # ######### # # ####### ### # #
#     # # #         # #       #   # # #
### # ### # ### ####### # ##### ### # #
# # # #   # #     #     #   # # #   # #
# # ### ##### ######### ##### # # ### #
# # #   # #           #       # #   # #
# # ##### # ##### ### ####### # #######
#     #     #   #   #   #   # # #     #
##### # ### # ### # ### # # ##### # ###
# #   # #     #   #   #   #   #   #   #
# # ### # ##### ##### # # ####### ### #
# #     # # #       # # #       # #   #
# ##### ### ##### ##### ### # ##### # #
#   #   # #           # # # # #     # #
# # # ### # ##### # # ### # # # # ### #
# #       # #     # #   # # # # #   # #
# ##### ##### # ##### # # # ####### # #
#     # # #   # #   # # # # #   #   # #
# # # ### ### # # # ### # # # # # ### #
# # #   #     #   # #     #   #   #   #
#######################################
