#######################################
# #   #       #   # #       #         #
# # ### ##### ### # # ##### # # ##### #
# #         # #     # #       #     # #
# ####### # ### # ##### ############# #
#         #     #     #     #   #   # #
# ####### ### ######### # # # ### #####
# #       # #     #   # # #       #   #
# # ####### ### ### # # ##### ##### ###
# # #           #   # #   #           #
# ### ##### ### ##### # ####### ##### #
# # #   #     #   #   # # #       # # #
### ##### ### ##### # # # ##### ### # #
#           # #     #   #   # # #   # #
# ### # # ##### # ### ##### # ### ### #
# # # # #       # #         #   #   # #
### ### ##### ### ##### ##### ##### ###
# #       #   #       #   #     # #   #
# ##### # # ### ##### # # # ##### # ###
# #     # # #       # # #   #   #   # #
# # # ######### ##### ##### # ### ### #
#   #     #     #   # #         # #   #
# ### ### ### # # # # # # # # ### ### #
# #   #     # # # #   # # # #     #   #
########### # # # ### ### # ##### ### #
#           # # # # # # # # #   #   # #
### # ### # # ### # ### # # ### ### # #
#   #   # # #   # #     # #       #   #
# ####### ##### # # ########### ##### #
#   #   # #   # # # #     #   # #     #
# ##### ### ##### # # ### # ##### #####
#     #   #             # #     #   # #
# ####### ######### ### # # ### ### # #
#       #   #         # #   #   # # # #
# ### # # # ##### ### ########### ### #
# # # # # #     #   #         # #     #
# # # ######### # ####### ### # # ### #
#   #   #         #         #       # #
#######################################
