#######################################
#   #   #   #     # #     #       #   #
# # # # # ### ### # # ### ### # ##### #
# # # #   # # #   #   #     # # # #   #
### # ##### # # ##### ##### # ### # ###
# # #       # # #   # # #   # #   #   #
# # ####### # ### ### # ##### ### # ###
#     # #   #     #   #   #   #   #   #
##### # ### # ####### ### # ### ### ###
# #     #   #   # # #   #   #     # # #
# ##### ### ### # # ### # ### ##### # #
# # #   #     #   #   #   #     #     #
# # # ### ####### ### ### # ##### #####
#     # #     #   #     # #   # #   # #
# ##### ##### # ### ### # # ### # # # #
# #     #   # #   #   # #   # #   #   #
# # # ### ### # # ##### ### # ####### #
# # # #   # #   #       #           # #
# # ### ### # # ######### ### ####### #
#             #   #       #           #
# # ### ##### ######### ### ######### #
# #   #     #   #       # #         # #
# ### # ### # ##### # ### # ### # ### #
# #   #   # # #     # #       # # # # #
##### ### # # # ##### ### ### ### # ###
# # #   # # #     #     # #     # #   #
# # # ##### # # ### ########### # ### #
#   #     # # #   #         # # # #   #
# ##### ### # # ##### ####### ### ### #
#       #   # # #   # #     # #     # #
# ##### # # # ### ### # ### # # ### # #
# #     # # #       #     # # #   #   #
### # # # # ############# # # ##### ###
#   # # # #   #   # # # # # # #       #
# ##### ### # # # # # # ### # # #######
# # #   #   # # #   #   #   # #       #
# # ##### ####### # # ####### ### ### #
#     #           #         #     #   #
#######################################
