#######################################
#       #         # #       #   #     #
# ### ### ####### # ### ##### ### #####
#   #   #   #       #     # #     #   #
### ### # ######### # ### # # ##### ###
#     #     # #     #   #       # #   #
# ######### # ##### # # ######### # ###
#   #     # #   #     # # #   # # #   #
# ##### ##### # ### ### # ### # # # # #
# #   # # #   #     # # #   # #     # #
##### # # ####### ### # # ### # #######
# # #   #   #   #   #   #             #
# # ### ### # ### ##### ### # # # ### #
#   # #   #       #   #     # # # #   #
# # # ### ######### # ### ##### ##### #
# # #   #   # #     #       #     #   #
### # ##### # # ### # ### # # # ### # #
#   #           # # #   # # # # # # # #
# ############# # # ########### # ### #
#   #   #     # #   #             # # #
### ### ### # # # # # ####### # ### ###
# #         #   # # # #     # #       #
# # ############# ######### # ### ### #
#       # # #           #     #   #   #
# ### ### # ### ### ### # ### # ### ###
# # # #   #   #   #   # # #   #   #   #
### ### ### # ########### ### # # ### #
#   #   #   #   #       # #   # #   # #
# ### ######### # ### # # # ### ### ###
# # #   #       #   # #   # # # # #   #
# # # ### ### ### ### # ### # ### ### #
# # # #     #     #   # # #   #     # #
# # # # ### # # ### ##### ### ### #####
# #   # # # # #   #     #       #     #
# # ##### ##### ##### ### # ####### # #
#             #   # # #   #       # # #
# ##### ##### # ### ### ##### # # ### #
#     #     #     #     #     # #     #
#######################################
