#######################################
# #         #         #   #           #
# # ####### # ####### ### # ####### # #
# #   #   #   #     #   #     #     # #
# # # ### ##### ##### # # ### ####### #
# # #   #   #   #   # #     # #   # # #
# # # ### ### ##### ####### ### # # ###
# # #   #     #   # #   # # #   # #   #
# # ### ### ### # # # # # ### ### # ###
# # # #     #   #     #   #   # # #   #
# # # ####### ####### ### # ### # # # #
#     # #         # #   #       # # # #
# # ### ### ### ### # # ######### ### #
# #   #   # #   #   # # # #     #     #
# ##### # # ##### ####### # # # ##### #
#     # #   #   #   # #   # # #   #   #
##### # ##### ### # # # ##### ####### #
#     #           #         #       # #
##### ### ######### # ### ##### ### # #
#       # #     #   #   # #     #   # #
# # ##### ##### # ### ####### ### #####
# # #     #   #   #   # #     # #     #
### # ##### ########### ### # # ##### #
# # # #       #       # #   #   #   # #
# # # # ### ### ##### # # ### ### # ###
#         # # # #         # # #   #   #
### ##### ### ### ######### # ##### ###
#       # #   #   #         #     #   #
# # ### ##### # ### ################# #
# # # #     # #     # #   #   #   #   #
# ### ####### # ##### # ### # # ### ###
#   # #   #           #     #   # #   #
# ### ### # ########### ####### # ### #
#     #   #   #   #     #   # #   #   #
# ### ### # # # # # ##### ### ##### ###
#   #     # #   #   #             #   #
# ### ##### ######### ########### ### #
#   #                     #           #
#######################################
