#######################################
# # #     #       #       #     #     #
# # # ####### ########### ### # # ### #
#     #   # #   #   #   #     #   #   #
# ####### # ### # ### ############# ###
# #     #   #   #     #   #   #   #   #
# ### ##### # ### ##### ##### ### # # #
# #       #   #   #   # # #         # #
# ### ##### ### ### # # # # ##### ### #
# #     #       #   #     #   # # # # #
# # ### # ####### # ####### ### # # ###
# # # # #   #     #   #         # # # #
# ### # ### # ######### # ######### # #
# #   #   #     #     # #         # # #
# # ##### ### # # ##### ##### ### # # #
# #     #     #     # # # # #   #     #
# ### ######### ##### # # # ######### #
#   #     # #     #   #         # #   #
# ####### # # ### # # # ### # # # # ###
#     #   # #   # # #   #   # # # # # #
# ##### ### # ####### ### ### ### ### #
#     # # #     # #     #   # # # #   #
##### # # ### ### # ### ##### # # # ###
#         #       # #       #   #     #
######### # ##### # ############# ### #
#   # # # # #   #   # #     #   # # # #
### # # # # # ### ### # # # ### # # # #
#         # #   #       # #     # # # #
# ### ### # # ####### ### ### ### # # #
# #   #         #   # #     #   #   # #
####### # ####### ##### ### ### ### # #
# #   # #             #   #   # #   # #
# # # # ### ### ### # ######### # ### #
# # #     #   #   # #         #   # # #
# # # ##### ######### ### ### # ### # #
#   #     #         #   # #   # #   # #
### # ### ################# ##### ### #
#   #   #             #         #     #
#######################################
