#######################################
#   #   #       #         # #     #   #
# # # ######### # ### ##### # # # # # #
# #   # # #     # #       #   # # # # #
# ### # # ##### ### ### ### ### ##### #
# # #   #       #   # # #   # #       #
# # # ##### ### # ### ####### ##### ###
# #         #   #       # #   # # #   #
### # ####### # # ##### # # ### # ### #
# # #   # # # # # #     #     #       #
# ##### # # # ### ########### ### # ###
#   #   #   #   #       #   #   # #   #
### # ##### ########### ### ### # ### #
#   # #           # #   #       # #   #
# ### ### ### ##### # ### ### ### # # #
# # # #     #     # # #   # #   # # # #
# # # # ### ####### # # ### ### ##### #
#     # # #   #   # # # #     #     # #
##### # # ####### # # # ### ### ##### #
#       #     # #       # # # # #   # #
### ### # ##### ####### # # # # # # # #
# #   # #   # #     # # #     # # #   #
# ##### # ### # ### # # # ######### ###
#   #             # # # #       #   # #
### ########### ##### # # # # ##### # #
# #     #   #   #   #     # # #     # #
# ### # ### # ### # # # ### ##### ### #
# # # #   #       # # # # #   #     # #
# # # ####### ####### ### ### ### ### #
#       #   #           # # #   # #   #
### ##### ### # ######### # ### # # ###
#   #     #   # #     #   #   # # #   #
### # ##### ##### ##### ##### ### ### #
# # # # #   #     #     #   #     #   #
# # # # # ### ### ### ### # # ##### ###
#   # #         # #       #   #       #
# ### # ####### ### ### ############# #
#             #       #               #
#######################################
