#######################################
#   # #             #   # #         # #
### # # ### ####### # # # ### ##### # #
# # # # #     #       #   # # #   #   #
# # # ### ####### # ### # # # # #######
#     #     #     # #   #   # #       #
# # # # # # # # ### # # ##### # ##### #
# # #   # # # # #   # #   #   #     # #
# ### # # ####### ##### ### # # ### # #
#   # # # #         # # #   #   # # # #
# ### # ############# # # ####### # ###
#   # #   #                       #   #
### ##### ########### # ##### ####### #
#   #   #     # #     #     #     # # #
# ### ##### ### ### # # # # ### # # # #
#     #   # # #     # # # # #   #   # #
### ##### ### ##### ##### ####### ### #
#           # #         #       #   # #
# # ######### ######### # # ##### #####
# #       # # #         # # # # #   # #
##### # ### # ##### ##### ### # # ### #
#   # # #           #       # #   # # #
# ### # ##### ### # # ##### # ### # # #
#   # # # #   #   # #   #     #   # # #
# # ### # ##### # ######### ### ### # #
# #     #     # #         #   #   #   #
##### ### # ##### # # # # # ##### # # #
#   #   # #   #   # # # # #     # # # #
# # # ### ### # ##### # ### # # # # # #
# # # #   #   # #     # #   # # #   # #
# # # # ### ######### # ##### # ##### #
# # # # #   #         #   #   #   #   #
# ##### # ##### ####### # # # ##### # #
#   #   # #   # #     # # # #     # # #
### # ### ### ### ### # ### ### # # # #
# #   # # #     # #   #   # # # # # # #
# # ### # # # ### # # # ### # # ##### #
#       #   #     # #   #     #     # #
#######################################
