#######################################
#       # #       #     #     #       #
### # ### ##### ### # ### ### ### ### #
#   # #     #       # #   # #   #   # #
# ##### ##### ##### ### ### ### ### ###
#   #     #       # #   # # #   #   # #
### ##### ####### # # ### # # ### ### #
# #   # #         # # # #         # # #
# # # # ########### ### # ### # # # # #
# # #     # # # #   # # #   # # # #   #
# ####### # # # ### # # ### ### ### # #
# # #         #     #   #   # #     # #
# # ##### ######### ### # ### ##### # #
# #     #     #   # # #   #       # # #
# ##### # # ##### # # # ##### ##### ###
#   # #   #     #     # #     #   # # #
### # # ##### ##### ### ### ### ### # #
#   # # #   # # #   #   # #   # #   # #
# # # # # # ### ### ##### ### # # ### #
# #   #   #   #     #     #     # #   #
# ########### # ##### ### # ### # ### #
# #     #   #   # #   # # #   # # # # #
# # ####### ### # # ### # ##### # # # #
#         #     #   # # #   #         #
### ##### ##### ##### # ### ### ### # #
#       #       #   # # # #   # #   # #
# ########### # # # # # # ### ### ### #
# #   # # #   # # # #         #     # #
# # # # # ### # # ### # ##### # # # # #
# # #   #     #       # #       # # # #
##### # ############# ##### # ### # # #
#     #         #     #     # #   # # #
# # ######### ### # ### ### # ####### #
# # # #     #     #   #   # #     # # #
##### ##### ####### ####### ####### # #
#   #   #   #     #   #           #   #
# # ### # # # ### ### ######### # ### #
# #       #   #       #         # #   #
#######################################
