#######################################
#   #       #   #           #         #
# # ##### # # # # ################# # #
# # #     #   # # #       #     #   # #
# # ### # ### # # # ####### # ##### ###
# #   # #   # # # # #       #     #   #
# ### # ### ##### # ##### ########### #
#   # #   # #     # #         #       #
### ### ##### ##### # # ##### # #######
#     #   #       #   #   #   #       #
##### # # # ### ######### ########### #
#   #   # # # # #   #   #     #     # #
### ### ### # # # # ### # ##### ##### #
#   #   #   #   # #   #     #     #   #
### # # # ### ### ####### ### ##### # #
# # # #   #       #     #     # #   # #
# # # ### ######### ### # ##### # #####
#   # # #   #   # # #     # #         #
### # # ##### ### # ####### # ####### #
# #     #   #           # # # #       #
# # # # # ### # ####### # # ##### # ###
#   # #     # # # #   #         # # # #
# # # # ### ### # # # ######### # # # #
# # # #   # #       #     #   #   #   #
####### ####### ##### ### # # ####### #
#               #   # #     #   #   # #
# ############### ### ##### ##### # # #
#           #     # #     # #   # # # #
# ########### # ### ### # # # ### # ###
#         #   #     #   # #     # #   #
### ####### ##### # ### # # # # ##### #
#     #         # #   # # # # # #   # #
# ##### ### ### # ##### # ####### # # #
#   #   # # #   #     # #     #   #   #
### # ### ######### ####### # ### #####
#       # #     #   #     # #         #
# ### # # # ### # ##### ### ### #######
#   # #   #   #   #         #         #
#######################################
