#######################################
# #   #   #   #     #   # # # #   #   #
# # # # # # # ##### # ### # # # # ### #
# # #   # # #   # #   #     #   #   # #
# # ########### # ### ##### ### # # # #
# # # #                 #   #   # # # #
# # # # ################# ### ##### # #
#   #   # #             #     #     # #
### ### # ##### ####### ### ### ##### #
#         #   #       #     #     # # #
### ####### # # # ##### ##### ##### # #
# #   #     #   #     #     # #       #
# ### # ####################### ##### #
#     # # #           #         #   # #
# # ### # # ######### # ##### # # # # #
# # #         #   #       #   #   # # #
# # # ### # ### ########### ####### # #
# # # #   #     #   #   #   #       # #
### # ##### ####### # # # # # # ### # #
# # #   #   # #       # # # # #   # # #
# # ##### # # # ##### ############### #
# #     # # # # #     #     # #       #
# ### ##### # # ####### ### # ##### ###
#   # #     #   #     # #   #   #     #
# # # ##### # ### ##### # ### ##### ###
# #     #         #   # #     #       #
####### # ######### ### ####### ##### #
# #           #     #       #   # #   #
# # ### ##### # ##### ##### # ### # ###
#   #     # #   #       #   #   #   # #
# # ####### ####### # # # ### # # ### #
# #       # #       # # # #   # # #   #
# ####### # # ####### ####### # # ### #
#       #       # #     #   # # #     #
### ######### # # ### # # # ### ### ###
#   #       # # #   # # # #     # #   #
# ### # ######### ### ### ####### ### #
#     #             #   #         #   #
#######################################
