#######################################
#             # #     # #   #         #
##### ######### ##### # # ### # ##### #
#   #     #   # #         #   # #   # #
### # # ### ### # ##### ### ##### #####
#     #           # #           # #   #
# # ### # ##### ### # # ### # # # # ###
# #   # #   #       # # #   # # # #   #
########### # # ######### ### ### # ###
#           # #   #       #           #
# # ### # ##### # ########### # # ### #
# # # # # #     #     # #     # # #   #
# ### # # # # ### # ### ### ##### ### #
# #     # # #   # #     #     #   #   #
# ####### # # ### ######### # # # # # #
#     #   # # #       #     # # # # # #
### # ####### ##### # ##### ##### # # #
#   #       # #     #     #   #   # # #
########### # ##### ##### ### # ### # #
#     #     # # #     #     # #   # # #
# ### # ##### # # ### ### ### ### # # #
#   #   #   #   #   #   #   # # # # # #
# # ### # # ##### # ####### ### #######
# # # #   #   #   # #                 #
# ### ############### ####### ### # # #
# #   #       #     #   #       # # # #
# # # # ##### # ##### # # ######### # #
#   # #   # # #   # # # # #       # # #
### # ### # # # # # # ### # ### # #####
#   #   #   #   # #     # #   # #   # #
# # ### ### ##### # # ### # ######### #
# # # # #   # #   # # #     #   #     #
# ### # ##### # # # ### ### # ### ### #
#   #     # # # #     # #       #   # #
### ### ### # # ##### ### ##### ### # #
#     #     # # #   #   # # #   #   # #
# ### ##### # # # # ### ### # # ##### #
#   #   #   #     #   #     # #       #
#######################################
