#######################################
#   #       #         # #         #   #
# # # ### ### # ####### ### ######### #
# # #   # #   # #       #     #     # #
# ##### ####### ####### # ### # ##### #
#   #       # # #         # # #   #   #
### # ####### # ########### # # ### ###
#             # #           #     #   #
############# # # ####### ### # ##### #
#     #     #   # #           #     # #
##### ### # ### ######### ##### ##### #
#     #   #   #   # # #   # #   # #   #
# ##### # ####### # # ### # ### # ### #
# #     #   #   #   # #   #     #     #
# # ####### ### ### # ######### ##### #
#   #       #     #         # #   # # #
##### ######### # ##### ##### # ### # #
#     # # #     #   #   #             #
### ### # # ### ### ### # ##### # ### #
# #   # #   # #   #       #     # #   #
# ### # ### # ### ####### # ##### ### #
#     #       #   # # # # #   # # #   #
# # # ### ######### # # ####### ##### #
# # # # #     #           # #         #
# # ### ### # # ####### ### ####### # #
# #   # #   # # #       #   #       # #
# # # # # # ######### # # ### # ### # #
# # #   # # # #   # # #       # #   # #
# # ##### # # # # # ### # ##### ##### #
# # #     #   # # #     # #     # #   #
# # # ######### ####### ##### ### # # #
# #   #   #     #   #   #     #     # #
### ### # # ##### ####### ##### ### # #
# #   # #   #   #       # # #   #   # #
# ### # # ### ####### ### # ### ### # #
# #   # #     #     #     #   #   # # #
# # ### ##### ##### # ### # ### ##### #
#   #   #               # #     #     #
#######################################
