#######################################
#     # #       #     #       #       #
# # # # ##### ####### # # # ####### # #
# # # #   #     # #   # # #   #   # # #
### # # ##### ### # # ### ####### # ###
#   #   #   #   # # #   # #   #   #   #
# ####### ### # # # ### # ### # ##### #
#         #   # #     #     # # #     #
# ##### ### ########### ### # # # #####
#   #   # #     #   # # #             #
### # ### ##### ### # ##### ####### ###
# # # #       # #     #         #   # #
# # ### ##### # ##### ##### ##### # # #
# # # # #   #   #       # # #     #   #
# # # ### # # ######### # # ### ### ###
# #     # #     #             # #     #
# # # # ### ### ##### # # ### ### ### #
# # # #     #   #     # #   # # #   # #
# # ##### ##### ### ##### # ### ### # #
# # #   # #       # #     #       # # #
# # ### # # # # # # # # ############# #
# #   #   # # # #   # #     #     # # #
# ### ### ### # # # ### # ### # # # ###
#     #     # # # #   # #     # # #   #
### ### ########### # ######### # # # #
# # # # #     # #   #     #     # # # #
# # # # # ### # # # ### # # # ### ### #
# # #   #   # #   # #   # # # #     # #
# ####### # # ### ### # ### # ####### #
#         # #     #   # #   #         #
# # ### ############### # # ##### ### #
# # # #     #   #       # # #   #   # #
##### # ####### ##### ### ### ##### # #
#     # #   #         #     #     # # #
##### ##### ####### ### ### ##### # ###
#     #   # #     #   #   #     # #   #
# ##### # # # # ### ############# ### #
#       #     #     #                 #
#######################################
