#######################################
#     #             #       # #       #
# # ### ##### # ##### ##### # ####### #
# #       # # # # #     #           # #
########### ### # ####### ### ##### # #
#   #     #     # # #       # # # # # #
# ##### ### ##### # ##### # ### # # # #
#     # #   #   #   # # # #   # #     #
### ### # ### # # ### # # ### # ##### #
# #     #     #     #     #   #     # #
# ##### # # ##### ##### ########### ###
#     #   # # #   #   #       # # #   #
### # ### # # # ### # # ##### # # ### #
#   # # # # # # #   #     #     #   # #
# ### # ### # # ### ### # ####### # # #
#   #   #   # # #   # # #     #   #   #
# ### ##### # # # ### ### ### # # #####
# #   # #   # # #   # #   #     # #   #
### ### ##### # # ### ### # ####### # #
# # #   # # # #   #     # # #       # #
# # # ### # # ######### # # # ##### # #
#     #   #     #         # # # #   # #
# ##### ### ########### ##### # ### # #
#       #       # #           # # # # #
# ##### # ##### # # # ######### # ### #
#     #   #   #   # # #     #       # #
### ##### # # ####### ### ### ####### #
#   #     # #           #   #     #   #
# ##### # ####### ##### # ### ####### #
#   # # #       #     #             # #
# ### # ####### # # ######### #########
# #   # #         #     #   #         #
##### # ##### ### ### # # ######### # #
#     # # #   #   #   #       #   # # #
# ### ### # ### ### ##### ##### # # ###
#   #       #     #     # # #   # #   #
### ######### ##### # ### # ### # #####
#   #             # # #         #     #
#######################################
