#######################################
#   # #   #     #   #       # #       #
# # # ### # ### # ######### # ### # # #
# #     # #   # # #   #     #   # # # #
# ##### # # # ### # # # ####### ### # #
#     # #   #   #   # #     #   #   # #
##### ### ######### ##### ### ### #####
# #       #       #     #       #     #
# # ######### ######### ##### ####### #
# # #       #         # #   #       # #
# # # ### # ##### ### # # ##### ### # #
# # # #   # #   # #   # # #     # #   #
# # ### ### ### # ##### # ### # # #####
# #     # #   #   # #   #   # # # #   #
# ####### ### ### # # ### ### ### # ###
#           #     #       #           #
# ##### ### # ### # ### ### ###########
#   #   # #   # # #   # #           # #
######### ### # ### ### # ### ####### #
# #     # #   # #   # #   #   #       #
# # ### # # # # # ### ##### ### #######
#   # #   # #     # #   # # #   #   # #
# ### ########### # # ### # # ### ### #
# #           # # # # # # # #   #   # #
# ######### ### ### # # # # # # # # # #
#     #     #       #   # #   #   #   #
# ######### ####### # ### ### ### ### #
# #     # # # #     #     #     # #   #
# # # ### # # # # # # # ### ### # #####
#   # #     #   # #   #       # #   # #
# ### ##### # # # # ### # # # # # ### #
#   #         # # # #   # # # # #     #
### # # # ### # ##### # ### ### # #####
#   # # #   # #   #   # # # #   # #   #
# ##### # # ##### ### # # ### # ##### #
#   #   # #     # #   # # # # #     # #
# ### ####### # ####### # # # ####### #
#   #       # # #       #             #
#######################################
