#######################################
#   #   #   #       #     #   #     # #
# # # ### ##### ### # ####### # ### # #
# # #   # #   #   #   # #     #   # # #
# ##### # # ##### ##### # ####### # # #
# # #   #     #   # #     #   #   # # #
# # # ##### ### ### # ### # # ##### # #
# #   #   #     #       #   #       # #
# # ### # # ##### ### # ####### ##### #
#   #   #     # # # # # #     # # #   #
# ### # ####### ### # ### ### ### ### #
#   # # #   # #       #     # #   #   #
# ### ##### # # ########### # # # # ###
# #       #     #     # #   #   # #   #
# ####### # # # ### ### ####### # # # #
# # #       # # #   #     #     # # # #
# # ##### # ##### # # ##### ##### ### #
# #   # # # # #   #       # #   #   # #
# ### # ### # # ########### # # ### # #
#   #                     #   # #   # #
# ### ####### ########### ##### # # # #
#     #     #       #     #     # # # #
# ####### # ### # # # ### # ##### # # #
# #     # #   # # # # # # #     # # # #
# # ##### ### ######### ####### # ### #
#     # #   #       #       #   #   # #
# ##### # ####### ##### ### # # ### # #
#         #           # #     #   #   #
### # # ##### # # # # ### ####### #####
#   # #     # # # # #     #   #       #
# ### # ######### # ##### ### ####### #
#   # #   #     # # # # # # #         #
# # # # ##### ### ### # ### ### ### # #
# # # #   # #   #   #   #   # # #   # #
### # # # # # ### ### ### # # ### ### #
# # # # # # # # #   #   # #   #   #   #
# ##### ### # # # ### # # ### # ### ###
#             #       #     # #   #   #
#######################################
