#######################################
#     #     #   #     # #         #   #
### ##### # # # # ##### # ####### # ###
#   #     # # #   #   # # #     # #   #
# ### ##### # ##### ### # # ### ##### #
#   # #     #     # #     # #         #
### # ### ### # # # ### # ### ####### #
# #     # #   # # #   # # # # #   #   #
# ##### # ####### ### ### # # # # # ###
# #     #           # #   #   # #   # #
# # ########### ##### # ### # ### ### #
#   # #               #     #   #     #
# ### # ##### ##### ####### # ####### #
# #     # # # #       #     #       # #
### ##### # ####### ##### ######### ###
#   #   # # #     # # # # #       #   #
# ### # # # ##### # # # # # # # ### # #
# #   #         # # #     # # #   # # #
### ######### ### # ##### # ### ##### #
#   #         #         #     # # #   #
##### # # ### # ### ##### ##### # #####
#     # # #     #           #   #     #
##### # # # ### ### # ######### ### ###
#     # # #   # #   # #       #       #
##### # ##### ### ### # # ######### ###
#     # #   # #     #   #     #   #   #
# ######### ### # ### ### # ##### #####
# # #           # #   #   # #   #     #
# # ####### ### # # # # ### # ####### #
#   # #     #   # # # # #   # #       #
### # ### ##### # # # ##### # # ##### #
#   #     #     # # # #   #   # #   # #
### ####### ##### ##### # ##### # ### #
#   # #   #     #   #   #       #   # #
# ### ### ### # ##### # ##### ##### # #
#   #       # #     # # #       # #   #
####### # # # # ####### # ##### # # ###
#       # #   #         #     # #     #
#######################################
