#######################################
#     #       #       #     #         #
# ### # ##### # # ##### # # ####### # #
#   #     #   # #   #   # # # #     # #
### ##### ######### # ##### # # #######
# # #   #       #   # #   #     #     #
# ### # ### # # # ### # ####### # #####
#   # # #   # #   #   #               #
# # ### # ######### ##### ### # #######
# #   #       #     # #   #   #       #
# ######### # # ##### ##### ######### #
# #       # #   #       #   #     #   #
# ##### # # ##### ### ### # # ### # # #
#   #   #   #   #   # #   # #   # # # #
### # ####### # ### # # # # ##### # ###
# #       # # #     # # # #     #     #
# ######### ####### # ##### ####### # #
#         #   #     # #     # #   # # #
# ##### # ### # ### # # ##### # ### # #
# #   # # # #   #   #   # #     #   # #
# ### # # # ##### ####### # ### # # ###
# #   # #   #     # #       #     #   #
# # # # ##### ##### # ### # ##### # # #
#   # #       #   #   #   #     # # # #
# ####### ####### ### ### ### ### ### #
# # # #   #     #     #   #     #   # #
# # # ##### ### # ##### ############# #
# # #     # #     #       #     #   # #
# # ##### # # ############### # # ### #
# #   #   # #   #     #     # #       #
# ### # # # # # # # ### ### # # # #####
#     # # # # # # #     #     # #     #
######### # # # # # ##### ##### ### # #
#     # # # # # # # #   # #   # # # # #
# # # # # ### # ##### # # # # # # #####
# # # # #     # #     # #   # # # #   #
# # ### ####### # ########### # # ### #
# #                   #       #       #
#######################################
