#######################################
#     #   #           #   #         # #
##### # ### ### # ### # # # # # ### # #
# # #     # #   # #   # # # # # #   # #
# # ##### ### ### # ##### # ##### ### #
# #   # # #   # # #         #         #
# ### # # # ### ####### ### ######### #
#   # #       # #       #   # #   #   #
# # # ####### # ######### ### # ##### #
# #   #       #   # #           #   # #
### # ######### ### ### # ### ### # ###
#   #   #           #   #   #   # #   #
### ### # ####### # ##### # ##### #####
#   # # #   # #   #       # #         #
# ### # ##### # # # ### ### # ### # # #
# #   #   #     # # # #   #     # # # #
### # ### # ### # # # ##### ### ### # #
#   #   #     # # #   #     #     # # #
# ############# # # ### # # ##### ### #
# #             # # #   # # #     #   #
# ##### ### ##### ### ####### ### ### #
#       #   # #   #   # #     #   #   #
# ######### # ##### ### # ### # ##### #
# #   #   # #   #   #       # # #     #
### ##### # # ### ### # # ### ##### # #
# #       # #   # #   # #   #   # # # #
# # ### # ### ####### # ### ### # # # #
#     # #     #       # # #   #   # # #
# ######### # ######### # ### ####### #
# #         #             #     #   # #
# # ############# # ##### # ##### # ###
# #         #   # #     # #     # #   #
# # ####### # # # ### ### # # # ### # #
# # #   # # # #   #     # # # #   # # #
### # # # # # ### ##### ##### # ### # #
#   # # # # #   #   #       # # #   # #
# ### # # ######### # # # ### # # ### #
#     # #           # # # #   #   #   #
#######################################
