#######################################
# # # # # #                 #       # #
# # # # # ### ##### # ####### ### ### #
#     # #   # #     # #       #   #   #
### ### # ### # ####### # ######### # #
#       # #   # #       #     #     # #
# ### ### # # ### ######### ### # ### #
# #       # #           # #     # #   #
####### ### ########### # # # ### # ###
# #           #       # #   #   # # # #
# ##### # ### ### ##### # ##### # # # #
#   #   #   #   # # #   # # #   # #   #
### # # # ##### # # ### ### ### ##### #
#   # # #     #   #   #       #   #   #
# # # # ############# ####### #########
# #   # #   #   #           #     #   #
##### # # # # # # ##### # ######### # #
#     #   # # # #     # # # # #     # #
# ### # ##### # ### ### ### # # # #####
# #   #   #   #       #     #   #     #
# ####### # ################### ##### #
# #     #                 #   #   #   #
### ### # # ##### # # ### # # ### # ###
#   #     #     # # # #   # # #   #   #
# # ##### # ############# # ### ##### #
# #   #   #       #   #   #   # #   # #
### # ##### ####### # ##### ### # # # #
# # # #   #   #   # #   #   #   # #   #
# # # ### # ### # # # ##### # ##### ###
# # #   #       #   #     #     #   # #
# # ### # # # # # # # ### # ######### #
# #   # # # # # # # #   #     #   #   #
# ##### # # # # # # # ### # ### # # # #
#   # # # # # # # # # #   #     #   # #
# # # ##### # ### # # ### ### ####### #
# #   #     # #   # #   #   #   #     #
# ### # ####### ### ##### # ######### #
# #           #   #     # #       #   #
#######################################
