#######################################
#     #   #     #     #   #           #
##### # ### ### ##### # ##### ####### #
#     #   # # # # #         # #   #   #
# # ##### # # ### # # # ##### # #######
# # # #     #       # #         #   # #
# ### ##### # ####### # ##### ##### # #
# # #     # #     #   # #   #     #   #
# # ### # # ####### ### # # ######### #
# #     # #     # # #     #   # # #   #
# ####### ### # # ### ### ##### # # ###
#   #         # #     #       #   #   #
# ####### ### # # ##### ### ### ##### #
#         #   #   # #     #           #
##### ######### # # # ### # ####### ###
#   # #   #     # #     # #       # # #
# ##### # # ### ########### ##### ### #
# #     #   #     #         #   #   # #
# ### ##### ### # # ##### # ### # # # #
#         #   # # # #     #   #   #   #
# ############# # # # # ##### # ##### #
# #   #   #   # # # # # #     # # #   #
# ### # # ### # ### ##### ##### # # ###
#     # #         #   #     #   # # # #
##### ### # ##### # ##### ### ### # # #
#       # # #   # # # # #   # # #   # #
# ##### # ### ### ### # ### # # ##### #
# # #   # #     # #   #     # # #     #
### ### # ##### ### # ### ### # # #####
#   # # # #   #     # # # # #   #   # #
# ### ### # # ####### # # # ####### # #
# #       # # #       # # #   #   # # #
# # ######### # ####### # # # # ### # #
#   #   #   # #         #   #   #   # #
# ##### # ### ####### # # # ### # # # #
# #     #     #       # # #   #   # # #
### ##### ####### ### ####### # ##### #
#                 #           #       #
#######################################
