#######################################
#         #   #   #   #     # #     # #
# ####### # # # # # ####### # # ### # #
#   #       #   #       #   # # # #   #
####### ##### ####### # # ### # # ### #
#   #     #   #     # #   # #   #   # #
# ### ##### ####### # ### # # ##### # #
# #       # #     #   #   #   #   #   #
# # ##### # # ### ########### # # #####
# #     # #   # # #     # #   # #     #
# ##### # ##### # # ### # ### # #######
#       #   #   #   # # #   # #   #   #
### ######### ##### # # ### # # ### ###
#   # #   #   # #   # #   #   # # # # #
# ### # ### ### ### # ### # ### # # # #
#     #         # #   #   # #   #   # #
### ######### # # ##### ### # ### ### #
#   #         # # #   # #   # #       #
# ####### ### # # # ### # # # # #######
#     #   # # # # #     # # # #       #
# ######### # # # ##### # ### ####### #
#   # #   #   #   #   #   #     #     #
# ### # ######### # ########### # #####
# #     #   # #   #   #               #
# ##### # ### ### ### ### ####### ### #
#     #   # #   #     #       # #   # #
# ##### # # # ##### ####### # # ### # #
#     # #     #     # #     # # #   # #
# ### # # # # # # # # # # ##### # ### #
# # # # # # # # # # #   #   #   #   # #
# # ####### ### ### ##### ### ####### #
# # #   # #   # # #     #       #   # #
# # # ### ### # # # # # ### ### # #####
#   # #   #   # #   # #     #   # #   #
# # # # ### ##### ### ########### # # #
# #   #     #   # # #     #     #   # #
# ##### ##### ### # ### # # ### ##### #
#                 #     #   #         #
#######################################
