#######################################
#                       #     # #     #
# # ### # # ### # ##### ### # # # ### #
# #   # # #   # # # #       # # #   # #
# ####### # # # ### # # # ### # # # ###
#       # # # #     # # #   #   # #   #
### ####### ############# # # ### # ###
#     #     #   #   #     # #     #   #
# # ### ### ### # ### # # # ##### ### #
# #   # #     # # #   # # # #   # #   #
# ### # ##### # # # ### ### # ##### ###
#   # #   #       # #   #   #     #   #
### # ### # ####### # ######### ##### #
#   #   # #     # # #               # #
### ### ### ### # # ####### ##### # # #
#     # #     # # # # #     # #   # # #
# # # ### ####### # # # ##### # ##### #
# # #   #         # #   #       # # # #
# # ####### ### # ### ##### # # # # # #
# # #     #   # # # # #     # #     # #
### # ### # # ### # ### # ########### #
#   #   # # # #   #   # # #       #   #
####### # ### # ### ### ### ### # # # #
#       #     #   #     # # #   #   # #
# ##### ##### # ### ### # ### ##### # #
# #   #     # # # #   # #     #     # #
# ### ######### # # ############# ### #
# #               #     #           # #
# # ########### ####### # ##### ##### #
# #       #     #       # #   #     # #
# # ##### ### ########### ### ##### # #
# #   #     # #     #       #       # #
##### ##### ### ##### ########### # ###
#     # # # # #       # #   # #   # # #
# ##### # # # ### ##### # # # ##### # #
#       # # #   # #     # #         # #
### ##### # ### # # ##### ##### ##### #
#         #   #   #           #       #
#######################################
