#######################################
#     #       #     #           #     #
# ### ####### # ### # # # # # # # ### #
# #   # #   # # #   # # # # # # # # # #
# ### # # ### # # ### # ### # # ### # #
# #     #       # #   # #   # #   #   #
# ##### # # ### # ####### ### ##### ###
#     # # # #   #     #   #   #     # #
# # # ### ####### ### # ####### ##### #
# # #   #     # # #   #     #   #   # #
# # ### ##### # ### ####### # ### # # #
# #   #   # #   #   #       #   # #   #
# ### ### # ### ### ##### # # ##### ###
#   #   #     # #       # #           #
### ####### # ##### ########### # ### #
#   # #   # # # # # # #         #   # #
# ### # # ### # # # # ### ##### ### # #
#     # #         #     #   #   #   # #
############# ######### ### # ##### ###
#     #         #     #     # #   #   #
# ### ######### ##### # ##### # # ### #
#   #         #       # #       #   # #
# ### ##### # ##### ### # ####### # ###
# #   #     # #   # # # # # #     # # #
# # # ####### # ### # ##### # # ##### #
# # # # #   #   # #           #       #
##### # ### ### # ####### ### ####### #
#   # #         #   #   # #   #       #
# # # ### # ### # ### # ### # # ### # #
# # #   # #   # #     #   # # # # # # #
# ####### ### # ####### # ### # # ### #
#     #   # # # #   #   #   # #   #   #
# ### ### # # # # # ### ### # # ### # #
# #   #   #   # # #   # #     # #   # #
# # ### # # ### # ##### ##### ##### # #
# # #   # # # # # #   # #     # #   # #
# # # ### # # # # # # ### # # # ##### #
# #   #   # #       #     # #       # #
#######################################
