#######################################
#     #   #         #   #   #     #   #
# ##### ####### ##### ### # ##### # # #
# # #         #   #     # #       # # #
# # # # ####### # ##### # ##### ### # #
# # # #     #   #           # #     # #
# # ##### # # ####### ##### # ####### #
#     #   #       #   #   # # #       #
##### # ### # # # ### # ### # # ##### #
#     #   # # # #   # # # # #   #     #
##### # # # ### ### ### # # # ####### #
#       # # # #   #     #   #   #     #
### # ### ### ### ############# ### ###
#   # #     # # # #           # # #   #
# # # ### # # # # # ######### ### # ###
# # #   # #   # # #         # #       #
####### # # # # # ### ##### # ####### #
# #     # # #   # #     #   #   #     #
# # ##### # ##### ### # # # ### # ### #
# #   #   #     #   # # # # # # #   # #
# ### # ####### ##### # # # # # ### ###
#     # #     #   #   # # # #     # # #
####### ##### ### # ### # # # ####### #
#     #     #       #   # # #     #   #
# # # ### ### # ##### ### # ##### # ###
# # #       # # #     #   # #   #     #
########### ##### ##### ##### ##### # #
#   # #   # #     #           #   # # #
# # # ### # ################### ### # #
# #     #     # #       #     #     # #
# # ### ##### # ##### ### ### ####### #
# # #           #   #     #   # #   # #
# # # ### ####### # ##### ##### # # # #
# # # #   # #   # #       #   #   #   #
# ##### # # # # # ####### # ### #######
# #     #     # # # #     #   #   #   #
# # ############# # # ####### ### # # #
# #               #         #       # #
#######################################
