#######################################
#     #     # #   #       #         # #
# ### # # ### # ##### ### # ######### #
# #     #   # #     #   # #           #
### ######### # ### # # ### ###########
#   # #   # # # # # # #     #     #   #
### # # ### # ### # # ########### # ###
# #     # #   #         #     #   #   #
# ##### # # ### ####### ### ### ##### #
#   #           #     #               #
### # ####### ##### ############# #####
#   # #       #             #         #
# ### # # ### # # # # ##### ### #######
#     # #   #   # # #   #   #   #     #
########### ### ##### # ### ##### ### #
#     #       #     # #   #       #   #
# ##### # # # # ##### # # ##### ### ###
# #     # # # #     # # # # #   # #   #
# # ### ### # ### # # # ### # ### ### #
#     # #   #   # # # #     # #   #   #
######### ### ### ### # ### # # ### # #
#       #   # #   # # # #   # #   # # #
### ### ### # ##### ### ### ##### ### #
# # # #   # #       #     #     #   # #
# # # # ##### ### # ########### ### ###
#     # #     #   #       #   # #     #
### ##### ####### # ##### # # # ##### #
#   #       #     # # #   # # #     # #
# ####### ### ##### # # ##### ##### # #
# #     # # # #     #         #   #   #
# # ### # # ################### # ### #
#   # #   #     # #   #       # #   # #
# # # ### # # ### # ### ##### # # ### #
# # # # #   #     #   # #   # # # #   #
### # # # ##### ### # # ### # # # # ###
#   # #       # #   # #   # # # # # # #
# ### # ### # ##### # # # # # # ### # #
#   #   #   #       #   #   # #       #
#######################################
