#######################################
# #   # #           #             #   #
# ### # # ######### # ##### ####### ###
#     # # #       # #   #   #         #
# ### # # # ### # # ### ####### ##### #
# # # # # # # # # #   #       #     # #
### # # # # # ####### ##### # ####### #
# #   # # #         #       # #       #
# # ### # ####### # ########### ##### #
# # #   # #   #   #       #     #     #
# # # ### # ##### ######### ##### ### #
# # # #             #         # #   # #
# # # ### ##### ### # ##### ### # #####
#   #     #   #   # # #   #   # # #   #
# # # ####### ### ### # # ### # # # # #
# #   #       #         # # # #   # # #
# ##### ##### ##### ####### ### ##### #
#     # #   # #   #         #   #     #
# ### # # ### ### # ######### ### # ###
#   # # # #   #     #     # # # # # # #
# ##### # # ####### ### # # ### # # # #
#       #   #     #   # # #     # #   #
### ############# # # # # ##### ### ###
#                 # # # #             #
# # ####### ##### ### ########### #####
# #     #       #   #       #   #     #
# # ### ######### ##### ##### ####### #
# #   # #     #       #     #         #
# ### # # ### ####### ##### ####### ###
# # # #   #   #     #   # #       #   #
# # # ### # ### ####### # ####### ### #
# #   #   #           #   # #   # #   #
# # ####### ##### ######### ### # # ###
# #   #     #     #   #   #   #   #   #
# ### ####### ##### ### # # # # # # ###
# #         #           #   # # #   # #
# ############# ########### ### # ### #
#             #         #     # #     #
#######################################
