#######################################
#     # # # #     #   #     #       # #
# ##### # # ##### # ### ####### ### # #
#   # #     #       #     #   #   #   #
### # ### ### ### # ##### ### ### # ###
#   #       #   # # #     # #     #   #
### ### ### # ####### ### # # ### ### #
#   # #   # # # # # #   #   #   # # # #
# ### ##### # # # # # ##### # # # # ###
# #         # # # # # # # # # # # # # #
# # ##### ### # # # # # # # ### # # # #
# #   #                   #     #   # #
# # ##### ########### ### ####### ### #
#   # # #           # #   # # # # #   #
# ### # # ### ####### ### # # # # ### #
#       #   #       # # #     # #     #
### # ### ######### ### ##### # ##### #
# # #   #       # #         # #     # #
# # # # ####### # # ##### # ### # # # #
#   # #   #   #   # #     # #   # # # #
# ### # ### ### ####### ##### ##### # #
# #   #     #         #     # # # # # #
# ####### ############### # # # # # ###
#     #     # #   # # #   # #     #   #
### ### ### # ### # # # ### # ### # ###
# #   # #   #     #   # # #   # # #   #
# ### # ### # ####### ### ### # # ### #
#   # # # #           #     #   # # # #
# # # # # ### ##### # # ########### ###
# # # #   #   #     #   # #     #     #
# # ############# ### # # # ### # #####
# # #   #         #   # #   # # # #   #
# # ### # ##### ######### # # # # # # #
# # #     #   #       #   # #   #   # #
### # ### # ######### # ### ####### # #
# #   #   #     #   #     #   #   # # #
# ### ### ##### # # ######### # # ### #
#     #         # #             #     #
#######################################
