#######################################
#   #       #   #   #         #   #   #
# # # ##### # # # # # ####### # # # # #
# # # #   #   #   # #     #     #   # #
# # # # # ######### ##### ####### ### #
# #     # #     #   #         #   #   #
##### ### ##### ########### # # ### ###
# # #   #         #   #     # #   # # #
# # ########### # # # # # ### # # # # #
#     # #     # #   # # #   # # # #   #
# ##### ### # ####### # ##### ##### ###
# #   #     # #   # # #     # #       #
# ### ####### # ### # # ### ######### #
# #   #   #     #   #   #     #       #
# ### # # ### # ### ### # ########### #
# # #   # # # #       # # # #       # #
# # ##### # ### ##### # # # # ##### # #
# #     # # #   # # #   # # #   #   # #
# # # ### # # ### # # ##### ##### # ###
#   # # #   # # #         #       #   #
# ##### ### # # # ####### ### ##### # #
#       # # # #         #   #   #   # #
# ####### # ### # # ### ############# #
#   #       #   # #   # # #       # # #
### # # ### ### # # ### # ### ### # # #
#   # # # #   # # # # # #     # #     #
### # ### ### # # ### # # ##### # #####
# #   #         # # # #   #   #       #
# ##### ### ####### # ##### # # ### ###
#         #         #       # # # # # #
# ##### # ##### ### ### ### ### # # # #
# # #   #     #   #   #   # #   # # # #
# # ### ### ### # ### ### ### ### # # #
#     #   #   # #   #   # #   #   #   #
# ### ######### ##### ### ##### ##### #
# #     #     #     #     #     #     #
# ##### # ### ### # ####### # ####### #
# #     #   #     #         #   #     #
#######################################
