#######################################
#           # #   #           #       #
### ####### # # # # ##### ### ### ### #
#   #     #   # # #   #   #   #   #   #
# ### ### ### # ##### # ### ### #######
#     #   # # # #   # # #       #     #
# ##### ### ### # ##### # ##### ##### #
#     #     # # #     # #   # # # #   #
# ### # # ### # ### ### # # # ### ### #
#   # # #         # #   # # #   # # # #
### # ########### # ##### ##### # # # #
# # #   #       # #     #     #   #   #
# ### ####### ### ### # ##### # # # # #
#   #     # #     # # # #       #   # #
# ##### ### ##### # ### ####### #######
#   #       #   # #     #     #   #   #
### # ##### # # ### ####### ### ### # #
#   # #     # #           #   #     # #
# ### # ########### ### ##### # #######
#   # #   #     #   # # #   #     #   #
### ### ##### ### ### ### ### ### # # #
#   #   # # # # #   # #   #   # #   # #
# ### ### # # # # ### # ##### # ### # #
#   # #   # # # # #             #   # #
# # # # ### # # # ##### ### ### #######
# #   #   #   # # #   #   #   # #     #
# ####### # ### # # # # ######### ### #
# #     #   #   # # #   #   #   # # # #
# # ### ### # ### ### ### # # # # # # #
# # # # # #     #         # # #   # # #
# ### # # ##### # ########### ##### # #
#     #   # # #                   # # #
### ### ### # # ######### ### ### # # #
#   # # #       # #   #     # #     # #
# # # # # ####### ### ####### # #######
# #       #         #     # # # #     #
# ### # ### ####### # ### # # ##### # #
#   # #           #     #   #       # #
#######################################
