#######################################
#         # #       #         #     # #
####### ### # ##### # ##### ##### ### #
#       # #     #     # # #           #
# ####### ########### # # # # #########
#     #     #         #     #       # #
# ### ### # # ######### ####### ##### #
# #     # # # #             #   #   # #
# # ### ### ####### ####### # ### ### #
# # # # # # #   # # #     # # #   #   #
### # # # # ### # # # ### # # # # # ###
#   # #         # # # # #   # # # # # #
# ### ### ####### # ### # ### # ### # #
# #     #     #   # #     #   # #   # #
##### ##### # # # ####### ### # ### # #
# #         #   #   #       # #     # #
# ##### ### ### ### # ####### # ### # #
#       #   #   # # # #   #       #   #
# # ######### # # # ##### # ### # # # #
# #       #   # # #   # # # # # # # # #
# ############# # # # # # # # # # # ###
#     #       #   # #   #   #   # #   #
##### # ##### ### # ####### ### ##### #
#     #     # # # # #     #   #     # #
######### # # # ### # ### # ### ### # #
#       # # #           # # #   #   # #
# ##### # ##### ### # ### # # # ### ###
#     # #     #   # # #   # # #   #   #
##### # ########### # # ### ##### # ###
#     #     #     # # #   #     # # # #
# ### ####### ### # ##### # ### # ### #
# # # #       #     #     # #   #   # #
# # # # ### ######### ##### # ##### # #
#   #   #   #   #           #     # # #
############### # ##### ####### # ### #
#   #         #       #       # # #   #
# ### ### ### ####### # # ##### ##### #
#     #     #         # #     #       #
#######################################
