#######################################
#           #   # #     #     # # #   #
# ##### ##### # # ##### # # ### # # ###
#   #   #   # #   # # # # #   #   #   #
### ####### # ### # # # # ### # ### ###
# #     # #   #         #   #       # #
# ##### # ####### ### ##### ######### #
#   #         # #   # # #     # #   # #
# ### # ##### # ##### # # ### # # # # #
#     #     # #             # #   #   #
### ##### ####### ##### ##### ### ### #
#   #     #   # # # #   #   #     # # #
####### ##### # # # ### # # ##### # # #
# #     #   #       #   # #   # # # # #
# # # ### ############# # ##### # # # #
#   #   #   #                 #   #   #
####### ### ##### ### # # # # #########
#                 #   # # # #   #     #
# ### # ##### ##### # ##### ##### #####
# # # # #     #     #   #         #   #
# # # # ########### ##### ######### # #
# # # # # # # #         #     #     # #
# # ##### # # ##### ##### # ##### ### #
#     #   # # #       #   #         # #
####### ### # # # ########### # # ### #
# #   # # #   # # #         # # #   # #
# # # # # # ### # # ##### # # # ##### #
#   # # #       #   # #   # # #   # # #
# # ### # # # ##### # # ##### ### # # #
# # #     # #     #   # #     #   #   #
# # # ##### ####### ##### ##### #######
# # #     # #     #   #   #     #     #
# ### ##### # # # # # # ######### ### #
# #       # # # #   # #       #   #   #
# # # # ### ### ##### ### ##### # # ###
#   # # # #   #   # # # # #     # #   #
# ### # # ######### # # ######### # # #
#   # #             #             # # #
#######################################
