#######################################
#     #         # #             #     #
# ### ####### # # # ######### # ##### #
#   # # #     # #     #   #   #       #
### # # ####### # ####### # ###########
#   # #   #     #   # #     #     # # #
# ####### ### ####### ##### ##### # # #
# # #   #     #       #     #         #
# # ### ##### ####### ##### # ####### #
# # # # #   #   #   #     #   #   # # #
# # # # # ##### ### ##### ##### ### # #
# # # #   #           #     # #     # #
# # # # ####### ### ####### # # ##### #
# # # #           #   #   #   # #   # #
# # # ##### ######### # ##### # # # # #
# #         #   #   #   #   #   # # # #
# ##### # ### # ### ### # # # ### ### #
# #   # #   # # # # #     #     #     #
# # ####### # ### # # # ### ### # ### #
#   #     # # #   #   #   # #     #   #
# ### ### ### # ##### ##### ##### # ###
# #     #   #       #     #     # #   #
# # ##### ### ##### ##### ### # # ### #
#   #   #     #           #   # #   # #
# ##### # # # # # ##### ### ### ### ###
# #       # # # # #       # # #   #   #
# # ### ### ### # # ### ##### ##### # #
# #   # # #   # # #   # #     #     # #
# ##### # # # ### ### # # # ### #######
# #     #   # #   #   # # # # #       #
# # ######### ######### # ### # ##### #
# #     #     #         #   # # #   # #
### # ### ############# # # # # ### # #
# # # #             #     # # #     # #
# # ####################### # ### ### #
#   #   #           #       #   # #   #
# ### # # ########### # ####### # ### #
#     #   #           #       #   #   #
#######################################
