#######################################
#     # #     #         # #       # # #
# ### # # ##### ####### # ### ### # # #
# #   # # #   #   #   #       #   # # #
# ### # # ### # ### # # ########### # #
# # # #   #   # #   # # #     #   #   #
# # ### ### ######### # # ##### ### # #
#           # #     #   # #       # # #
########### # # ### ### # ####### # ###
#           # # #       #   #         #
# ### ### # # ### ### # ### # ####### #
# #   #   # #     #   #       # # #   #
####### ### ### ######### ### # # #####
#       #         #       #           #
# ### ### ####### # ######### ####### #
# #   #     #     #     #     #     # #
# # ####### # # ############# # ##### #
# # #   #   # #     # #       #       #
# ### # # ### ### ### # ######### # # #
# #   # #   #   # #   #   #   # # # # #
# # ####### ##### # ### # # # # # #####
#   # #   # # # # #     #   # # # #   #
##### # ### # # # ### ##### # # # ### #
# #     #     # # #   #     # #     # #
# # ### ##### # ### ### # ####### # # #
#     # #   # #   #   # #   #     #   #
##### # # ####### # # ### # ### ### ###
#   # # # #   #     # # # # # #   # # #
# ##### # ### # # # # # # # # ### ### #
#           #   # # # # # # #   #     #
######### # # ##### # # ##### ####### #
#         #     #   #   #   #     #   #
##### ##### ### # ####### # ##### ### #
#   #   # #   # #       # #   #     # #
# ####### ### # ### ##### ##### ### # #
#           # #   # #     #     #   # #
# ######### # ### ### ####### ####### #
#         #     #           #         #
#######################################
