#######################################
#           # #     #           #     #
# ####### # # # # ####### ### # ##### #
# #       #   # #     #   #   # #     #
# ########### ##### # # ####### # ### #
#       #           #     #   #     # #
# ##### ### ##### # ### # # # ##### # #
# #   # #     #   # # # #   #     # # #
# ### # # ########### ### ######### # #
# # #   #   #                   #   # #
# # ####### # ####### ### # ######### #
# #     #   # # #     #   # #         #
# # # ### ### # # ############### ### #
# # #   # #   # #   #     #   # # #   #
# ### # # # ### # # # ####### # ### # #
#   # # # #   #   # # # #   #   #   # #
### ### ##### # ### # # # ##### ### ###
# # #     #   # #     #           # # #
# # # ######### ############### # # # #
# #   # #           #           #     #
# ### # # ######### # ### ########### #
#   # #   #   #   # #   # #     #     #
# # # ##### ### # # ####### ### ##### #
# # #       #   #   #     # # # #     #
# # # ### ### # ####### # # # # ### # #
# # #   # # # # # # #   #     # #   # #
# # ##### # # ### # ######### # # # # #
# #       #       #   #   #   #   # # #
# ############### ### # # # ######### #
#             # # #     # # #         #
##### ######### ######### # # ####### #
#   # #     #   # #       # #   #     #
# ### # ### # ### ### # # # ######### #
# #   #   # #   # #   # #   #   #   # #
# # ##### ##### # ##### # ### # # # # #
# # #   #     # #       # # # #   #   #
# # ### # ##### ### ##### # # ### #####
#       #           #       #   #     #
#######################################
