#######################################
#   # #       # #         #   # #     #
# # # # ### ### ####### # # # # ### # #
# # #   # #   #         # # #   #   # #
# # ##### ### # ########### # ### ### #
# #   # # # # #   #   #     # #     # #
# # # # # # # ### # ### ##### ##### # #
# # # # #   # #   #     #   #     # # #
# # # # # # # # # ### # ### ##### # ###
# # # #   # # # #   # # #   #   #     #
### ##### # # ### # ### # ### ####### #
#   #   # #     # #   #     # #     # #
# ### ####### # ##### ##### # # ##### #
# #   #       #       #         #   # #
# # ################# # ######### # ###
# #   #         #     #   #     # #   #
# ### # ### # ### ### ### ### # # ### #
# #     #   # #   #     # #   #     # #
# # ##### ### # ##### ### # ######### #
# # # #   #   #   #     # # #   #     #
# # # ##### ### ### ### # # # # # #####
#       # #   # # # #     #   # # #   #
####### # ### # # ### ### ##### # ### #
# #     #   # # #   # # #   #   #     #
# # ##### # # # # # ### # # # ####### #
#   #     # #   # #   #   #     #   # #
# ### ##### ##### # ### ####### ### # #
# # #     #   #   #     #   #     # # #
### # # # ##### ####### ### ####### # #
#   # # #   #   #     #   # # #   #   #
# # ### # # ##### # ### ### # # # ### #
# #     # # #     # #     #   # # # # #
# ##### # # # ### ### ### # # ### # ###
#   #   # #   # # # #   #   # #   #   #
### ### ##### # # # # # ### ### ##### #
# #   # #     #       # #       # #   #
# ####### # ##### ### ####### ### # ###
#         # #     #         #         #
#######################################
