#######################################
# #       #   #           #           #
# ### ##### # # ### ##### # ### ##### #
#         # # #   #     # # # # #     #
######### ### ### ### # # # # # # #####
#   #   #         #   # # #   # #     #
# ### ### # ### ####### ####### ##### #
#   #   # #   #   # #   #     # #     #
### ### # # # ##### ### # ##### ##### #
#   #     # #   #     # # #     #   # #
# ### ##### ### # ##### # ##### # # # #
#         # #   #     #   #   #   # # #
### ### # # # # # ######### # ##### ###
#     # # # # # # #       # # #   #   #
##### # ### ##### ### ### # # # # ### #
#     #   #           #     #   # #   #
# # ### # ############# # ####### # # #
# # # # #           #   #   #   # # # #
# # # # ##### ####### ##### ### # # ###
# #   # #     #     #   #   #   #   # #
# ######### ### ############# ####### #
#         #           #     #   # #   #
### ### ########### # # ### ### # ### #
# #   #       #   # # #   # # #     # #
# ### ##### ### ### # ### # # # # ### #
#     #     #   #   #     #     # #   #
# ### ######### ####### # # # ##### ###
# # #           # #   # # # #     #   #
# # # ##### ### # # # # # ####### # # #
# #     # #   # # # #   #     # # # # #
# ##### # # ##### # # ######### # ### #
# # # #   # #     # #   #       #   # #
# # # # ####### ### ##### ######### # #
# #   #     #   # #     #   #       # #
### # # # ### ### ##### # # # ####### #
#   #   #   # #       # # #   #     # #
# ### # ### # # ####### # ####### ### #
# #   #   #   #         #             #
#######################################
