#######################################
#     # #   #       #   # #   #       #
# # # # # # # ##### ### # # # # # #####
# # #     # #     #   # # # # # # #   #
### ####### ##### ##### # # # ### # ###
#   #   # #   # # #     # # #         #
# ### # # ##### # # # ### # ### #######
#   # # #   # #   # #   #   # # #     #
# # # # ### # # ### ### ##### # ##### #
# #   #       # #   #   #     # #     #
######### # ### # ### ### ##### # ### #
#       # # #     #   #       # # #   #
# ####### # ### # ##### # # ### # ### #
#   #     #   # # #     # #       # # #
# # ### ######### # ######### ### # ###
# #   #     # #   # #       #   # # # #
##### ### ### ### # # ### ### # ### # #
#     #   #   #         #   # # #     #
# ##### ### ####### ### ### # ### # ###
# #       # #       #   #   #     #   #
# # # ##### ### ##### ####### ####### #
# # # #     # # #         # # #   #   #
# # ### ##### # ### ####### # # # # ###
# #   # #   #     #   #     # # #   # #
# # # # ### # ### ##### ############# #
#   #         #   #   #               #
### ####### ####### # ########### ### #
#   #     #         # #     #   #   # #
# ####### # ######### # # ### # ### # #
# #         #       #   #   # #   # # #
# ####### ######### # # # ### ### # # #
# #       #         # # #   #   #   # #
# # # # # # # ########### # # # ##### #
# # # # #   # #   # #     # # # #     #
# ### # # # ##### # # ### ### # # #####
#   # # # #   # #   #   #   # # # #   #
# ### ##### ### # # # ### ### # # # # #
#   #   #         # # #       # #   # #
#######################################
