#######################################
#     #   #       #       #   #   #   #
# ##### # # ##### # # # ##### # # ### #
# # #   #   #   #   # # #   #   #   # #
# # # ####### # ##### # # ######### # #
# # #         #     # #   #       #   #
# # ############### ### # ####### ### #
#     #             #   #   #     # # #
### # ##### ### ##### # # # # ##### # #
#   # #       # #   # # # # # # # # # #
# # ### ##### ##### # ### ### # # # # #
# #     # #   #   #     # #   # #     #
# ####### # ##### ####### # # # ### ###
#   #     #     #       #   #         #
# ### ### ##### ### ### ##### ####### #
# #   #   #       # #         # #   # #
# ####### ### ####### ######### # # # #
# # #       #   #       #         #   #
# # # ##### # ### ####### # ### #######
# #   #   # # #   #   #   #   #   #   #
##### # # # ### ### ### ######### # # #
#   # # #         #     #     #   # # #
# # ### ######### ####### ### # ### ###
# #     # # #   # #     #   # # #     #
# ##### # # # # ### # # # ### # # ### #
# # #   #   # #     # # # #   #   # # #
# # # ##### # ##### # # ### ### ### # #
# #   #     # # #   # #         #   # #
# ##### ##### # # ############# # #####
# #         # # # #       #   # # #   #
# # # ######### # ### ### # # # # ### #
#   #   #   # # #   # # # # # # #     #
### ##### # # # ####### # ### # # #####
# #       #   #         #         #   #
# ########### ### ### ### ### # ### # #
#       #   # # #   # #   #   #     # #
# ### ### # # # ##### ####### ### ### #
#   #     #         #         #   #   #
#######################################
