#######################################
#       #       #   #           #     #
# # ##### ### # ### # ######### # ### #
# #   # # # # #     #   #   #     #   #
##### # # # # # ####### ### # ### ### #
#   # #     # # #     #     # #   # # #
# ### ####### ### ### ####### # ### # #
#     #     #       #     # # # #     #
# ### ##### ####### ##### # # ##### ###
#   # #   #     # #     #   #   # #   #
# # ### # ##### # # ##### ####### ### #
# #     #       # # # # # # #     # # #
####### ### ##### # # # # # # ##### # #
#     #   #   #     #     #   #   # # #
# ### ### ### ### ####### ### # ### # #
# #       # #   # # #   #             #
# # ##### # ##### # ### ######### #####
# #     # #       #   # #   #         #
# ####### ########### # # ##### #######
#       #               #       #     #
# ### # # ############# # ##### # # ###
# # # # # #   # # #   #   #       #   #
# # ### # ### # # # # ######### # # ###
# #   # #       #   # #         # #   #
# # # # ############# # # # ##### # # #
# # # # #   #       # # # #   #   # # #
# ### # ### # ### # # # # ##### ### # #
# #   #   #   # # #     # #       # # #
# # # ### # ### ########### ### ### # #
# # # #   # # #             # # # # # #
# # # # ### # ### ### # ##### # # # ###
#   # #   # #   # # # # # #   #   #   #
######### ### ### # # ### ### ####### #
#     #   #   #   #         #     #   #
##### # ### ############# ### # ##### #
#     # #     #       # # #   #       #
# ##### # ### ##### # # # # ####### ###
#         #         #   # #       #   #
#######################################
