#######################################
#   #       #       #     # #   #     #
# ### ##### # ### ### ### # ### # ### #
#   #     #   # #   # #   #   # # # # #
### ##### ### # ### # ##### # # # # # #
#     #   #   #             # # # #   #
# ##### ########### ### ##### # # #####
#   # # # #       #   #   #     # #   #
# # # # # # ##### # # ########### ### #
# # # #   # #       #           #     #
### # ### ### # ##### ### ##### # #####
#   # #   #   #     # #   #   #   #   #
# ### # ##### ####### ####### ####### #
#   # # # # #     #   # #     #     # #
### # ### # # ### # ### ##### ### ### #
#   #     #   #   # #   # # #         #
# ##### ########### # ### # # #########
# #     #       #     # # # #   # #   #
# # # ######### # # ### # # ### # # # #
# # #   #     # # # #   # #   # # # # #
# # # ### ### # # ### # # # # # # # # #
#   # # # #   # #   # #   # # # #   # #
# ### # # # ### ### # ### # # # ##### #
# #   # # #   #   #   # # # #       # #
# # ### # ####### ##### # # # ##### # #
# # #     #       #   # #   #   # # # #
### ##### ####### # ### ####### # # # #
#       #   #   #   #     #       # # #
# ##### # ##### # ##### # ####### ### #
#   # #   # # #     # # #       #     #
### # ### # # ##### # ##### ### # #####
#   # #   #   # #     #   # # # #     #
##### ### # ### # ### ### ### # # #####
#     #   # #     # # # # # #   #     #
# ### ### # # ### # ### # # ### # ### #
# # #     # # #     #     #     # #   #
# # ##### # ### # ### ### # ####### ###
#   #           #     #               #
#######################################
