#######################################
#   # # # #   #     #   #   #         #
# ### # # # # # # ### # ### # ####### #
#     #   # #   # #   #     # #   #   #
# # ### ######### # # ### # ### # # ###
# # #   #           #   # #     # #   #
### ### # # ### ### ##### ####### # # #
#         # #   # #   #         #   # #
### # # ### ### # ### ############### #
# # # # #     #     # #             # #
# # ### # ### # ##### # ########### # #
#   #   #   # #     # #   #   #   #   #
# # # ##### # ##### ##### # # # ##### #
# # # #   # # # #   #   # # #       # #
# ### ### # # # # ### # # # ### # ### #
# #   #   # # # # # # #   #   # #     #
### # # ##### # ### # # ##### ##### # #
#   #   # #   #     # # #     #     # #
### ### # # ####### # # ##### ####### #
#     # # #       #   #     #   #     #
##### ### ####### ######### # # # #####
#           # # #   #   # # # # #     #
# ######### # # ### # # # # ### # #####
#   #   #   # #       # # #   # # #   #
# # # # ##### ######### # ### # ### # #
# # # #   # # # #     # #     #     # #
# # # # # # # # # ########### ####### #
# #   # #     #     #         #       #
# # ### # ##### ##### ########### #####
# #   # #   #     #   #       # # # # #
# ### ########### ### ### ##### # # # #
#   #         # #   # #       # # #   #
### ##### ### # # ### # ##### # # ### #
#   #   # #   #     #   # #     #     #
# # # ### # ####### ##### # ######### #
# # #   # # #         #   #   # #   # #
# # ### # # ####### ### # ### # # # # #
# #     # #         #   #     #   #   #
#######################################
