#######################################
#           #   #       # # # #       #
### ######### ### ##### # # # # # ### #
#                   #       # # # # # #
# ##### ####### ### # ####### # # # ###
# #       #   #   # #   #   # # # #   #
####### # ### ##### ### # ### # ##### #
#   #   #       # # #   # #   # #   # #
### # # ##### # # # # ### # ### # ### #
#   # #   #   # #   #     #     #     #
### ####### # # ####### ##### ####### #
#   #   #   # # #   # #           #   #
# # # ### ##### # ### # ######### # ###
# # # #       #   # #           # #   #
# # # # # ### ##### ########### # ### #
# #   # # # #           #       #   # #
# ### # # # # ######### # ########### #
# #     #   #       #   #             #
# ##### # # # # # # # ####### # ### # #
#     # # # # # # # #   #     #   # # #
# # ##### ####### ### # # ########### #
# #   #         # # # # # #   #     # #
### ######### # # # # # ##### # # ### #
#   #   #     # #   # #     # # #   # #
# # ### # # ### ##### ### # # # ### # #
# # #   # #   #     #   # # #     #   #
##### ### ####### ### ########### ### #
#     #     #   # # # #     #   # #   #
# ##### ##### ### # # ##### # # ### # #
#   #       # #   #       #   #     # #
### # ##### # # ####### ##### # ##### #
#   #   # #   # #   # # # #   #   #   #
# ##### # # ##### # # # # ####### # ###
# #   # #   #     # # # # #     # #   #
# ### # # # # ####### ### # # ### ### #
#   #   # #   #     #   #   #   # #   #
# # # ### ### # ####### # ##### # # ###
# #   #     #           #     #   #   #
#######################################
