#######################################
#     #           #               #   #
# ### ### ##### ### ##### ####### # ###
# # #   # #   #     #         #       #
# # ### # # ############### ### ##### #
# #   # #   #   #   #       #   #   # #
# # ### # ### # # ### ####### ##### ###
#     #   #   #       #     # #   #   #
# ### ##### ########### ##### # # # ###
# # # #   #   #     #   #       #   # #
# # # # # ### ### # # # ######### ### #
#   #   #   #   # #   #   #     # #   #
########### ### ####### # # ### # # # #
#     #     #   #     # # # #       # #
# ############# # ### ### # ######### #
#         #   # #   #     #   #   #   #
# ####### ### ##### ######### ### # # #
#     #     #     # #       # #   # # #
# ##### ### ##### # ##### ### # ### # #
# #     # #       #     # #   #     # #
######### ### # ####### # # # ##### ###
#       #     #     #   #   # #     # #
# ##### ########### # ####### # ##### #
# # # #   #     #     # #   # #       #
# # # # # ##### # # ### # ####### #####
# # #   #   #     # #   # #   # #     #
# # ##### ### # # # ### # # # # ### ###
# #   # #   # # # #   # #   #         #
##### # # ##### ### ### ### ##### #####
#   # #   #       #   #         # #   #
# # # # ##### # # # # # ### ##### # # #
# # # # #     # # # # # #       #   # #
# # # # # ### # # # ### ##### ####### #
# #   # #   # # # #       # #       # #
# ##### # # ### ####### # # ##### # # #
# #       # # # #       #   # # # # # #
# ### ##### # # # ####### ### # # # ###
#     #       # # #           #   #   #
#######################################
