#######################################
# #           #         #   #     #   #
# # ######### # ####### ### # ### # # #
#   # #   #     #       #   #   #   # #
# # # # ######### ######### # ### #####
# # #     #   # #         #   #   #   #
### # # # # ### ############### ##### #
# # # # #     # #   #       #       # #
# # # # ####### # # # ##### # ##### # #
#     #       #   #   #   # #     # # #
# ### ######### ####### # ### # ##### #
#   #           #     # #     #   #   #
# ### ############# # # ########### # #
#   #   #       #   # #         #   # #
# # # # ####### # ######### # # ##### #
# # # # #       # #     # # # # #   # #
# ##### # ####### # # ### # # # # # # #
# #   #           # # #     # #   # # #
# # ### ### ######### # ######### # # #
#   # # #     #   #   #   #   # # #   #
# ### ####### # # # # ### # # # # #####
#   #     #     # # #       #   #     #
# # # ### ### # # # # ######### #######
# # #   #     # # # #       #     #   #
# ########### # # # ##### # ##### # # #
#   #       # # #   #     #     #   # #
### # ##### ##### ##### ### ### ##### #
# # #     #       #   #   # #   # #   #
# ##### ##### ##### ### # ### ### # ###
#       #           #   # #     # # # #
######### ####### ############# # # # #
#         # #       #           # # # #
# ######### # # ### # ########### ### #
# #   #     # #   # # #             # #
# # # ### ##### ### # # ########### # #
#   #   # #   #   # #   #     #   #   #
####### # ### # ### ##### ### # # ### #
#           #   #   #       #   #     #
#######################################
