#######################################
#         #       #   #         #   # #
# ####### # ##### # ### # # ##### # # #
#   #     #   #   #     # #       # # #
# # ######### # ### ### # # ####### # #
# #         # #     #   # #       # # #
# ######### # ####### # # ######### # #
#   # #     #     # # # # #     #   # #
### # # # ### ### # # # ### ####### # #
# #   # # # # #   #   # # # # #   #   #
# # ### # # ####### ### # # # # ### # #
#   #   # #     # #   #   # # # #   # #
# ##### # # ### # # # ##### # # ### ###
#     # # # #     # # #   #   #   #   #
# ##### ### ######### # ##### ### ### #
# #     #   #         # # #   # #   # #
##### # # ##### # ##### # # # # # # # #
#   # # #     # # #   #   # # # # #   #
### ### ### ### ### # # ### # # # ### #
# # #       #   #   #   #   #   # #   #
# # # ### ### # # ######### # ### # # #
# #   #       # # #     #   #     # # #
# ##### # ####### ### ### ##### # # # #
#   #   #     #         # #   # # # # #
# # # # ##### ######### # # # ##### ###
# # # # #   #   # #     #   # #       #
# ######### ##### # # ##### # ####### #
# #   #   #         #       # #       #
# # # ### ####### ##### ######### # # #
#   #   #       # # #   # #     # # # #
####### ### ### ### # # # ##### ##### #
#   #   #     #       #   # #   #     #
# ### ############# # ### # ### # # # #
#   #         #     # #   #       # # #
### ######### # ##### # ######### # ###
#       #       #     # #   #   # #   #
# ##### # ##### # ##### ### ### ### # #
#   #     #     #   #   #           # #
#######################################
