#######################################
#   #   #   #           #   # #   #   #
# ### # # ##### ### ### # ### # # ### #
#     #   #   #   # # #   #     #   # #
# ##### # ### ### # # ### ######### # #
#     # #         # # # #         #   #
### # # ### ######### # ########### # #
#   # # #       #   # #       #     # #
# ####### ##### # ### # ##### # #######
#   #   #   # #   #     # #       #   #
# # # ### ### # ##### ### # # ### ### #
# # # #   # #       # #     #   #     #
# # # # ### # ##### # # ### ### #######
# # # # #   # #     # #   #   #       #
# # # # ### # # ##### # # # # ####### #
# # #   #   # # #   # # # # # #     # #
### ### # # ### # # # ######### ### ###
# #   #   #   #   #   # # # # # #     #
# # ######### # ####### # # # ### ### #
#   #         #               #     # #
##### ########### # ########### ##### #
#   #     #   #   #       # #     # # #
# # ##### # # # # ### ### # ####### # #
# # # #   # #   #   #   #         #   #
# # # # ############### ############# #
# # # # #           # #       #   # # #
# # # # # # ### ### # ### ##### ### # #
# #     # # # # # #           #       #
# ######### # ### # ####### ##### #####
# #     #   # # #   #             #   #
# # ### # ### # # ##### # ### ### ### #
# # # # # #           # # # # #     # #
# # # # ### ######### ##### # ##### # #
#   #     # #     # # #     #   #   # #
##### ##### ### ### # # ##### # # ### #
#     #     # #   #   #   #   # # #   #
# ##### ##### # # # # ### ##### # # # #
#     #       # #   #       #   #   # #
#######################################
