#######################################
# #       #     #   # #           # # #
# # # ### # # ### # # ######### # # # #
# # # #     # #   #   #       # # # # #
# # # ####### # ##### # ##### ### # # #
# # #       #   #   # # #       #   # #
# ######### # ### # # # ### ### # # # #
#   #       #   # #   #   # #   # # # #
# # ########### ####### ### # ##### # #
# #     #     #   #   # #   # #   # # #
####### # ### ### ### ### # # # # # # #
# #   #   #   #     #     # #   #   # #
# ### ##### ### ### ### ######### # # #
#   #     #     #     #   #       #   #
# # ##### ####### ######### ### ##### #
# # #   #       #     #   # #   # #   #
# ### # ####### ### # # # ### ### # ###
#   # # # #   #   # # # # #       #   #
### ### # # ### ### # # ############# #
#   # # # #         # # #         #   #
# ### # # ### # ####### ### # ##### # #
#   #   #   # # # #       # #   #   # #
### ### ### ### # ####### ##### # #####
# #   #   #     #     #   #     # #   #
# ### ### ### # ### # # # # # ### # # #
# #       #   #   # # # #   #   #   # #
# # ####### ##### # # # ### ### ##### #
# # #   #   #   #   # # #   #         #
# # # # ####### ##### ##### # # #######
# #   #         #   #     # # #     # #
# ######### ####### ##### # ##### # # #
# #     #       # #   # #     #   #   #
# ### ### ####### ### # ### # ### ### #
# #           #         #   #   #   # #
# # ######### # # ####### ##### # ### #
#     #   #   # #       # # #   # #   #
# ##### # ### # ##### # ### ####### # #
#   #   #         #   #             # #
#######################################
