#######################################
#     # # #   #     #     #           #
##### # # # ### # # # ### ##### # #####
#     #   #     # # #   #       # #   #
# ##### ######### # ### # ####### # ###
# #   # #     #   # #   #       #     #
# # # # # ##### ### # ### ##### #######
#   # # # #   # #     #   #   # #     #
# ### # # # ### ####### ### # # ##### #
#   #     #     # #     #   # #     # #
####### # # # ### # ##### ######### # #
#   #   # # #     #     #   #   #     #
# # # # # # ########### # ### # ##### #
# #   # #       #     #       #   #   #
# ### ### ####### ######### ##### #####
#   #   #   #     #   #     #     #   #
### ##### ### ##### # ##### # ### # # #
# # # #         #   #     # # #     # #
# # # ### # ##### ####### # # # ##### #
#   #     # #     #   #   # # #     # #
# ####### # # ##### # # ### # ### # # #
#   #     #       # # # #   #   # # # #
####### ##### ### # ##### ####### ### #
# #     # #     # #   #   # #     #   #
# # # ### ####### # # # ### ####### ###
#   #   #       # # # #     #   # #   #
# # # ######### # # ######### # # ### #
# # #   # #     # #       #   # #     #
### ### # # ##### ### # ### ### ##### #
#   #       #         # #   # #       #
##### ### ####### ##### # ### #########
#     #   # #     #     #       #   # #
# ### ##### # # # ######### ### # # # #
#   #   #   # # # #   #     #   # #   #
### ### # # ##### # # # ##### ### ### #
# #   #   # #   # # #   #   #   # # # #
# ### ##### ### # ####### # ### # # # #
#     #         #         #   #     # #
#######################################
