#######################################
#   #     #         #     #   #       #
### # ### # ### ### ##### ### ####### #
#   # #   # # # # # #     #     #     #
# ### # ##### # # ####### ##### # ### #
# #   # #       #             #   # # #
# ### # # # ############### ##### # ###
#     #   #       #   #   #           #
# ############# # ### # # ########### #
#   #       #   # #   # #     #     # #
##### ####### ##### ### ### ### ##### #
#     # #   #   # # #   #       # #   #
# ##### # ##### # # # ### ####### ### #
#     # #     #   #   # #     #     # #
# ### # ##### # ### ### # # ##### # # #
# #   #       # #   #   # #       #   #
### ##### # ### ##### # # ####### #####
#   #     # # #       #       # # #   #
# ### ### ### # ##### # ### ### # # # #
# #   #   #   # #     # #       #   # #
# # ### ### ##### ##### # ########### #
#     #     #         # #     # # # # #
######### # # ### ### # ### ### # # ###
#         #   #   #   #   # #   #     #
# # ### # ##### ########### # ### ### #
# # # # #   #       #     # #   #   # #
### # ####### # ##### # ### # # ### ###
#   #   #   # #       # #     #       #
# ### # ### # # # ####### ##### ##### #
# #   #       # # #   #   #   #   #   #
# # ### ### ### ### # # ### ### # ### #
# # # #   # # #   # # #   # #   # #   #
# # # # ##### ### # # ##### # ### # # #
# # # #   #       # # # # #   #   # # #
# ### ### ### ##### # # # # ######### #
#   #   #   #       #   #       #     #
### # ####### ################### ### #
#   #                         #   #   #
#######################################
