#######################################
#       # #   #   #   #     #   # #   #
# ##### # # # # # # # # ### # # # # # #
# #   #     #   #   # #   #   # #   # #
# # ##### ##### ######### ##### # ### #
# # #     # # # #     # #   # # #   # #
# # # ### # # ##### # # ### # ##### # #
# # #   #   # #     # #   #   #     # #
### # ### ### ##### # # ##### ####### #
#     # #   #   #   # # # #   #   #   #
##### # # ##### ### ### # # ### # # ###
# #     #   # #       # #       # #   #
# # ##### ### # ####### ####### ##### #
#       # #       #   #         #     #
# ####### ##### # ### ######### ##### #
#       # #   # # #   # #       #     #
### ### ### ### # # # # ### ### # #####
#     #         # # #   #   #   #     #
# # ### ######### # ### # ### ##### # #
# # #       # # #     #   #   #     # #
### ####### # # # # ####### ##### ### #
#   #           # # # #   # #     #   #
# ##### ####### ##### ### # ### ### ###
# #     #     # #   #   # #   #   # # #
# # ##### # # # # # # # # ### ### # # #
# # #     # #   # # # # # #   #   #   #
# # # # # ##### # # # # # # ### ##### #
# # # # #     #   # # # #   #     # # #
# # # # ##### ### # # # ##### ### # # #
# # # #   #   #   # # # #   #   # # # #
####### # ##### ### # # # ####### # # #
#       # # # # #     # #   # #   # # #
# ####### # # # # ####### ### # ### # #
# #   #   #     #       #       #     #
# ### # ##### ### # ### ##### #########
# #   #     #   # # # # #   #         #
# # # # ########### # # # # # ##### # #
#   # #     #         #   #   #     # #
#######################################
