#######################################
#     #   #         #         #       #
# # # # ##### ##### # ######### # ### #
# # # # # #   #   #   #         # #   #
##### # # # ##### # ### ######### #####
# #     # #   # # # # #     #   #     #
# # # ### ### # # ### ##### # ####### #
# # #   #     #   #   #     #   #     #
# ### # ### ### # # ### # ### ### #####
#     #         # #     # #   #   #   #
# ####### # ############# ### # ### ###
# #       #   #         #     # #     #
# ########### ### ### # # ### # ### # #
# #     #   #   #   # # # #   #   # # #
# # # ### ##### ### # # # # ##### ### #
#   #   #     #   # # # # # #   # #   #
# ##### ### # ### ### # # ##### # # ###
#     # #   # #       #   #     #     #
# ### # # # ### # ### ##### # ####### #
# #   #   # #   #   #   #   # #   #   #
# # ##### # # ####### ##### # ### # ###
# #     # # # #   #       # # #   #   #
# ##### # ### # # # ##### # ### # # # #
#   #   # #   # #       #   # # #   # #
##### ### # ########### ##### ##### # #
#   # # # # # #         #   #     # # #
# # # # ##### # ### ##### # ### ### # #
# #   # # #   # # # #     #   # #   # #
# # ### # # ### # # ######### # # # ###
# # # #         # # #             #   #
# ### # # ####### # # ############### #
# #     #     # #   #         #       #
### ######### # # ########### #########
# # #   #     # # #   # #     #       #
# # # ### ##### # # ### # ##### ##### #
# # #   #   #   #   # #   #     #   # #
# # ### ### # ####### # # ### # # ### #
#       #   #           #     #   #   #
#######################################
