#######################################
#     # #   # #     # #   # #   # #   #
# ### # ### # ##### # # # # # ### # ###
# #   #     #       #   # # #       # #
# ### # # ####### ####### # # ### ### #
#   # # #   #   # #             #     #
##### ##### # ### # ### ### ### #######
#   #   # #   # #   #     #   #   #   #
# # # # # ### # ##### # # ### ##### # #
# #   # # #     #     # # # #       # #
# ##### # # # ### ##### ### ### ##### #
# #     #   #     #     #   #     #   #
# # # ### ### ### ### # ### ######### #
# # #     #     #   # #       # #     #
### ### ### ##### ##### ####### ##### #
#   # # # # #         # #       #   # #
# # # # # # # # ### # # # # ####### # #
# # # # # # # #   # # #   #   #     # #
# ### # # ### ##### # ### # ### # ### #
#   #   #   # #   # #   # # #   # #   #
### ####### # # ####### ### # ##### ###
# # # #   # #   #       # # #     # # #
# # # # # # # ### ##### # # ##### # # #
# #   # # #   # # #     #     #   #   #
# ### ### ##### # ### ##### # # # ### #
#   # # #       # #     #   #   #   # #
# ### # # ##### ### ##### ######### # #
# #     # #   #     #     #         # #
# # ##### ### ########### ##### ##### #
#   #   #   #                 # # #   #
# ### # ### ### ############# ### # ###
# #   # #   # #   # #   #   # #   # # #
# # ### ### # ##### # ### # ### # # # #
# # # #   # #   #   #   # #     #   # #
# # # ### # ### # ##### ##### ####### #
#   # #   # #   #     # #           # #
##### # ### # ##### ### # ######### # #
#       #   #                     #   #
#######################################
