#######################################
#   #   #   #   #       #   #   #   # #
# # # ### ### # # # ### # # # # # # # #
# #   # # # # #   #   # # #   #   #   #
# ##### # # # ### # # # # #############
# # #   #   #   # # # # #   #     #   #
# # # # # ### ### ######### # ### ### #
# # # #         # #   # #   # #       #
# # # ############### # # ### ####### #
#         # #   #   # # #     #       #
### # ### # # # # ### # ### ####### ###
# # # #     # #   #   # # #       #   #
# # ### ##### # ### ### # ########### #
#   # #     # # #   #     #   #       #
##### ### # # ### # # ####### # ##### #
#         #       #   #       #   #   #
# ####### # # # ####### ### ### # #####
# #   #   # # #   # #   # # #   #     #
# ### # ### ##### # ### # # ######### #
# #   #   #     # #     # #           #
# # ##### ##### # # ##### # # ##### # #
# #       #     #         # # #   # # #
# # ##### # ##### # # ####### # # ### #
# #   #   #   # # # #     #     # #   #
####### ### # # ######### ####### #####
#     #   # # #     #       #         #
# ### # # ##### ######### # ##### ### #
#   # # #               # #     # # # #
### # # ######### ##### ########### # #
#   # #     #     # #               # #
##### ##### # ##### ######### ####### #
#           #             #     #   # #
# ####### # ############# ### ### # # #
#   #     # #         #   # # #   #   #
### # ### # # ##### # # ### ### #######
# # # #   #   #   # # #   # #   #     #
# ### # ####### ##### ### # # ### ### #
#     # #             #   #       #   #
#######################################
