#######################################
#       #     # #             #       #
# ##### # # ### ############# # ##### #
#     #   #     #     #     #       # #
##### ### ##### # ### # # ########### #
#   #   # #   # #   #   # #     #     #
# ### ### # ### ### # ##### ### # ### #
#     # #     # #   #   #   #     #   #
# ##### # ##### # ### # # ######### ###
# #     # #   #     # #   #     #   # #
### ### # # # # ####### # ##### # ### #
#   #       # #   #   # #       # #   #
######### ### ### # ############### ###
#         #   #   # #             #   #
### ####### ### ### ##### ####### # # #
#         # #     # #         #   # # #
# # ### ########### # ######### ##### #
# #   #   #   # # #       #         # #
# ### ### # ### # ######### ######### #
#   #   # #     # #               #   #
# ##### ### ##### # ############# # # #
#     #   # #       #   #     #   # # #
##### # ### # ######### # # # # ##### #
# #   # #     #   #     # # # # #     #
# ### ### ##### # # ##### # # # ### # #
# #   #       # # #       # # #   # # #
# # ### ##### # ####### ### ##### # ###
# #     # #           # #   #     #   #
# # ##### # # ####### # ############# #
#   #   #   #     #     #   # #     # #
####### # # ### ######### # # ### # # #
# #     # # # #           #     # #   #
# # # ### # # ### ######### ##### ### #
# # #     #     #     # #   #       # #
# # ########### ####### # ### ### # ###
#   #   # #     #     #   #     # #   #
# ### # # # ### # ##### ##### # # ### #
#     #   #   #       #       # #   # #
#######################################
