#######################################
#     #       #   #         # # # #   #
# ##### # ### # # ######### # # # ### #
#     # # #   # #     #   # #   #   # #
##### ### ### # # # # # ### ### ### # #
#           #   # # #                 #
# ######### # # # # ####### ##### ### #
# #   #   # # # # # #   # # #   #   # #
##### # # # # # ### ### # # # ##### # #
# #     #   # # #     #     # #   # # #
# ####### # # ######### ### # # # # ###
#         # # # #   #     # #   # # # #
# ######### # # ### # ### # # ##### # #
# # #     # # #     # #   # #     #   #
# # # # ### # ### ######### # ### ### #
# # # #     #     #   # #     #   #   #
# # # ############# ### # # ### ### # #
#   #   #   #       # #   # #   # # # #
####### ### # # ##### ##### ### # ### #
# #       #   #   #           #     # #
# # ##### ####### ##### ##### ##### # #
#   #   #     # #     # #   #     # # #
# ##### # ### # ##### ### # ####### ###
# # #   # #     #   # # # #       #   #
### # ### # ### # ### # # ####### ### #
# # #   # # # # # #   #   #     #     #
# # ### # # # # # ### # ### # ### # ###
# #   #   # #   # # #   #   #     #   #
# ### # ### ##### # ### # ##### #######
#   # #   #       # #   #     # #     #
# ### ########### # # ### ### # # # # #
#               # # #   # # # # # # # #
##### ######### ### ##### # ### # ### #
#       #     #   #     # #     # # # #
### ### ### # ### ### # # # ##### # # #
#   # #   # #   # #   # # #       # # #
# ### ### # ### # # ### # # ####### # #
#   #       #   #     #   #     #     #
#######################################
