#######################################
#     # #   # #   #         #     #   #
# ### # # ### # ### ####### ### # ### #
# # # # #   # #   #   # #   #   #   # #
# # ### # ### # # ### # ### # ##### # #
#           # # #       #         #   #
### ### ##### # ####### # #############
#   #         # #       #   #   #     #
# # # ########### # ####### # # ### # #
# # # #   #       #   #   #   # #   # #
# ### # ##### ####### ### ### # # ### #
# #     # #   #   # #   #   # # # #   #
### ##### # ### # # ### ### # # # # # #
#           # # # #   #     # # # # # #
# # # ### ### # # ### # ####### # #####
# # #   #       #   #   #   #   #     #
# ### ##### # ##### ##### # ### # #####
#   # #     # #   #     # #   #   #   #
# # ### ### # # # ### ### ### ####### #
# # #   #   # # # #     #   # #     # #
# ### ######### # ##### ### ### ### # #
#   #       # # # #   #   # # # # # # #
# # ######### # # ### # # # # # # # # #
# #   #     # # # #     #   # # # # # #
# ### # ### # # # # ##### # # # # # # #
#   #   # #   # # #   # # #   # #     #
### # ### ### # # ### # # # ### # #####
#   #     #   # #     #   # #   # #   #
# # ####### ### # ### ### # # ### # # #
# #     # # #   #   #   # # # #     # #
# ##### # # ##### # ### # ### ####### #
# #     # # #   # # #   #         #   #
### ##### # # # ##### ############# ###
#   #   #   # # #     #     # #   # # #
# ### # ### ### # ##### ### # # # # # #
# #   #   #   #   #     # #   # #   # #
# # ##### ############# # ##### ##### #
#   #                   #             #
#######################################
