#######################################
#   #       #       #     #     #     #
# # # ##### # ##### # # # # ### # ### #
# # #   #     #   # # # #   # # # #   #
# # ### ######### # # # ##### # # #####
# #   #   #       # # #       # #     #
# ### # # ##### ### # ##### ### # ### #
#   # # # # #   #   # #   # #   #   # #
# ### ### # # ### ### # # # # ##### # #
#   # #     #   #   # # #   #   #   # #
### # # ##### # ### ### ####### # ### #
#   #   #   # # #   #   #     #   # # #
# ######### # # ### # ##### ##### # # #
#         #   #   # #     # #       # #
##### ### ####### ####### # # ####### #
#     #         #         # # #   #   #
# ############# # ### ##### # ### #####
# # #   #     #   #       #     #   # #
# # ### ### ### ### ##### ##### # # # #
# #   #   #   #   #   # # # #     #   #
# # ### # ### # ##### # # # ######### #
# #   # #   # #     #   # # #   #     #
# # # ### ### # ### # ### # ### ### ###
#   # #   #   # #   # # #     #   # # #
# # # # ### ########### ####### # ### #
# # #   # #       #     #       #   # #
# ####### ####### ### # # # ####### # #
#     # # # #   #     # # #   #   # # #
# ### # # # # ######### # ### # # ### #
# #   #   #   #           #     #   # #
### ### # ### # ####### ### ### ### # #
# # #   #   #   #     # #     #   #   #
# # # ##### ### # ### # ###############
#   #   #   #   # #   #         # #   #
# ### ### ### # # ### ######### # # # #
#     #       # #   #     #   # #   # #
##### ######### ### ##### # ##### ### #
#           #       #               # #
#######################################
