#######################################
#     #     #         #   #     #   # #
# ##### ### # ### # # # ### # # # # # #
# #     # #   # # # # # #   # #   #   #
# # ##### ##### # # # # # ### ####### #
# # #   #     #   # # #     # # #     #
# # ### # ### ####### # ##### # # #####
# #     # # #   #     #   #   #       #
# ####### # # ### ### ##### ######### #
#     #   # #   #   #     #         # #
##### # ### ### ### ##### # ####### ###
# # # #   #     #     # #   #     #   #
# # # ### # ######### # ##### ####### #
# # #     #     #   #       # #       #
# # ########### # # ####### # # #######
#             #   #       #   # #     #
# ##### # # ########### ####### ##### #
#   # # # # #             #       #   #
### # ### ### ########### # ##### # ###
#   #   #     #         #   #   # #   #
# ##### ########### ##### ### # # ### #
# #     # #   # #   #   #     # # #   #
### ##### # # # # ### # # ######### # #
#   # #   # # #       # # #         # #
# ### ### # ### ####### # # # ####### #
# # # #   # #     # # #   # #   #     #
# # # # ### ##### # # ##### ### #######
#     #   #   #     # # #   #         #
### ### ##### # ### # # ##### # #######
#                 #           # # #   #
# ##### # ######### ####### ### # # ###
#   #   # #         #   # # # #   #   #
### ### ####### ### # # # ### ### ### #
# #   #   #   #   #   #     # #   # # #
# ### ##### # ### ### # ##### # # # # #
#   #   # # #       # # #     # # #   #
# ##### # # ### ##### ##### ####### ###
#       #   #       #                 #
#######################################
