#######################################
#           #   #     #             # #
### # ####### # # ### # ######### ### #
#   # #       #   # #   #     # # #   #
# ##### ######### # ### # ##### ### ###
# #   #     #     #       #   #     # #
# # ##### # # ### ##### ### # ##### # #
#   #   # # # # # #   #     #     #   #
### ### # # ### # ### ### ### # # ### #
#   #   # #     #   #   # #   # #     #
# ### ######### ####### # # ### #######
# #   # #     # #     #   # #         #
# # # # ### # ### # # # ############# #
# # # #     # #   # #         #   # # #
# # # ### ##### ### ##### ### ### # # #
#   #   # #     #     #   # #   #   # #
# ### # # # # ######### # # ### # # # #
# #   #     # #         # # # #   # # #
##### ####### # ##### ### # # ##### # #
# #   # #     #   #   #   #       # # #
# # ### # # ##### # ############# # # #
#       # #     # # # #   #         # #
####### # ####### ### ### # ####### # #
#     # # # #   #     #   #   #   # # #
# ### ### # # # ####### # ### # # ### #
# # #     # # # #       #   # # #     #
# # ##### # # # # # ####### ### # #####
# #         # # # # # # # #   # # #   #
# ### ######### # ### # # # ### # # ###
# # #         #   #   #   # #   #   # #
# # ######### ##### ### ### # ### ### #
# #       #   #   #   #   # # #   #   #
### ####### ### ##### # # # # # ##### #
# #   #   # #     #   # # # # #     # #
# # # # # # # ### # ### # # # ##### # #
#   #   #   # #   #     #     # #   # #
# # ########### # # ### ### ### # ### #
# #             # # #   #       #     #
#######################################
