#######################################
#   #   #     #         #       #     #
# # # # ##### # ##### # ### ####### ###
# #   #     # # #   # #     # #   #   #
### ####### # # ### ### ##### ### ### #
#   #   #     #   # #   #     #     # #
# ### ### ####### # # ####### # ### # #
#     #       # # # #             # # #
##### # ##### # ### ##### ##### ##### #
#     #     #   # #     # # #         #
######### ##### # ### # ### # ####### #
#     #     # # #     #     # #   #   #
# ### # ### # # # ### ####### # # ### #
#   # # #   #   # # #     #     #   # #
# ### ##### # ### # # ### # ######### #
# #       # #       # #     # #       #
# # ##### ### ####### ####### ##### ###
# #     # #   #         #     #   #   #
# ##### # # ### ### # ####### # # #####
# #   # #   #   # # # #     # # # #   #
# # # ##### # ### # # ### ### # # # # #
#   #     # # #     #     # # # #   # #
# # ##### ### # # ##### ### # ####### #
# #   #   #   # #     #     #       # #
# ############# ### # ##### # ##### # #
#         #     #   #   #     #   #   #
# ####### ####### ######### ##### # ###
#   #     #     # #   #     #     # # #
### # ####### # ### # # # ##### ##### #
#   # #       # #   # # #     #       #
# ##### ####### ### ### ##### # ##### #
#     #       #   # #   #   # # #   # #
### ##### ### ### # # ### ####### # # #
# # #   # #   #   # #   #         # # #
# # # # ### ### ### ### # ##### ### # #
# #   #     # #     #   # #     #   # #
# # ######### ### ### ##### ##### ### #
#   #             #         #         #
#######################################
