#######################################
# #                   #               #
# # ########### ##### ### #############
# # # #       #   # #   #       #     #
# # # # ##### ### # ### # ##### # ### #
#   #   #     #   #   # #     #   #   #
### ### # ##### ### ### ##### ##### ###
#     # # #   #   #         #     #   #
# ### ### # # ### ######### ####### # #
# #   # #   #   #         #       # # #
# ### # ####### ######### ####### # # #
#   # # #     #     # #   #   #   # # #
# # ### ### # ##### # # ##### # ##### #
# #   # # # #       # # #     #     # #
# ### # # # ######### # # # ##### # # #
#   #     #   #       # # #       # # #
##### ### # ### ####### # ######### # #
# #   # #   #           # # #     # # #
# ### # # # ############# # # # # # # #
#   # #   #             # #   # #   # #
### # ######### ####### ####### # ### #
#   #     #     #   # # #     # #   # #
# ### ### ####### ### # # # ####### # #
# #   #         # # #   # #       #   #
# # ### ######### # ##### #############
#   #   #     #   #       #   #       #
# ### ### # ##### # ####### ### ##### #
#   #     #     # #   #     #       # #
# ### ### ##### # ### # ### ### ##### #
#   #   #     # #   # # # #   # # #   #
# ####### ### # # # # # # ####### # # #
#   #   #   # # # #   #   #       # # #
### ### ### # # # # # ### # ####### # #
#     #   # # # # # #     #   #     # #
# ####### # ### # # ### ##### # ##### #
# #     # # #   # # #   #   #   #     #
# # ### # # ### # # # ### # # ### #####
#   #     #   #   # #     #   #       #
#######################################
