#######################################
#     #   #           #       #       #
# # # # # # ##### # # ##### # ### #####
# # # # # #     # # #     # #   #     #
### ##### ##### # ##### # # ### ##### #
# #     #       #   #   #     #   #   #
# ##### ########### # ########### # # #
#     #         #   # #         #   # #
##### ######### # ### # ####### ##### #
#     #       # # #   #       #     # #
# ### # ##### # ### # ######### ### ###
# # # #   # #   #   # #       #   #   #
### # ### # ### ### ### ##### # ##### #
#   # #     # # #       # #   # #   # #
# # # # # ### # # ####### # ##### # # #
# # #   #   # #   #   #         # #   #
# ### ##### # ##### ############# ### #
# #   # #   #   #     #         # #   #
# # ### # # ### # ### # ####### # #####
#       # #       #   # #       #     #
### ######### ### ##### # ######### # #
#       #   #   #     # #   #       # #
# ####### # ### ##### # ##### # ##### #
#       # # #     #   #       #   # # #
### ##### ### ######### ### ##### # # #
# #         #   #       #   #     #   #
# # ######### ### ####### ### # ### # #
#   #       #     #     #   # #   # # #
### # # ### # ######### # # ######### #
# #   #   # # #   #     # # #       # #
# # ##### ### # ### # ### ### ### # # #
#   #     # # # #   # #   #   #   # # #
# ####### # # # # # ### ######### # # #
# # #   #   # #   # #   #       # #   #
# # # # ##### ### ####### ####### #####
#   # # #   # #   # # #       #   #   #
# # # ##### ### # # # # ##### # ##### #
# #             #   #       #         #
#######################################
