#######################################
#         #   #                   #   #
### ### ### # ############# ##### # # #
# #   # #   #     #       # #   #   # #
# # # ### ##### # # ##### # # # ##### #
# # #   #     # # # #   #     #     # #
# ### # ######### # # #################
#     # # #         #     #     #     #
####### # # # ########### # # ####### #
# #   # #   # #         # # #     #   #
# # ### ### ### ####### # # ##### # # #
# #   #         #     # # #     #   # #
# # # # # ########### # # ##### ##### #
# # #   #   #   #     # # #         # #
# ######### # # # ### ### # # ### # ###
# #   # #     # # #   #   # # #   #   #
# # ### # ##### # # ### ### # # ### ###
#       #   #   # #   #   # # #   # # #
# ### ##### ##### # # ### # ##### # # #
# #   #   #       # # #   # #     #   #
# ##### # ### ### ##### ### # ####### #
#   #   # #   #   # #       #     # # #
# ##### ### ####### ### ######### # # #
# #     #           # #   #     #   # #
# # ############### # ##### ######### #
#   # # #         #   #       #     # #
# # # # ### ### # # # # ##### # ### # #
# #       # #   #   # #   #   #   #   #
# # ##### ### ##### ### ####### #######
# # #     #   #             #     #   #
### ##### # ################# ### ### #
# #   #   #           #     # # # #   #
# ### # ####### ##### # ##### # ### ###
#     # #   #     # #         #       #
# ##### # # # ### # ######### ##### # #
#     #   # # #   #     #   # #   # # #
### # ##### # # ##### # # ### # # ### #
#   #     #   #       #     #   #     #
#######################################
