#######################################
#   #       #     #     #             #
# ### ##### # ##### # ### # ######### #
#       # # #       #     #   #   # # #
####### # # ### ### ####### ### # # # #
#     #   #   # # #   #       # # # # #
# ####### ####### ########### # # # # #
# #     #   #   # #   #   #   # #   # #
# # ### # # # # # # # ### # ### ##### #
#     # # #   # #   #   # #   # #     #
# ##### ####### # ##### # # # # # #####
# #     #     #   #   # #   # #   #   #
# # ##### ### ### # ### # ######### # #
# #   #   #   # # #     #   #   #   # #
# ### # # # # # ### ####### # ### ### #
# #   # # # # # #   #     # #   # # # #
##### # ### ### # ##### # # ### # # # #
#   #   # #       #     #     # #   # #
### ### # ##### ### # ####### # ##### #
# #   # # #     #   # #   # #     #   #
# ### ### # ### ##### # # # ##### # # #
# # #   # # # # #   # # #     # #   # #
# # # # # # # ### # # # ##### # ##### #
#   # #     #     #   # #   # # #     #
# ##### ##### ##### ### ### # # # #####
# # # # #   #   #   #   #   # #   #   #
# # # # # # ### ######### ### # ##### #
# # #   # #         #   #     # #     #
# # # # # ##### ### ### # ##### # ### #
# # # #   # #   #     # # #   #   # # #
# # # ##### ### # ##### # # # ##### # #
#   # #   #   # # #   # #   #     #   #
### # # # # ### ### # # # ####### ### #
#   # # #   # #     #     # # # #   # #
# # # # ##### ### ######### # # ##### #
# #     #     # # # #   #   # # #     #
# ########### # # # # # ### # # # #####
#             #       #       #       #
#######################################
