#######################################
# #               #     #       #     #
# # ### ######### # ### # ### # # ### #
# # #   #     #   # # #   #   # # #   #
# # # ### ### ##### # ##### ### ### # #
#   #     #   #         # #   #   # # #
# ######### ### ####### # ### ##### # #
#         #       # #     # # #     # #
################# # # ##### # # ##### #
#   # #           #     # #   #   #   #
# # # # # ### ########### # # ### # ###
# #     # # # #           # #   # #   #
# # ####### ### ########### # ### #####
# # #     # #   #         # # #   #   #
# # # ### # ### ### ### ##### # ### # #
# # # #       #       # #   # #     # #
# # # # ##### ### ### # # # # ####### #
# # # #     # #   #   # # # # #     # #
# # # ### # # # ### ### ### # # ### # #
# # #   # # # #   #   #   # # #   #   #
# ##### # # ### ##### ##### ##### ### #
# #     # #     #     # # #     # #   #
# # ############# ##### # # ### # #####
# #           # #   #   #     #   #   #
# ########### # # ### # ### ### ### # #
#   #       #   # #   #   #   #     # #
### ####### ### # ####### ### ####### #
# #       # #   # #   #   #         # #
# ####### # ### ### # # # # ####### ###
# #         #   #   # # #   #   #     #
# # ### # ##### # ####### ##### # #####
# #   # # #           # #     # # #   #
# ##### ### # ######### # # # # # # ###
# # #   #   #         #   # #   # # # #
# # # ####### ####### ##### ##### # # #
#   #         #     #   #     # #     #
# ### ####### # ### ### # ##### ##### #
#     #         #     #   #           #
#######################################
