#######################################
#                 # #       #     #   #
# # ############# # ### ### # # ##### #
# # #   #       #   #   # # # # #     #
# # # # # ##### ####### # ##### ### ###
# # # # #     # #   #     #   #       #
# ### # ##### # ### ### # # # # ##### #
#     # # #   #         #   # # #     #
# ##### # ######### # ##### # ### #####
# # #   #       #   #     # #   # #   #
# # # # ####### # ##### # # ### # # # #
# # # # #       # #     # #   #   # # #
# # # # # # ##### ##### # ### ### # ###
# #   #   #   #       # # #   # # #   #
##### ####### # ### # # ### ### # ### #
#   #     #   # #   # #   #   # #   # #
# # ####### ### # ##### # # ### # ### #
# #       #   # # #   # # #   #   #   #
# ######### # ##### ##### ######### # #
#       # # #       #   #         # # #
### ### # # ########### ##### ### # ###
# #   #   # #     #           # # #   #
# ### # ### ### # ##### # ##### # ### #
#     #   #     #       #       #     #
####### # # ############### ### #######
#       # # #   #     #   # #   #     #
# ### ### ### # # ### # # # ##### # ###
# #   #       # # # #   #     #   #   #
# ### ##### ### ### ####### # # ##### #
#   # #   # #   #         # # #     # #
### ### # ### ### ######### ####### # #
# #   # #     #     #     #       # # #
# ### # ########### # ### ####### # ###
#   # # # # #   #   # # #   #   #     #
# ### # # # # ### ### # ### # # ##### #
#   # # #         #   # # #   #   #   #
# # # # ### ### # # ### # ####### # ###
# #   #     #   #   #                 #
#######################################
