#######################################
# #       #   #         #   # #       #
# # ##### # ####### # # # # # # # #####
#   #       #     # # # # # #   #     #
# ### ##### ### # ### # # # # ####### #
#   #   # #     # #   # # # #   #   # #
####### # # ##### # ##### # ####### # #
#       #   #   #   #     #   #     # #
# ####### ### ##### # ####### # ### # #
#   #   #   #     # #   #     #   # # #
### # # ### ### # # ### # ### ### ### #
#   # #     # # #   # # # #   # #     #
# ### ### ### ##### # ### ##### # # ###
# # # #     #     # # #     #   # # # #
# # ### ### # ##### # # ### # ##### # #
# #       #       #   # #           # #
# ############### ##### ####### ### # #
# #   #         #   # #       # #     #
# ### # ####### ### # # # ##### #######
#   # # # # # # #   # # # #   #   # # #
### # # # # # # ### # ### # # ### # # #
#   #     # # # #     #   # #     # # #
# ####### # # # # ### # # ######### # #
#   # # # # # #   #   # #     #   # # #
# ### # ### # ### # # # ### # # # # # #
# # # # #   #   # # #   #   #   #   # #
# # # # # ### ### # ##### ### ####### #
# # # #           # #   #   #       # #
# # # # ####### ### # ### # ####### # #
# # #       #   #   #     # #   # #   #
### # ### ### ### ### ####### # # #####
#   # #     # # #   # #       #       #
# ### # ### # # # # # # ### ###########
#   # # # # # #   # # #   #           #
# # ### # # # ##### ##### ########### #
# #       # # #   #     #   #     #   #
# ######### # ### ### ##### ### ### # #
#     #     #   #             #     # #
#######################################
