#######################################
#     #     #     #     #     #       #
# ### ##### ##### # ### # ### ##### # #
# #     # # #     #   # #   #       # #
# ####### # # ### ### # ### # # ##### #
# #   #   # # # #   # #     # # #   # #
# # # # ### # # # # # ####### ##### # #
#   # # # #   # # #   #     #     # # #
# ### # # ### # # ##### # # ####### # #
#   #   #     #   # #   # #   #     # #
# ##### ### ####### # ### ### # #######
# #   #   #   #     #   #   #   #     #
### # # ##### # ### ### ### ##### ### #
# # #   #       #   # #   #       #   #
# # ### # ##### ##### # ########### # #
# #   #   #   #       # #     #     # #
# # ####### ############# ### ####### #
#         # #           # #           #
# ### ##### # ######### # #############
# #       # # # #   # # #   #         #
##### ### # ### ### # # # # ### #######
#       #         # # # # #   #   #   #
# # # # # ######### # # ##### # # ### #
# # # # # #   #       #     #   #     #
# ##### ### ### ##### # # ##### ### ###
#     #     # # #   #   #     #   # # #
##### ####### # # # # ####### ### ### #
# #           #   # #   #   # # #   # #
# # ##### ##### ### ### # ### # ### # #
#   #         #   #   # # #     #   # #
# ########### # ##### # # # ### # ### #
# #         #   #   # #   # # #   #   #
# # ### ########### # ##### # ####### #
#   # #     #         #   # #       # #
##### ######### ####### ### ### ### # #
# #             #       #       # # # #
# # ############# ####### ### ### # # #
#               #         #       #   #
#######################################
