#######################################
#       #         #   # #     # #     #
# ##### # ### ##### # # # ### # # ### #
# #   # #   #     # # #   #   #     # #
# # # # ######### # # ##### # ####### #
# # # #     #     # #       #     #   #
### # ### ##### ### ############# # ###
#   #     #   # #   #     #   #   #   #
# ####### # ### # # # ### # # # # ### #
# # #     #   # # # #   # # #   #     #
# # # ####### # # # ##### ######### # #
# #       #   # # #   # #       # # # #
# ######### ### ##### # ##### ### # ###
#   #     #           #   # #   #     #
### # ### # ############# # # # ### ###
# #   #   # #             # # # #     #
# ##### ### ##### # ##### # ### # #####
#     # #   #   # #   #   #   # #     #
# ##### # ### # # ### ####### # ##### #
#     # #     # #   #   #   #   #   # #
# ### # ### ##### ##### # ##### # ### #
#   # #   # #     #     # #   # # #   #
##### # ### # ### # # ### ### # # ### #
#     #     # #   # #     #   # #   # #
# ########### ##### ####### # # ### # #
#     #       #   #         # # #   # #
# ### # ######### # ######### # # ### #
# #   # # #   #   #     #       #     #
# # ### # # ### # # # # ##### # ##### #
# #   #   # #   #   # #     # #       #
# ### ### # # ### ##### ##### ### ### #
# # #   # # # # #   #   #   # #   # # #
# # ### # # ### ### # # ### # # ### # #
#     # # #         # # #     # # #   #
# ##### ### ### ##### ####### # # ### #
# #   #   # # # # #   #     # # #   # #
# ### # # # # # # ### # ### ##### # # #
#   #   #   #       # #   #       #   #
#######################################
