#######################################
#     #       #           #         # #
# # ### ##### ##### ####### # ##### # #
# # #       # #   #         #     #   #
### # ####### # # ####### ########### #
#   # #     #   #       #   #         #
# ### ##### ##### ### # ### ### # ### #
#   #   #     # # # # #     # # # #   #
### ### # ### # # # ######### ### # # #
#       # #   # # #     #   #     # # #
# ### ##### # # ### ### # # # ##### ###
#   # # #   # # # # # # # # # # #   # #
### # # # ##### # # # # # ##### # ### #
#   # #   #     #     #       # #     #
# ### # ### # ### ####### ### # ##### #
# #     #   #   # #     # #   #     # #
# ####### ### # ### ####### ### # ### #
#       #   # #   #   #     #   #     #
# ##### ##### ### ### # ######### #####
#   # # #   # # #   # # #       #   # #
### # # ### # # # ### # # ##### ### # #
#     #   #   #   #     #     # #   # #
# ####### # ### ### # ### ##### # ### #
# # #     # #   #   #   # #     #     #
# # # ##### # ### ####### # ### ### # #
# # # #     #     # #     # #   # # # #
### # # ### ####### ####### # ### ### #
#     #   #           #   # #     # # #
# ######### # ### ####### # ##### # # #
#   # # #   #   #         #   #   #   #
### # # # ######### ######### # #######
#   # #           #     #     #   #   #
# # # # ##### ### ##### # ####### # # #
# #     #   # #   #   #   #     #   # #
# ####### # ### ##### # ####### ##### #
# #       #   #   #   # #       # #   #
# # # ##### # # ### # # # ####### # ###
#   #   #   # #     # #   #           #
#######################################
