#######################################
#   #         #   #     #       #     #
### ### ####### ### ### ### # ### ### #
#   #   #         #   #     #   # # # #
# ### # ### ####### # ######### # # # #
#     #           # #     #       # # #
##### ##### ####### # # # ######### # #
#   # #   #     #   # # #     #   # # #
# ### ### # ### # ### ##### ### # # # #
#   #   # #   #   #     # #   # #   # #
### ##### # ########### # ##### # ### #
#   #     #         #       #   #   # #
# # # ##### ####### ######### # ### # #
# #   #   # # #   # #     #   # # # # #
# ### # ### # # # # ##### # ### # # # #
# # # # #   #   #   #   #   #   # #   #
# # # # # ### # ####### ##### # # #####
# # #   #   # #         #     #   #   #
# # ##### # ### # ##### ########### # #
# # #     # # # # # #   #           # #
# # # ##### # # ### ### ####### ##### #
#   #     # # #   #   #         #     #
# ####### ### # # ### ####### ##### ###
#           #   #   # #     # #   # # #
# ####### # ### ### # # ##### ### ### #
#   #     #   #   # # # #     # # #   #
### ### ### ######### # # ##### # # ###
#     #   # #         #         # #   #
####### # ### ### ############# # ### #
#       #     # #   # #   #   # # #   #
# # # # ### ### ### # # # # # ### # ###
# # # #   #   #   #   # #   #     # # #
# # ##### ### ### # ### ######### # # #
# # #     #       #   #       # # #   #
# # # ########### ### # # ##### # ### #
# # # #     #   # #     # #     #     #
# ### # # # # ### # ##### ### ####### #
#   #   # #   #   #     #     #       #
#######################################
