#######################################
#   #         #   #       #           #
# # ##### ### # # ### ##### # ### #####
# #   # #   # # #   #       # #   #   #
# ### # ### ### # ####### ### ####### #
#   # #   #   # #       # #   #     # #
### # ### ### # ####### ### ### # ### #
#   #         # #           # # #     #
# ######### ### # ########### # ##### #
# #     #     # #     #     #   #     #
# # ### # ### # ##### # ### # ### #####
# #   # # #   #     # # # # #   #   # #
# # # # # ### ##### ### # # # # ### # #
# # # # #   #   #     #   #   # #   # #
# ### ##### ##### ### ####### ##### # #
#     #         #   # #       #   #   #
# ##### ##### # # # # # # ### # # #####
# #   # #   # #   # # # #   # # # #   #
# # # # # ### ##### # ####### # # # # #
# # #   #     #     # #     #   #   # #
# # ### ####### ### # ### # # #########
# # # #   #   # #   #   # # #         #
# # # ####### ####### ##### ####### # #
# #       #   # #         #         # #
# ######### # # # ####### ######### ###
# #         # #   #     #       #     #
# # ##### ##### ### ### ##### # ##### #
# # # #   #   # #   # #     # # #     #
# # # # ### # ### ### ##### # ### #####
# # # # # # #   #   #       #   #   # #
# # # # # # ### ### # ######### ### # #
# # #     # # # #   #       # #   #   #
# # ##### # # # ### # ##### # ### # # #
# #   #   #   #   # #   # #   # # # # #
# ### # ### ##### # ### # ### # # ### #
#   # # # #   # #   #   # #   #     # #
### # # # ### # # ### ### ### # ### # #
#     #     #   # #     #       #     #
#######################################
