#######################################
# #           #           #       #   #
# # ### ####### ### ##### # # ### ### #
#     #     #   #       #   #   #   # #
# ######### # ### ##### ########### # #
# # #       #   # #       #     #   # #
# # # # ####### # # ##### # ### # ### #
# # # #   #     # # #     #   #   #   #
# # # ##### ##### ### ####### # ### # #
#   #       # # #   #   #   # # #   # #
# ####### ### # ### ####### # # # ### #
# # #   # #   #   # #       # #   #   #
### # # # # ##### # # # ### # ##### ###
#   # # # #     # # # # #   # #   # # #
# ### ######### # # ### ### # # ### # #
# #   #   # # #   #   #   # # # #     #
# # # # ### # # ##### # # ### # #######
# # # # #   #   #   # # #     #       #
# # # # # ### ### ### ##### ######### #
# # #   #   #     #   #   #       #   #
# ### ##### # # ### ### # # ##### # ###
# #   #       # #     # # #     #   # #
# # # # ### ### ##### # # ### # ##### #
# # # # #     #     # # # # # #     # #
# # ##### ######### # # # # ######### #
# # #         #   # #   #   #   #   # #
# # # ##### # # # # # ##### # # # # # #
# #       # #   # # #     # # # # #   #
# ##### ### ##### ### ##### # # # ### #
#   #   #   #     #   # #   # #   #   #
# # ##### ############# # ### # #######
# #   #   #     #             # #     #
##### ### ### # ### ########### # ### #
#   #   #     #             #   #   # #
# ### # ############# # ##### ####### #
#     #   #       #   # #   #   #     #
##### ##### ### # # ##### ##### # ### #
#           #   #         #       #   #
#######################################
