#######################################
#           # # #   #   # #   #       #
# ##### ##### # # # # # # # # # ##### #
# #   #     # #   # # #     # #   #   #
# # # ##### # ### # ######### # # ### #
#   # #   # #   # #       #   # # #   #
##### # ### ### ##### ####### ### #####
#     #     #   #     #   #   #       #
####### ##### ### ##### ### ### ##### #
#     # #             #   #   # #   # #
# ### # # ######### ##### ### ### # # #
# #     # #       #     #   #     # # #
# ####### # ############### ### ### # #
#   #   # # #             # #     # # #
# # ### # # ####### ##### # ##### ### #
# # #     # # #   # #   # #       #   #
# # ##### # # # # # ### # # ##### # ###
# # #       #   #     #   # # #   #   #
### # # ############# ##### # # ##### #
#   # #                       #       #
# ### ### ##### ############# # #######
#       # #           #       # #     #
# # ############# # ### # ##### # ### #
# #       #   #   # #   # # #   # # # #
### # ### ### # # ##### ### # ### # # #
#   # # #     # #   # #     # #   #   #
# ### # ########### # ### ### ### # ###
# #   #   #         #     #   #   #   #
# ####### ####### # # ##### ### #######
#       #     #   # # #   #           #
### ### ##### # # # # # ##### # ##### #
# # # # #   #   # # # #     # #   # # #
# # # ### # ### # # ### # ### ##### ###
# # #     #   # # #   # #     #       #
# ### # ### ##### ##### ############# #
#   # # #   #     # #   #       #     #
# # # # ########### # ### ##### # ### #
# #   #                   #       #   #
#######################################
