#######################################
#       #       #         #   #     # #
# ### ######### # # # ##### # # ### # #
# #         #     # # #   # # # #     #
# # ### # ### ##### ### # # ### ### ###
# # # # # #   # # # #   # #     #   # #
# # # # ### ### # # # ### ##### # ### #
# # # #   #   # #   # # # #   # # #   #
# # # ### ### # ### # # # ### # # # ###
# # # #       #   # #   #   #   # #   #
# # # # ######### ##### ### # ### ### #
# # # # #       # #   # # #   #   #   #
# ### # # ####### # # # # ##### ### # #
# #   # #           # # # #     #   # #
##### # ############# # # # ### # # # #
#     #         #   #     #   # # # # #
# ######### ### # # ######### # # # # #
# #       # #     # #         # # # # #
# # ##### ### ####### ########### ### #
#   #     #   #           # #   # #   #
# ### ### # ### # ### # ### # # ### ###
#   #   # #     #   # # #   # #       #
### ### ########### # ### ### ##### # #
#   #         #   # #           #   # #
# ### ##### # # ### ##### ### ####### #
#   #   # # #   #       # #     #     #
# ##### # # ### # ####### ##### # #####
# #     # # #   # #         #   # #   #
# # ##### # ##### # ######### ### # # #
# #   #   # #   # #       #   #     # #
##### ### # # # # ####### ##### # ### #
#   #   # #   #   #     #   #   # #   #
# # ### # # ####### # ##### # ### # ###
# #   # # #     #   # #     # #   #   #
# ##### # # ######### # ##### # # #####
#   #     # #           #   # # # #   #
# # ####### # ########### # # ##### # #
# #         #             # #       # #
#######################################
