#######################################
#                     #       #       #
# # ################### # ### ####### #
# #   #     #           # # #   #   # #
# ### # ### # ########### # ### # # # #
# # #   #   # #   #     # #   # # #   #
# # ##### ### # # # ### # # ### # ### #
#     #   #   # # #   #   #       #   #
##### # ### ### # ### #################
#     #   #   # #   #                 #
# ####### ### ##### # ######### ##### #
#   #   #           # #   # # # #   # #
### # # ########### # # # # # # # # # #
#   # #   #   #     # # # # # # # #   #
# ### ### # ######### # # # # ### ### #
#     # # # #   #     # # #     # #   #
####### # # # # # ### # # ##### # #####
#     #   #   # #   #   #       #     #
# ### ####### # ####### ############# #
#   #         #       # #       #   # #
### ############### ### ##### # # # # #
#     #   # # #   #   #       #   # # #
# ##### # # # # ##### # ####### ##### #
# #     # # #   #     #   #     #     #
# # ##### # # # # # ### # # ##### #####
# # #       # # # #     # #     #     #
# # ####### # # # ####### ##### ##### #
# # #   #   # # # #   # # # #       # #
# ### # # ### # # # ### # # ####### # #
# #   #     # # # #   # #   #   #   # #
##### ### # # ### ### # ##### ####### #
#   #   # #   #       # #   #         #
# ########### ### ##### # ### #########
#   #     #   #   #     # #         # #
### # ### # # # ### ##### ######### # #
#   # #     # #     #     #       # # #
# # ### ### # # ### # ##### ####### # #
# #     #   #     #         #         #
#######################################
