#######################################
#           #   #       #     #   #   #
# ######### # ####### # # # ### # ### #
#   #     #   #       # # #     #   # #
# # # ### ##### ####### # ### ##### # #
# # # # #       #     # #   #     #   #
# # # # ### ### # ### # # # ### # ### #
# # # #     # #     # # # # #   #   # #
### # # ##### ####### ### ### ### # # #
#   # # #     #   #   #   #   # # # # #
# ### # # ##### # # ### ### ### # # # #
#     # #   #   # #       # #   # # # #
####### ### # ### ######### # # # # # #
#     # #   #   #     #   # # #   # # #
# ### # # ##### # ### # # # # ####### #
#   # #   #     # # #   #   #       # #
##### ### # ##### # ### # # ##### ### #
#   #     #   #     #   # # #   # #   #
# # # ####### ####### ### # # # # # ###
# # #       # #         # #   # # #   #
# # ### ##### ########### ########### #
# # # # #         #   # # #     #     #
# # # ### ######### ### # # # ### # ###
# #         #     #   # #   # #   #   #
# ##### ##### ### # # # ####### ##### #
# #   # #   # #     #   #     #   # # #
# ### ### # # ########### ### ### # # #
#   #   # # #     #   #   #   #   # # #
### ### # # ### # # # # ### ### ### # #
# #   #   #   # #   #   #     #   #   #
# ### ####### ########### ### ##### ###
#     #     # #     #     #       # # #
# ######### # # ##### # ### ####### # #
# #     #   #     #   # # #       #   #
# # ### # # ### # # ### # # ##### ### #
#   #     # #   #     #   # #     #   #
############# ########### # # ####### #
#                 #       # #         #
#######################################
