#######################################
#             #   # # #   # # #   #   #
# ##### ##### # # # # # # # # # ### # #
# #     #     # # #   # #   #   #   # #
### ##### ##### # # ### ##### ### ### #
#   #   #     # # # #   #     #   #   #
# ##### ### ### # # ### # ##### ### ###
#     #     #   # # #   #       #     #
# ### ####### ### # # ########### #####
#   # # #   #   #   #     #     # #   #
##### # # # ### ### # ### # ### # ### #
#     #   #   # #   #   #   #   #     #
# # ####### ### ########### # ### ### #
# # #                       #     #   #
# ### ################### ########### #
#   # # #       #       # # #     #   #
# # ### ####### # ##### # # # ### # # #
# #   #       #   #     # #   #   # # #
# ### # ##### ##### ############# ### #
# #   # #   #   #     #       #     # #
# # ### # # ### # ### # ##### ##### # #
# #   # # #   # #   # #   # #         #
### # # # ### # ### ##### # ### #######
#   # #     # # # #   #   #   # #     #
# ### ####### # # ### # ### # # ##### #
#   #         # #   # #   # # # #   # #
### ##### ##### ### # ### # # ### # # #
#   #   # #   #   # #   # # # #   #   #
# ##### # ### ### # ### # # ### ### # #
# #   #   #     # # # #   #     #   # #
# # ####### ##### # # # # ### # # ### #
# #       #       # # # #   # # # #   #
# ####### # ####### # ### # ### # # ###
#       #       #   #   # #     # #   #
# ##### ### ##### ##### # # ##### ### #
# #   #   # #   #     #   # #   # #   #
# # # ### ##### # ########### # # # ###
#   #   #                     #   #   #
#######################################
