#######################################
# # #           #       #       #     #
# # ### ####### ##### ### ##### # ### #
# # # #       # #   #     #   # #   # #
# # # ####### ### # ### ### ### # # # #
# # #         #   # # #     #   # # # #
# # ######### # ### # ##### # ##### ###
# # #       #   # # #     # # #   #   #
# # # ##### ##### # ##### ### # # # # #
#     #   #             #   # # # # # #
##### # # ############# # # # # # ### #
# #   # #             # # # #   # #   #
# # ### ############# # # # ### # # ###
# #   # #     #   #   #   #   # # #   #
# # ### # ### ### ##### ##### # # ### #
# # #   # # #     #     #   # # #   # #
# # # ### # # ####### ### # # ### # # #
#     #   # # #   # # # # # #   # #   #
# ##### ### # ### # ### # # ### # #####
#   #   #       # # #   # #   # # #   #
### ### ######### # # # # # ### # # # #
#     #   #     # #   # # #   # # # # #
# # # ### # ### # ### # ##### # # ### #
# # #     #   #   #   #   #   #       #
# # # ##### # ##### ##### # ###########
# # # #   # # #     #     #   #   #   #
# ####### ### # ####### ### # # # ### #
#     #   #         # #     # # # #   #
##### # ### ####### # ##### # # ### # #
#       #   #     #     # # #   #   # #
####### # ### ########### ####### # ###
#         #     #       #   #     #   #
# ### ### # ### # ##### ### # # ##### #
#   # # #   #         # #   # # #   # #
# ### # ### # ######### # ##### # ### #
# # #   #   #   #     # #     # #     #
# # ### ##### # # ### # ### # # ##### #
#   #       # #   #   #     #   #     #
#######################################
