#######################################
# #               #             #   # #
# # ### ######### # ######### # # # # #
# #   #     #     #   #     # #   #   #
# ### ##### # ##### ### ### # ####### #
#   #   #   # #   # #   #     #       #
### # ### ##### # # # ########### #####
# #   # #     # #   #           #   # #
# ##### ##### # ############### ### # #
#     #     #   #             # # #   #
##### # ### # ##### ########### # ### #
#     #   #   #   #         #   #     #
# ####### ##### # ####### ### ### ### #
#     #         #     #   # #   # # # #
# ### ### ############# ### # # ### # #
#   #   # #   #         #     #   # # #
# ##### ### # # ############# ### # ###
# #     #   # #   #         # #   #   #
# # ####### # # # ### # ##### # ##### #
# #   #     #   #   # #   #   # #   # #
# ### # ### ########### # ### # # # # #
# # # # #   # #         # #   #   #   #
# # # ### ### # ######### # ####### # #
#   #   #     #       # # #     #   # #
# ##### # ### ####### # # ##### # ### #
# # # #     #       #   #   #   # #   #
### # ### ######### # # ### # #########
#   #   #   #   #   # # # #   #       #
# ### ##### ### # # # ### ##### #######
# #   # #   #     # # #         #     #
# # ### # ### ##### # # # ########### #
#       # #   # #   # # #   #         #
# ##### ### ### # ### ##### # ### #####
#   # # # # #     #   #     # #       #
# # # ### # ####### ### ##### ##### ###
# #   #   #     #               #   # #
# ### # # ### # # ######### # ####### #
#   #   #     #       #     #         #
#######################################
