#######################################
#   #       #         #           #   #
# # # ##### ### # ### # ######### # # #
# #       #     #   #   #   #       # #
# ####### # ######### ### # # #########
#   #     # #   #   #     # #     #   #
### ### ### ### ### ### ######### # ###
# #   # #       # #   #       # #     #
# ##### ##### # # ### ####### # ### # #
#     #   #   #     #   #       #   # #
# ################# ### ######### #####
# #           #     # # #   #   # #   #
# # ######### # ##### # # # # # # # ###
#   #     # #   #     #   #   # # # # #
# ### # # # ####### ##### ##### # # # #
#   # # #           # #     #   #   # #
# # # # ##### ##### # # ##### # # ### #
# # # # #     #   # # # #     #       #
# ##### # ##### # ### ### ### ### # ###
# #   # #     # #       # # #   # # # #
# # # # ##### # ####### ### ##### ### #
#   # # #   # # #     #     #     # # #
##### # # # # # # # ####### # ##### # #
#     #   # # # # #           #     # #
# ####### # # # ##### # # ### # ##### #
# #     # # # #   # # # # #           #
# ### ### # ##### # ### # ### #########
# #   #   #       #   # # # #         #
# # ################# ### # # # ### # #
# # # #         #         #   # #   # #
# # # # ####### ################# # # #
# # # #   #   #           #   #   # # #
# # # ##### ######### ##### # # # ### #
# #         #       # #     #   #   # #
# # ####### # ##### # # ########### # #
#   #   #   #   # #   #   # #   #   # #
##### # # ##### # # ##### # # # # # ###
#     #       #   #       #   #   #   #
#######################################
