#######################################
#         #     #             #       #
# ### ### # ##### ######### ### ##### #
# #     # #     #   #     #   # #     #
# # ### # ### # # # # ### ##### #######
# #   # #     #   #   #   #     #   # #
# ### ##### ########### ### ### # # # #
#   #     #   #     # # #     #   #   #
####### ### # # ### # # ### # # ##### #
# # #   # # #   #     #     # # #   # #
# # ##### # ##### ### ####### # # # ###
#     # # #   # #   #   #   # # # #   #
# ##### # # # # ### # ### # # # # ### #
# #       # # # #   #   # #   # #   # #
# # ##### # # # # # ### # # # ##### # #
# #   #   # # #   #   # # # # #     # #
# ### # ##### ########### # # # ##### #
#     #       #       #   # #   #   # #
# # ########### ### # # ### ##### ### #
# # #       #   # # # # #   #   #     #
# # # # ##### ### # ### # ### # # ### #
# #   #     #     #     # #   # #   # #
# ### ######### # ######### ### ### ###
# # #   #       #         # #     #   #
# # ### ### ############# # ######### #
#     # # # #   #       #   #     # # #
# # # # # # # # # # ### ##### ### # # #
# # # #   # # # # # # # #     # # # # #
# # # # ##### # ### # # # ##### # # ###
# # # #     # # #   #   #     #   #   #
### # ### # ### # ########### # ##### #
#   #   # #     # #       #   # #   # #
# ##### # ####### # ##### # ### # # # #
# # #   #   # # #   # # #   #   # #   #
# # # ### ### # ### # # ##### ### ### #
#   # #   #   #     # #     #   # #   #
##### ##### ####### # # # ##### # # ###
#                     # #         #   #
#######################################
