#######################################
#     # #           #     #         # #
# ### # # ##### ### ### # # # # ### # #
#   #   # #   #   #   # #   # #   # # #
# # ##### ### ### ### ####### ### # # #
# #   # # #   # # #   #     # # # #   #
# ### # # # ### # # ####### # # # ### #
#   # # # # #     #   #     #   #   # #
##### # # # ######### # ##### ####### #
#       # # #         #           #   #
# ####### # # ##### # ####### ### ### #
#   #   # #   #     #   #       #   # #
# # # ### ##### ####### ####### ### # #
# # #   #   # #     # #   #     # # # #
### ### # # # ##### # ### # ### # # ###
#       # #   #         #   #   # #   #
# ####### ### ######### ##### ### ### #
#         #   #     #   #         # # #
########### ### ### ##### ######### ###
#     #     #     #     #     #     # #
# ### # ######### ##### ##### # ### # #
# #   # #     #   # #     #       #   #
# # ### ##### # ### # ### # ######### #
# #   # #   #       #   # #       #   #
##### ### ############### ##### ### ###
#   #         #     #           #   # #
# ####### # # # ### # ##### # ### ### #
#       # # # #   #   #     # #     # #
# ##### ### ##### ####### ### # ### # #
#   # # #   #     #         # # # #   #
### # # # ######### ##### ##### # ### #
# # # # #       #   #   #   #   #     #
# # # # ##### ####### # ### # #########
#     #               #     #       # #
############# ############### ##### # #
#     #     #     #     #   #     #   #
### # # # # ####### ### # # ##### #####
#   #   # #         #     #           #
#######################################
