#######################################
#                     #     #   #     #
# ##### ########### # # ### # ##### # #
# #   # #           # # #   #     # # #
### # ### ########### # # ##### ### # #
#   #     #     #   #   #           # #
# ########### # # # ######### #########
#     #       #   # # # #   # #   #   #
# ### # # ######### # # ### # ### # # #
# #   # #       #     #   #       # # #
### ########### ##### ### ##### ### # #
#   #         #     # # # # #   #   # #
# ########### # ### # # # # ##### #####
#           # #   # #   #   # #   #   #
# ######### # ##### ##### ### # ### # #
#   #       #   #           # #   # # #
### # # ####### # ### ##### # ### # # #
# # # #   # #   # #     #   #   # # # #
# ### # ### # # # ##### # # ### # # # #
#     # #   # # #   #   # #     #   # #
# ##### ### # ##### # # # ########### #
# #   #   # #     # # # # #     #     #
### ### # # ### ### ### ### ######### #
#       #     #     #   #   #       # #
# ################### ### ### ### # # #
#   # #   #         # #   #   #   #   #
### # ### # ##### ### # ### ### ##### #
#   #   #   #   # #     #     # #   # #
### ### ##### ### # ##### ##### # # ###
# #   #     #     # #   # #   # # #   #
# ### ##### # ##### # # ### # # # # # #
# #   #   # #       # #     # #   # # #
# # ### # # # ####### ####### # ##### #
# #     #   #         #       # #     #
# # ### ####### ######### ####### ### #
# #   #           #     #   #   # #   #
# ### ########### # # # ### # # # # # #
#             #     # # #     #   # # #
#######################################
