#######################################
#   #     #               #           #
# ### # ### ####### # ### # ### ##### #
# # # #     # #     # # #     #     # #
# # # # ##### # ##### # # ######### ###
# #   #   #   # #   # #         # # # #
# ### ### # # # # ### ##### # ### # # #
#     #   # # # # #   #     #   #   # #
######### # ##### # ### ### ### # ### #
#         #       #   # # #   # # #   #
# # ####### ### ### # ### ### ### ### #
# # #   #   # #     # #     #   #   # #
# # ### ##### ### ### # ### ### ### # #
# #     #   #     #   #   #     #   # #
# # ### # ### ##### # ### # # ##### # #
# #   # # #   #     # # # # #     #   #
# ### ### ##### ####### ### # ### #####
# # #     #     # #         # #   #   #
# # ####### ##### # ####### # # # # # #
#   #     #   #     #   # # # # #   # #
### # ### ### # ##### # # ### ####### #
#   # #     # # #   # # #       # #   #
# ##### ##### # # # # # ####### # # ###
#     #   #   #   # # #           # # #
##### ### # ####### ######### # ##### #
#   # #   # # #   #   #       # #     #
# # # # ### # # ##### ####### ####### #
# # # #     # #     # # #   # #       #
# # # ####### ##### # # ### # ### ### #
# # #   #   #     # # #       #   # # #
# ##### # # # ##### # # # ##### ### # #
#     # # # # #     # # #     # #   # #
### # # # # # # ##### # ####### # ### #
#   # #   #   # #     #   #     # #   #
# ##### ##### # ### ### ### ##### # ###
# #     #   # #   #   # #   #       # #
# # ##### # ### # ### ### ### ####### #
#         #     #   #     #           #
#######################################
