#######################################
# #   # #       #       #   #   #     #
# # # # ### ### ### # ### ### # # ### #
#   # #   # #   #   # #   #   # # # # #
# # # ### # ##### ### ### ##### # # # #
# # #   #           #   # # # #     # #
# # ### ########### ##### # # ####### #
# #   #   #   #       #   # #       # #
# ### ### ### # ### ### ### # ##### # #
# #     #   #   #   # #   # #     #   #
# ######### ##### # # ### # ### # ### #
#         #       #         #   #   # #
# ####### ############### ##### ### # #
# #     #   #       #   # #   #   # # #
# # # ##### ##### # # # # # ##### # ###
#   #   # #   #   # # # #   #     #   #
# ####### # ### ### ### # ### ### ### #
#   #     # #     #       #     # #   #
# ### ### ### ######### # ##### ### # #
# #     # #   #     #   #   #   #   # #
# ##### ### ### # ### ### # ##### #####
# #   #     #   #   # #   #     #   # #
# # # ############# ### ####### # # # #
# # #   #     #   #   #     # #   #   #
# # ### # ##### # ### # ### # # ### ###
#   #     #     # #   # # # # # #   # #
### # ### # ##### # ##### # # # # ### #
#   #   # # #     #         # # # #   #
####### ### # # ######### ### ### # # #
#     #   # # #       #   #     # # # #
# # ##### # ######### # ### ### ##### #
# #     # #     # #     #     #       #
# ##### # ##### # # ### # ##### ##### #
# #   #   #   # # #   # # #   # #   # #
# # # ##### ### # ### # # # # # # # # #
# # #   #       #   # # # # #   # # # #
# ### ### ####### ### # ### ##### # # #
#     #           #   #     #     #   #
#######################################
