#######################################
#   #   #       #     #   #           #
# # ### # ### # ##### # # # ##### ### #
# #     # # # #     #   # #     #   # #
# ####### # # # ######### ##### ### # #
#         #   # #       #   #   # # # #
##### ####### ### ##### # ### ### # ###
#   #   #     #   #   # # #   #       #
# # ##### ##### ### ### # # # #########
# #       #   # #   #   #   # #       #
# ####### # # # # ### ##### # # ##### #
# #   #     # # #   #       #       # #
# # # ####### # # # ####### ######### #
# # #       # # # #       #       #   #
# # ##### ##### ### ### ######### #####
#   #   #   #       # # #       #     #
### # # ### ######### # ##### ####### #
# #   # #   #       #     #     #     #
# ####### ### ############# # ### ### #
#       #   #               #     #   #
# ##### ### ######### ############# ###
# #   #     #     #     #       #     #
# # ### ##### # # # ### # #############
# #     #   # # #   #   #             #
# ####### # # # ##### ####### ####### #
#   #     # # #     # #       #       #
### # # ### # ##### # ##### ###########
#   # #   #   #   # #     #     #     #
# ### ### ####### # # ####### ### ### #
# #   # #       # # #   #   #     #   #
# # ### ####### # # ##### # ######### #
#   #       # # # #       # #       # #
##### # ### # # # # ### ##### ##### # #
#     # # #   #   # #   #     # #   # #
# ##### # # ####### # ### ### # # ### #
#   #   #   #       # #   #   #   #   #
### # ####### # ####### ### ### ##### #
#   #         #         #     #       #
#######################################
