#######################################
#           #           #   #       # #
# ######### # ######### ### # ##### # #
#     #     #   #     #   #   #       #
# ##### ####### ### # ### # ### #######
# #   #   #   # #   #   # #   #       #
# # ##### # # ### ####### ### ### ### #
# #   #     #           #   #   #   # #
# # # # ####### ####### # # ### ### # #
#   # #       #   #   #   #   #   # # #
##### # ####### # ### ####### ### # ###
#     #   #     #   #   #   #   # #   #
# ######### ####### # ### # ### ##### #
# #         #   #   # #   # # #   #   #
### ####### ### ### # # ### # ### # ###
# # #   # #     #   # #   #   # # # # #
# # # # # ####### ### ### ##### # # # #
# #   # #     # #   #   #             #
# ##### ### # # ### # ############### #
#     #     #     # #     #   #   #   #
# ### ####### ##### ##### # # # # # ###
#   #       # #     #   # # #   # #   #
##### # ##### ####### # # # # # # # # #
#     # #         #   # #   # # #   # #
# ####### ####### ##### ####### #######
# #     #     #   #   #       # #     #
# # ### ####### ### ######### # # ### #
#   # #     #     #         #     # # #
# ### ##### # ### ### ### # ####### ###
#   #   #   #   #     #   # #   #     #
### # ### # ### ####### ### # # ##### #
# # #   # # #   #     #   # # #   #   #
# # ### # ### ### # # ### # # ### # # #
# # #   # #   #   # # #   #   # #   # #
# # # # # # ####### # # ####### ##### #
#   # # #       #   # #       #   #   #
# ### ######### # ########### # # # ###
#     #         #             # #     #
#######################################
