#######################################
# #         #     #   #     #   #     #
# # ##### # ### # # # # ### # ##### ###
# # #     #   # # # #   #   # #       #
# # # ####### # ### ##### ### # ##### #
#   #     #     #   #   #   #   #   # #
######### ### ### ### # ### ##### # # #
#         # # #   #   #   # #     #   #
# ######### ### ### ### ### # #########
#             # # #   # #     #   #   #
# ######### # # # ##### # ####### ### #
#   #     # #   # #   # #   #     #   #
######### # # ### # # # ### # # ### # #
#           #     # # #     # # #   # #
# # ####### # ### # # ######### # # ###
# #       # # #   # #   #       # #   #
# ##### ### ### # # ### # # ######### #
#   #     # # # #   #   # # #         #
# ### # # # # ####### ### # ### ##### #
#   # # # # # #     # #   # #   #   # #
# # ### # # # # ### # ##### ### # # # #
# #   # # # #     # # #   #   # # #   #
# ### # ### ####### # # # ### # ### ###
# #   #   #     #   #   # #   #   # # #
# ##### # ##### # ####### # ##### # # #
#     # # # #   #     #   # # #   #   #
##### ### # # ####### # ### # # ##### #
#   # # # #   # #   # # #   # #   #   #
### # # # ##### # # # # # ### ### #####
#   #   # #   #   # #   #       #     #
# ### ### # ### ######### ### ####### #
# #     #   #           # #         # #
# ##### ##### ######### # ######### # #
#       #     #     #   # #         # #
# ##### # ######### # ### # ######### #
# #   # #   #     #   #   # #   #   # #
# ### # # # ##### ### # ### # # # # # #
#     #   #         #   #     #   #   #
#######################################
