#######################################
#   #       # #               #       #
# # ### ### # # ######### ### # # ### #
# #     # # # #   #       # # # # # # #
# ####### ### ##### ##### # # # # # # #
#   #         #   # #     #   # # #   #
# # # ######### # # ##### # ##### ### #
# #     #     # #   #   # #     #   # #
# ##### ### # # ### # # ####### # # # #
#   #     # #   # # # #   # #   # # # #
# ### ### # ##### # # ### # # ##### ###
# #   #   #     #   #   # # #     #   #
# # ### ####### # ##### ### ##### ### #
# # #     #   # #     # #       #     #
### # ##### # # ####### # ### ####### #
#   #   #   # #       # #   #       # #
# # ##### ##### # ##### ####### ### # #
# #           # #             #   # # #
# ### ### # # # ############# # ### # #
#   #   # # # #   # #       # # #   # #
# ######### # ### # # ##### # ### ### #
#   #     # # #   # #   # # # #   #   #
### ### # # ### ### ### # # # # ### ###
# #     # #     #     #   #   #   # # #
# ### ########### ### ### ####### # # #
#     # #     # # #   #     #     #   #
# # ### # ### # # # ### # # # ####### #
# #   #   # #     # #   # #       # # #
# ### # # # ####### # # ########### # #
#   # # # #       # # #     #     #   #
# ### # # ### ##### # ####### ### #####
# #   # #   # #   #   #     # # #     #
# # ####### # # # # ##### ### # ##### #
# # #   #     # # #           #     # #
### # ### ##### # ############# ### # #
#   # #   #     # # #   #   # # # # # #
# ### ##### ##### # # # # # # ### # # #
#               #     #   #       #   #
#######################################
