#######################################
#           # #       #         #     #
####### ### # # # ### # # ##### ### # #
#       #   #   #   # # # # #       # #
# # ### # ######### # # ### # ### #####
# # #   # #   #     # # #   # # # #   #
### # ### # # # ####### # ### # # # # #
# # # # # # #     #     # #   #   # # #
# # ### # # ####### # ### ### ##### # #
# # # #     #   #   # #   # #     # # #
# # # # ### # # ### # # ### ##### ### #
#   #     #   #   # # #   #     #     #
# ############### # # ### ##### #######
# #       #   # # # #           #     #
# ### ### # # # # ########### # ### # #
#   #   #   # # #           # #     # #
### # # ### ### ####### ### ### ##### #
#   # # #   #   #     #   # #   #     #
# ### # # ##### # ####### ### ### #####
#     # # #   # # #   # # # # # #     #
######### ### # # # # # # # # # ##### #
#             # # # #   #   # #     # #
# ############# # # ### # ### # ### # #
#       #     #   #   # #   # # #   # #
### ### # ### # # ### # ##### ### ### #
# #   #     # # #   # #     #   #     #
# ### ##### # ##### # ### ##### # #####
#   # #   # #       # # #     # # #   #
# # # # ######### ##### ##### # ### # #
# # # # #       #   #       # #     # #
### # # # # ### ### # # # ### ####### #
#   # #   #   # # # # # # #         # #
# ### ##### # # # # ### # # ##### # # #
#     #   # # #   # #   # #     # #   #
# ### # ##### ### # # ### ### # #######
#   #   #   #   # #   #     # # #     #
### ### # # ### ##### ####### # ### # #
#     #   #   #               #     # #
#######################################
