#######################################
#   #         #         #     #       #
# ### # ##### ####### # # ### # # #####
#     # #   #   #   # #     #   #     #
# ### ### ### # # # ######### ####### #
# #   #       #   #         #   #     #
### ### ### ############### ##### #####
#   #   #   #     #       #   #   #   #
######### ### ### # ### ##### # ### # #
#   #     #     # #   #       #     # #
# ### # ### ### # ### ############### #
# # # #     #   #   #   #             #
# # # ####### ##### ### ##### #########
#   #   #       #   #         #       #
# ### # # ### ##### ############# ### #
#     # # # #     # #     # #       # #
# # ##### # ##### # # ##### # ####### #
# # #     #     # #   #     # #   #   #
# ####### ### # # ######### # # ### ###
# #     #   # # # #   #       #     # #
# ##### ### # # # # # # ####### ##### #
# #   #   # # # # # # #   #   #   #   #
# # # # ##### # # # # ### ### ### # ###
# # # #       # #   # #         # # # #
# # # ####### ### # # # ####### # # # #
# # # #   # #     # # #     #   # # # #
# # ### # # ####### ####### # ### # # #
#       # #       #       # # #   #   #
######### # ### ####### ### ####### ###
#       # #   #       #   #   #       #
# # ##### ########### ### ### ####### #
# # #   #   #   #       #   #         #
# ### # ### # # # ######### # ####### #
# #   #   #   # #       #   # #       #
# # ##### ### # # ##### # ##### ##### #
# #     # #   # # # #     #   # #   # #
# ##### # ##### # # # ##### # # # # # #
#       #       #   #       #     # # #
#######################################
