#######################################
#     #   #     #     #             # #
# ### # # # ### # # # ##### ####### # #
#   #   #     #   # #     # #   #     #
### ### # # ############### # # # ### #
#   #   # #       #     #     # #   # #
# ### ########### # ##### ######### # #
# # # #       #   #       # #       # #
### # ### # ### ### ####### # #########
#   # #   # #     #     #   # #       #
# ### # # ### ### ##### ### # # ##### #
#       # #   # #   # # #   # #   # # #
# ######### ### ### # # # # # ### # # #
#   #       #   #   # #   # #   #   # #
# ### ##### # # ##### ##### ### # ### #
# #   #   #   #     #     #   #   #   #
### ### # # ### ### ### ##### ##### # #
#       # #   #   #   #     #   #   # #
# ### ### ########### # ### ### # ### #
# # # # # #     #   # #   #     # #   #
# # ### ### ### # # # ########### # # #
#   #   #   # #   # #   #     #   # # #
####### # # # ### # ### # ### ##### ###
#       # # #     #     # #       #   #
### ##### # ########### # ####### ### #
#   #     # #   #     # #     #   #   #
# ### ##### # # # # ### ##### # # # # #
#   #   #     # # #     # #   # #   # #
# # ### ######### # ### # # ### #######
# #   #     #     #   # # #   #       #
# ### ##### # ####### ### ### ####### #
#   #       # #           # #   #     #
### ######### # ########### ### #######
#   #   #     # #     #     #         #
# ### # # ####### ### ### # # ####### #
#   # # #   #     # #   # #   #     # #
### # # ### # ##### ### ####### ### # #
#   # #       #                 #     #
#######################################
