#######################################
# #   #         #   #                 #
# # # # ####### # # ####### ####### ###
# # #   #   # #   # #     # #     #   #
# # ##### # # ##### # ### ### ### ### #
#         # #           #   #   #     #
### ####### # ######### ### ### ##### #
# # #   #   # #     #   #   #   #   # #
# ##### # ### # ### ##### ### ##### # #
#       # #   # # #     #     #     # #
# ##### # ##### # ##### ######### ### #
# #     #         #   #   #     # #   #
# ### ##### ####### # ### # ### # # ###
#   #     #     #   #   #     # #   # #
### ##### ############# ####### # ### #
# #     #   #         #   #   # # #   #
# ### ####### # ##### ### # # # # # ###
#   # # #     #     #     # #   # #   #
# ### # # ############# ### ##### ### #
#   #   #   #   #   # #     # #   #   #
### # ##### # # # # # ####### # ### ###
# #       #   #   # # #   #   # #     #
# # ### # ######### # # # # # ### ### #
#   # # #         # #   #   #   #   # #
##### # ##### ##### # ### ### # ##### #
#     # #   #       # # #   # #     # #
# ### ##### # ######### ##### ##### # #
#   #       #     #   #   #   #   #   #
##### ########### # # # # ### # # ### #
#     #     #     # # # #   #   # #   #
# ##### ### ### ### # ### ##### # ### #
# #   # # #     #   #   #   #   #   # #
# # # # # ######### ### ### # ##### # #
#   #   #     #   #   #     #     # # #
####### ##### # # ### ##### # ##### ###
#       #     # #   # #     # #   #   #
# ####### # ### ### # # ####### # ### #
#         #       #   #         #     #
#######################################
