#######################################
#       #       #       #       #   # #
# ##### ### ### # ### ### ### # # # # #
#   #     # # #   #   #   #   #   #   #
### # ### # # # ####### ### # #########
#   # # #   #   #     #   # # #   #   #
# ### # ######### ### ##### ### # # # #
# #   #         #   #       #   #   # #
# ### # ####### # # ######### ####### #
#   # # #   #   # #         # # #     #
# # ### # # # ### ########### # # #####
# # #     # #   #   #       #   # #   #
### # ######### ### # ##### # ### # ###
#   # #           # #     # # #   #   #
# # # # ##### ##### ##### # # # ##### #
# # # #   #   #   #       #   #       #
# ### ### ##### # ################### #
#       # #     #   #           #     #
# ####### # ####### # ######### # #####
# #       # #   #   # #     # #   #   #
# # ##### # # # # ### ### # # # ### # #
# #     # # # # # #   #   #   # #   # #
# ##### ### # # # # ### # ######### ###
# #   #       # # #     # #   #     # #
# ### ########### # ##### # # # ### # #
#   #   #         # #   # # # # #   # #
### # # # ####### # # # ### # # ##### #
# # # # #       # # # #     #   #   # #
# # # # ####### ### # ######### # ### #
# # # # #     #   #   #   #   #   #   #
# # # # # # ### # ####### # ##### ### #
#   # #   # #   #     # # #       # # #
# ### ##### # # ##### # # ####### # # #
#   # #     # # #   #   #           # #
### # ### ### ### # ##### ####### ### #
# #   # # # #     #   #   #     #     #
# ### # ### ### ##### ##### ### ### # #
#     #             #       #       # #
#######################################
