#######################################
# #       #           #               #
# # ##### # ##### ### ######### ##### #
# #   # # # #   #   #         # # #   #
# ### # # # # # ### ######### # # # ###
#   #   # #   #   #       #     #   # #
# ### ### ########### ### ##### ##### #
# #   #               # #   #   #   # #
# # ### ############### ### ### # # # #
# # #   #   #             #   # # #   #
# # # ### # # ############### ### #####
#   # #   # #     #       #       #   #
##### # ### ##### # ##### ######### # #
# # #     #       # # #       #     # #
# # ##### ######### # # ##### # ##### #
#     # #   #   #   # #     # # #   # #
# ##### ### ### # ### ##### # ### # # #
#     #   #     #   #       #     # # #
# ### # ####### ### ############### # #
# #   #     #   #   #     #     #     #
# # ##### # # ### # # ### # # ### #####
# #     # #   #   #   #   # #   # #   #
##### ### # ### # # ### ### ### # # # #
#   #     #     # # # # # # # # #   # #
# # ############# ### # # # # # ##### #
# #     #   #   #     # #     #       #
# ##### # # # # # ### # # ######### ###
# #     # #   #   #   # # # #   # #   #
# # ### # ######### ####### # # # # ###
# # #   # #         #       # # #     #
# # ##### ### ##### # # ##### # # #####
# # #   #   # #   # # # #   # # #     #
# # # # # # ### # ### # # # # # ##### #
# #   # # # #   # #   # # #   # #     #
# ##### # # # ### # ##### ##### # #####
# # #   # #     # #   #   #   #   #   #
# # # ########### ### # ##### ##### # #
#   #               #               # #
#######################################
