#######################################
#       #       #   #         #       #
# # ##### ##### # # ### ##### ### ### #
# # #   # #   #   #   # #         # # #
### # # # ### ####### # # ######### # #
#     # #   #         # # #         # #
# ##### # # ########### # ### ####### #
#     # # # #   #       #   # #       #
##### # # # # # ### ####### # # #######
#   # #   #   # #   #     #   #   #   #
### # ### # ### # ### # ######### ### #
#   #   # # #     #   #       #       #
# ### ##### ######### ### ####### #####
#     #   #         #   #       # #   #
####### # ##### ### ### ####### ### # #
# #   # #       #   # #   #     #   # #
# # # # ######### ### # ### ##### ### #
# # #   # #       #     #   #     #   #
# # ##### # ########### # ### ##### ###
# # #     # # # #     # #         #   #
# ####### # # # ### # ############### #
#         #   #   # #                 #
# ####### ### # # # ############# #####
#     # # # #   #           #   #     #
# ### # # # ############### # ### ### #
# # # #   #     #   #   #   #     #   #
# # # # ##### # ### # # ### # ##### ###
#   # # #     #   # # #     #   #   # #
# ### # ### ####### # ####### # # ### #
# #   #     #     # #     # # # # #   #
### # ####### ### # ####### # ### # # #
#   # #   #   # # #     #     # # # # #
# ##### # # ### # ### ### ##### # ### #
#     # # #     #     #   #   # #   # #
# ### # # ##### # ### # ### # # ### # #
# # # # #     # # #   # #   #   #   # #
# # # # ##### # # # ### ### ### # ### #
#   #       #   # #         #   #     #
#######################################
