#######################################
# #       #     #   #     #   #   #   #
# # # ### ### # # # ### # # # # # ### #
# # #   #   # # # #     #   # # #   # #
# # # ##### # # # ########### # ### # #
#   # #     # #   #     #     # #   # #
# ### # ##### ##### # ### ##### ### # #
#   # #       #     # # #   # #   #   #
### # ### ##### ### ### ### # # # #####
# # #   #   #   #   #   # # #   # #   #
# # ### ### ##### # # ### # # ### # # #
#   #   # # #     # #   #   #   #   # #
# ### ### # # ####### # # ##### ##### #
#   # #   #   #     # # # #     #     #
### ### # # ### ##### # # ### ### ### #
#   #   # #     #   # # #   # #   #   #
# ### ### # ##### # ### ##### # ##### #
# #   # # #   #   # #   #   # # #   # #
# ### # ##### # ### # ##### # # # # # #
#     #   # #   # #   #     # #   # # #
####### # # ### # # ##### ### ##### # #
#       #   # #   #     #     #     # #
# # # ####### # ####### # ##### ##### #
# # #   #     # # # #   #   #   #   # #
### # # # # # ### # # ### ### ### # # #
#   # # # # #     # #   # #   #   # # #
# ### # # # ### ### ### ### # ##### ###
# #   #   #   # #   #     # #     #   #
# ####### ### # # ### ### # ##### ### #
# #     # # # # # #   #   #     # #   #
# # ### ### # ### ### # ####### ### # #
# #   #     # #       #       #   # # #
# ### ####### # ##### # ####### # # # #
#   #   # #   #     # #       # # # # #
### ### # # ####### ##### ### ### # # #
#   #   # #     #       # # #   #   # #
# ### # # ### # # ##### ### ### # ### #
#     # #     #       #     #     #   #
#######################################
