#######################################
#     #       #     #   #     #     # #
### ### # ##### ### # ### ### # ### # #
#   #   #   #   #   #       # # # #   #
# ### ##### # ### # ######### # # ### #
# #   #     #   # # #       #   # #   #
# # ##### # ### # ### ##### # ### # # #
# # #   # # #   # #   # #   #     # # #
# # # # # # # ### # ### # ####### # ###
# #   # # #   # #   #   # #     # #   #
# ##### ####### # ##### # ### # ##### #
#     #   #     # #     #     #     # #
# ####### ### # # # # ##### ##### # # #
#         #   # # # #     # #   # #   #
# ######### ##### ##### ### # # # #####
# #         #   #   #   #   # #   #   #
# # # ####### # ### # # # ### ##### # #
# # #   #     #   # # #   #   #     # #
####### # ##### ### ##### # ##### ### #
#     #     #   #   # #   #     #   # #
# ### ####### ### ### ### ##### ### # #
# # # #       #   #   # #   #       # #
# # # # ####### ### ### ### ######### #
# #     #   #   #   #   #       #     #
# ####### # # ### ### ### ##### #######
#         # # #   # #       #   #     #
########### # # ### # ##### # ### ### #
#         # #   #   # # # # #       # #
# ####### # ##### # # # # ########### #
#   #   #   # #   # # # #     #       #
# # # # ##### # ### # # ##### # ##### #
# # # #     #   # # #   #   # #   #   #
# # # # ### # ### # ### # # # # # # ###
# # # # #   #     #     # #   # # #   #
# # # ### ### ### ##### # # ### # ### #
# # #   # #   # # #   # # # #   # #   #
# # ### # # ### ### # # # ### ### # ###
# #     #   #       #   #     #   #   #
#######################################
