#######################################
#               #         #       #   #
# # ########### # ####### ### # # # ###
# # #     #     #   #       # # # #   #
### # ### ### ### # ####### ### # ### #
#   #   #   #   # # #   #       #     #
# # ### ### ### # # # # # #############
# # #   # # #   # #   # #   #     #   #
# ### ### # ### ####### ##### ### # # #
# #   #   #   #         #       #   # #
# # ### # ### ##### ##### ########### #
# #     #   # # #   #     #           #
# ##### ##### # # ### ##### ######### #
#     # #     #     # #   # #         #
# # ### # ########### # # # ###########
# # #   #         #   # # #       #   #
# # # ########### # ### # ####### # # #
# # #   #     #   #     #       #   # #
# ##### # ### ### # # ######### ### # #
#     #   # # #   # #   #   #   #   # #
# ### ##### # # ### ### # # # ####### #
# # # # # #   #   # #   # #   #   #   #
# # # # # # ##### # # ### ##### ### # #
#   #     #   #   # # # # #     #   # #
### ##### ### # ### # # # # ##### ### #
# # # #   #   #   # # #     #     # # #
# # # # ### ##### # # ####### ##### # #
# #   #   #   # #   #   #   #       # #
# ### ### ### # ####### # # ######### #
#       #   # # #       # # #       # #
######### ### # # ####### ### ##### # #
#   #     #     # #     #     #   # # #
# # # ##### ### # ### # ##### # # # # #
# #   #     #   #     # #   #   # #   #
# ##### ############### # ####### # ###
# #     #   #     #   # # #     # # # #
# # ##### # ### # # # # # # ##### # # #
#         #     #   # #   #       #   #
#######################################
