#######################################
#           # #       #     #       # #
# ########### # ### ### ### ### ### # #
#         #     # #     #       # #   #
# ####### ### ### # ############# ### #
# #     #   #     # #         #       #
# ### # ### ####### # # ### ####### ###
#     #   #   #   #   #   #   #   #   #
####### ##### # # ########### # # #####
#     # #   #   # #   #     #   #   # #
# ### # # ### ### # # # ### # ####### #
# #   # #   # #   # # # # # #     #   #
# # ### ### # # ### ### # # ##### # ###
# #   #   #   #     #   #     #   #   #
# # ##### # ####### # ##### ### ##### #
# # #     # # #   # # #   # #   #     #
# ### ##### # # # ### # # ### ### ### #
# #   #     # # #   #   # #     # #   #
# # ### ### # # ### ##### # ### # # ###
# # # #   #   #   #     # #   # # # # #
# # # # ##### ### ##### # ### ### # # #
#     # #   # # #   # # #   #   # #   #
### ### # # # # # # # # # ### # # #####
# # #   # #     # # #     #   # #     #
# ### ### ##### # # ##### # ### ##### #
#       # # #   # #   # # # # #   #   #
######### # # ##### # # # # # ### # ###
#         # # #   # # # # # # #   #   #
####### ### # # # ### # # # # # ##### #
#     #     #   #       # # #   #   # #
# ### ### ### ############# # ##### # #
#   #   #   #               #       # #
### # ################# ### # ####### #
# # #     #         #   #   # #     # #
# # ##### # ### ##### # # ##### ### # #
# #   #   #   #       # #       # # # #
# ### # ##### # ####### ######### ### #
#     #       #     #                 #
#######################################
