#######################################
# #         #       #             #   #
# ##### ### # ##### # ### ######### # #
#     # #   #   #   #   #     #     # #
# # ### # ##### # ######### # # ##### #
# # #   #       # #   #   # #       # #
# # # ############# # # # ########### #
# # #     #         # # #       #   # #
### # ### # ######### # ####### # # # #
#   # #   #   #       #   #   # # # # #
# ##### # ### ##### ##### ### # # ### #
#   #   #   # #   #     # #   #   #   #
### # ##### # # # ##### # # ####### # #
#   #   #   #   # #   #   #       # # #
# ### # # ####### ### ########### # # #
# #   # # #   #   #     #       #   # #
# ##### # # # # ### ##### ##### # ### #
#     # # # # #   # #     #   # #   # #
# ### # ### # ### # # ##### # # ##### #
# # # # #   #     #   #     # #     # #
# # # # # ########### ### ### ### # # #
# # # #     #     #   #   #   #   # # #
# # # ##### # ### ### # ####### ### # #
#   # #   #     #   #   # #     #     #
### # # ########### ##### # ######### #
#   #         #   # #     #     #   # #
####### ##### # # # # ### ##### # # # #
#         #     #   #   # #   #   # # #
# ####### # ######### # # # # ##### # #
#       # #   # # #   # # # # #   # # #
####### # # ### # # ### # # # # # # # #
#     # # # #   #     # # # #   # # # #
# ##### # ### ######### ### ##### # ###
# #     #           #     #     # #   #
# # ####### # ##### # ######### # ### #
# # #   #   # #   #   #         #   # #
# ### ### ##### # ######### ####### # #
#               #           #         #
#######################################
