#######################################
# #         #         #     #         #
# # ####### # ##### # # ### # # #######
#   #     #   #     # #   # # #       #
# ### ### # ### ##### # # # # ####### #
# #   #   #   #   # # # # # # #   #   #
# # ### ######### # # ### # ### # # ###
# #   #       #   # #     #     # #   #
# ### ##### # # ### ############# ### #
#   # #   # #   #           #   #   # #
# ### ### # # ######### ##### # ### # #
# # #     # # #       #       #   #   #
# # ####### ### # ### # ######### ### #
# #   #       # #   # #         # #   #
##### # ### ### ################# # ###
#     # # # # # #   #       #     #   #
# ##### # ### # # # # ##### # ### ### #
#     #       #   #     #   # # # #   #
# ### # # ############### ### # # # ###
# # #   # #   #   #   #     # #   #   #
# # ####### # # # # # # ### # ####### #
#   #     # # # #   #   # # #       # #
### # ### # # ##### ### # # ##### # # #
# #     # # # #   # #   # #   #   # # #
# ##### # # # # # ### ### ##### ### # #
#   #   #   # # #   # #         #   # #
# # # ####### # ### # ##### ##### ### #
# # #     #   #   # #     # #   # #   #
# ####### # ##### # ##### # ### # # ###
#     #   #   #   #       #     # # # #
##### # ##### # ############# ### # # #
#     # #   #   #           # #   # # #
# ### ### # ##### ####### ### # # # # #
# # #   # # #     #     #   # # # #   #
# # ##### ### ####### # ### # # # ### #
#         #   #       # # #   # #   # #
# ######### ### ####### # ##### ##### #
#               #             #       #
#######################################
