#######################################
#   # #       # #       #       #     #
# # # # ### # # # ### ### ##### # ### #
# #     #   # # # # #         #     # #
######### ### # # # ############### # #
#       #   #   #   #           #   # #
# ### ##### ####### # ######### ##### #
# # #       # #     # #       #       #
# # ######### # ##### # ##### #########
#     #     #   #     #     #     #   #
##### # ### # ### ######### ##### # # #
#   # # #   #   #         #     #   # #
# # # # # ### ##### ### ####### ##### #
# # #   #   # #   #   #       #   #   #
# ######### ### # ### ### ####### # ###
# #     #   #   # #     #     #   #   #
# # ### # ### ### ########### # ##### #
# #   #   # #   #           #     #   #
# # # ##### ### ########### ##### # # #
# # #   #     #   #       #   #   # # #
# ##### ##### ### ### # ##### # ### # #
# #     #       # #   # #     #   # # #
# # ##### ####### # ### ### ####### ###
#   #   # #       # #     # #     #   #
# ### # # # ####### ##### # # ### # # #
# #   #     #   #     #   #   # # # # #
# # ######### # # ### ######### # ### #
# #           # # #   #   #       #   #
# # ######### # ### # # # # ####### # #
# #     #   # # #   # # #   #   #   # #
# ####### # ### # ##### ##### # # #####
#   #     #   # #   #   #     # #     #
### # ####### # ### # ####### # ##### #
# #   #     # #   #   #       # #     #
# ######### # ### # ### ### ##### #####
# #         # #   #     #   #   #     #
# # ### ##### # ######### ### # ##### #
#     #         #             #       #
#######################################
