#######################################
#                   #       #         #
# ##### ############# # ##### ### #####
#     # #         #   # #     #   #   #
####### # ####### # ### # ##### ### # #
#       #     # #   # # #     #   # # #
# ########### # ##### # # ####### ### #
# #       #   # #   # #   #         # #
# # ##### ##### # # # ##### ### ##### #
#   #   #       # # #       # # #   # #
##### # ### # ##### ##### ### ### # # #
#   # #   # #     #           #   # # #
# # # ### # ### ######### ##### ### # #
# #   #   #   #       #   #       #   #
# ##### ############# # ######### #####
# #   # #         #     # # #     #   #
# # # # # ####### # # ### # # ##### ###
# # # #   # #     # # #           #   #
# # # ##### # ### # ####### ##### ### #
#   # #     #   # #   #   #   #     # #
########### ### ##### # # ### ####### #
#           #   #     # #   # #       #
# # ####### # ### ##### ### # # ### ###
# # #   #   #     #     # #   # # #   #
### # ### ####### # ### # # ### # ### #
#   #           # #   #   # #   # #   #
# # ##### ####### ### # ### # ### # ###
# # #   # #     #     # # #   #   # # #
# ### # ### ### ### ### # ##### # # # #
# #   #     #   #   #   #   #   #   # #
# # ######### # # # # ### # # # ##### #
# #   #     # # # # #   # # # # # #   #
# ### # ### # # ####### # ### # # # # #
#   # #   # # #   #   # # #   # #   # #
### # ##### # ### # # # # # # # ##### #
#   #     # #   # # #   # # # #       #
# ####### # ### ### ##### # # ####### #
#             #         #   # #       #
#######################################
