#######################################
#   #   #           #       #       # #
# # # # # ######### ### # ### ##### # #
# #   #   #     #       # #   #   # # #
# ######### ### ######### # ### # # # #
#             #   #   #   #   # # # # #
# ############### # # ### ### # ##### #
#       #         # #   #   # #       #
##### ### ######### ### ### # ### ### #
#   # #   #         #   #   #   #   # #
# # # # ### ### ####### ### ### ### ###
# # # #   # #   #     #   #   #   #   #
# # ##### # ##### ### ### ####### # # #
# #       #   #   #   #       #   # # #
# ####### ### # ##### ####### # ##### #
# #     #   # #     #       #   #     #
# # ### ### # ##### ### # ######### # #
#   #   #   # #   # # # #     #     # #
##### ####### # # # # ####### # ##### #
#     # #     # #   #       # # #   # #
# ##### # ### # ####### ### # # # ### #
# #     # #   #   #   # #   # # #     #
# ### ### # ##### # # # # ### # # #####
# #       #     #   # # #     # # #   #
# # ######### ####### ##### ### ### # #
# # #       #       #   # # #       # #
# # ##### # ####### ### # # ######### #
# #       #       #   # # #   #       #
# ##### ######### ### # # ### # ##### #
#           #     #   # #   # #   #   #
# ########### ### # # # ### # # # #####
#     #       #   # # #     # # #     #
##### # ####### ### ####### # ####### #
#     # #   #     # #     # # #       #
# ##### # # # ##### # # ### # # ##### #
# # # #   # # # #   # # #   #   #   # #
# # # ####### # # ### # # ####### # # #
#   #         #       #   #       #   #
#######################################
