#######################################
# #   #         #   #         # #     #
# # # # ### ##### # # ### ### # # # # #
#   #   #   #   # #   #   #   # # # # #
# ####### ### # # ####### # ### # # # #
#   # #   #   # # #   #   #   # # # # #
### # # ### ### # ### ####### # # # ###
# #   # #   #   # # # #     # #   #   #
# ### # # ### # # # # # ### # ### ### #
#     #   #   #     # # #   #   # #   #
######### # # ####### # # ##### # # ###
#       # # # #   #     #       # # # #
# ##### # # ### # ####### ######### # #
# # #   # #     #   #   #     #   #   #
# # # ############# # # ##### # # # # #
# #   #     #   #   # #     #   #   # #
# # ### # ### # # # # ##### ######### #
# #     # #   # # # #     #   #       #
# ####### # ### # # ### ### # ##### ###
# #   #   #   # # #     #   #     #   #
# # ### ##### # ##### ### ####### ### #
# # #   # #   #   # #   # # #   # # # #
# # # ### # ##### # # ### # # # # # # #
# # # #   #   # # #   #   #   # # # # #
# # # ### ### # # # ### ### # ### # ###
# #   #     # # # #   #   # # #   #   #
# ### # ##### # # ####### # # ### ### #
#   #   #       #   #     # #   #     #
### ### # ######### # ##### ### ### # #
# # #   # #   #   # #     #   #     # #
# # ##### # # # # # ##### ##### # ### #
# #       # # # #   #     #     # # # #
# ### ##### # # ### # ##### ##### # ###
#     #     # # # # # #   # # #   #   #
# ####### ### # # # # # ##### # ### # #
# #     # #   # #   #   #     #   # # #
# # ### # # ### ####### # ####### # # #
#   #     #   #         #           # #
#######################################
