#######################################
#                     #     #     #   #
# ### ############### # ### # ### # # #
# # # #     #   #     # # #   # # # # #
# # # # ##### # # ##### # ##### # # # #
#   # #       #   #     #       # # # #
##### # ############# ##### # ### ### #
#   # #           #   #   # #         #
# # # ########### # ### # ########### #
# # #     #     # # #   #       #   # #
# # ##### ### # # # # ######### # # # #
# #     #   # #   # #     #       # # #
# ##### ### ####### ##### ######### ###
# #     #   #   #       #     #   #   #
# ### ### ### # ####### ##### # ##### #
#   #         #       #       # #     #
### ################# ####### # # #####
# # #     #   #   #   # #     # #     #
# # ### ### # # ### # # # ##### ##### #
# #         #   #   # #           #   #
# ########### ### # # ##### ##### # ###
#   #         #   # #       #     #   #
# # # ######### ### ######### ####### #
# # # #     # # #       #   #   #   # #
# ### # ### # # ####### # # ### ### # #
#   #   # #   #       # # #   #     # #
### ##### # ######### # # ### ####### #
#   #     # #   #   # #   #   #   #   #
# ##### ### ### # # # ##### ### ### ###
#     # #   #     # # #   # #   # # # #
##### # # ### ### ### # # # # ### # # #
#   # #     # # # #   # # #   #   # # #
# # # ### ### # # # ##### ##### ### # #
# # #   # #   #   #     #     #   # # #
# # ### ### ### ####### ### # # # # # #
# #   #     #   #   #   #   # # # # # #
# # ### ######### # # ### ### ### # # #
# #               #       #       #   #
#######################################
