#######################################
#     #               #           #   #
# ##### ### ######### ##### ##### # # #
#       #   #     #       # #     # # #
######### # # ### ####### # ##### # # #
#     #   # # #       #     #   #   # #
# ### # ##### ####### ##### # #########
#   # # #   #   #   #   # # #         #
### # # # # ### ### ### # ####### ### #
#   # #   # # # #     # #       #   # #
# ### ##### # # # # ### # ##### ##### #
#   #       # #   # # #   #   # #     #
# # ######### ### ### # # # # # # ### #
# # #   #     # #     # #   # #   #   #
### # # ### # # ### ### ##### ##### ###
#   # #   # #     # # # #   # #   # # #
# # # ##### ### ### # # # ### # ##### #
# # #   #     # #   # # #   # #       #
# # ### # ### ### ### # # # # ####### #
# # #   #   #       #   # # # # #     #
# # # ##### ##### # # ##### # # # ### #
# # #   #     #   # #     #     #   # #
# ##### ##### # ### ##### ####### # ###
#     #     # #   # #           # #   #
# ### ##### ##### # ########### ##### #
# #       #     # # #   #     #     # #
### ##### ##### ### # # # ######### # #
#   #   #     #   #   #         #   # #
# ### # ### ##### ### # ####### # ### #
#     #   # #     #   #   #     #   # #
# ####### ### ##### ####### ####### # #
#   #     #   #   #   #     #     # # #
##### ### # ### # ### ####### # ### # #
#     #   #   # #   #   #     # #   # #
# ######### # # # # ### # ##### # ### #
#   #     # #   # #   # #   #   # #   #
# # # ### ####### ### # ### # ### # # #
# #     #           #       #   #   # #
#######################################
