#######################################
#   #           #           #         #
# ### # ####### ####### ### ##### ### #
#     #   #   #   #   #   # #     # # #
# ####### # # ### # # ### # # ##### # #
#   #   # # # #   # #   # #   # #     #
### # # # # # # ### ### # ##### # #####
#     # # # # #     # # # #       #   #
######### # # ####### # # # ####### # #
#       #   # #           #     #   # #
# ##### ##### # ############### # ### #
#   # #       #   #   #       # #   # #
### # ########### # # ### ##### ### # #
#   #       #   # # #   #     #   # # #
# ### ####### # ### ### # ### ### ### #
#   #   #   # #     #   # # #     #   #
# # ### # # # ####### ### # ####### ###
# #   # # #   #   #   #       #   # # #
# ### # # ####### # ########### # # # #
# # # # #       # # #   #     # #   # #
# # # # ####### # # ### ##### # ##### #
#   #         #   #     #     #   # # #
### ##### ### ### ##### # ##### ### # #
#   # #   #   #   #     # #     #   # #
# ### # ### ### ### ##### # # ### ### #
#     # #     # # # #     # # #   #   #
##### # ##### # # # # # ### # # ##### #
#     #   #   # #   # #     #   #     #
####### # # ### # ############# # #####
#     # # #   # #   #   #       #     #
# # # # # ### # ### # # # ####### ### #
# # # # # #   # # # # #   #   #   # # #
# ### ### # ### # # # ##### # # ### # #
#   #     # # #   #   #     #       # #
# # ####### # ### ##### ############# #
# # #   #       # #   # #   #         #
# # # # ######### # # ### # # ####### #
# #   #             #     #   #       #
#######################################
