#######################################
#           #             #       #   #
# ######### # ##### ####### ##### # # #
# #   # #   # #   #         #   # # # #
# # # # # ### ### ########### # # # ###
#   #   # #   #           #   # # #   #
####### # # ### ######### ### ### # # #
#     # # #   # #   #         #   # # #
# # ### # ### # ### # ######### ##### #
# # #   # #   # #   # #   #     #     #
# # # ### # ### # # # # # # ##### ### #
# # # # # #     # # # # # #       # # #
# # # # # ####### ### # # ####### # # #
# #     #     # #     # #   #   # #   #
# ########### # # ##### ### ### # ### #
# #         #     #   # #   #   #   # #
# # ####### # ##### ### # ### ##### # #
# # # #     #       #   # #       # # #
# # # # ####### ##### ########### # ###
# #   # #       #             #   #   #
##### # ##### ### ########### ### ### #
#     #     # #   #         #   #     #
# ######### ### ### # ######### ### ###
#   # #   #   # # # #   #       #   # #
### # # # ### # # # ### # ####### ### #
# # # # #       # # #   #     #   #   #
# # # # ######### # # ####### # ##### #
# #   #   #   #     # #     #         #
# ### ### # # # ##### # ### ######### #
# #   # #   # #     # # #     #       #
# # ### ##### ### ### # # ##### #######
#   #     #   #   #   # #       #   # #
# ##### # # ####### # # ######### # # #
# #     # # #     # # # #       # # # #
# ### ### # # ### # ### ### ### # # # #
#   #   # # #   # #         # #   # # #
### ### # # ### # ########### ##### # #
#       # #     #         #           #
#######################################
