#######################################
#     #   #               #     #     #
# ### # # # ######### ##### ### # # ###
#   #   #   #     #   #     # # # #   #
# # ##### ### ### ### # ##### # ##### #
# # #     #     #   # # #     #     # #
# # ####### ### ### # # ### ####### # #
# #       #   # #   # # #   #       # #
# ####### ### # # ### # # # # ### ### #
# #         # # #   # # # # #   # #   #
### ##### ### # ### # # # ####### # # #
#   # #   #   # #   # # # #   #   # # #
# ### # ####### # ##### # # # # ### ###
#   #   #     # # #     # # # #   #   #
### # ##### # # # ### ### # # ####### #
#   # #     # # #     #     #         #
# ### # ##### # ####### ##### ####### #
#   #   #   # #   #         #       # #
# # ##### ### # # # ####### ####### # #
# #   #   #   # # # #   #     #     # #
##### # ### ### # ### # ####### # #####
#     #   # #   #     #         # #   #
# ####### # # ### ######### ####### # #
# #     #   # # # #     #   #       # #
# # ### ### # # # ##### ##### ####### #
# # # #   # # #       #       #   #   #
# # # ### # # ################### # ###
# # #   # # #           #       # # # #
# # # # # ####### ##### # # ### # # # #
# # # # #   #   # #   #   # #     #   #
# # # # ### # # # ### ##### ##### ### #
#   # # #   # # #     # #     #     # #
# ##### # ### # # ### # ##### # ##### #
# #     #   # #   #   #   #   # #     #
# # # # ### # ####### # ### ### # #####
# # # # # # #       # #   #   # #     #
# ### # # # ####### # ### ### ##### # #
#     #   #         #       #       # #
#######################################
