#######################################
#           #               #       # #
# ######### # ### ######### # ##### # #
#       # # # #   #   #   # #   #     #
# ##### # # # ##### # ### # ### ##### #
# #   # #   #       #   # #   #   # # #
# # # # ### ########### # ### # # # # #
#   # #   # #       #   #   # # # #   #
##### ### ### ### ####### ### # # # ###
#   # # #       #         #   # # # # #
# ### # ############### # # ##### # # #
#   # #     #           # #     # # # #
### # # # ### ##### ########### # # # #
#   #   # #   #   # #       #   # # # #
# ##### ### # # # ### ### ### ### # # #
#     # #   # # #   #   #   # #   #   #
### ### # ##### ### ### ### # # ##### #
#   #   #     #   #   #   # #   #   # #
# ### ####### ### # ##### # ##### # # #
# #   #   #     # #   #   #       # # #
# # ##### # ##### ### # ### # ####### #
# # #   # #       # #   # # # #     # #
# # # # # ######### ##### # # # ### # #
# #   #         # #       # # # # # # #
# ############# # # ##### # ### # # # #
#       #   # # # # #   # #     # #   #
# # ### # # # # # # # ### ####### #####
# # #     #   # # #   #   #           #
# # ##### ##### # # ### # # ##### ### #
# # #   # #     #   #   # # #   # # # #
# # # # # # ######### ##### # # # # # #
# #   # # #     #   # #     # #   #   #
# ##### # # ### # # # # ##### ##### ###
#   #   # # #   # # #       # #   # # #
##### ##### # ### # ######### ### # # #
#     #     # #   #     #   #   # # # #
# ##### ##### # ####### # # ### # # # #
#       #       #         #     #     #
#######################################
