#######################################
#       #   #         # #       # #   #
# ####### # ### ##### # # # ### # # # #
#   #     #     #   # #   # #   #   # #
# # # ##### ##### # # ##### # ### ### #
# # # #   # #     # #       # #   #   #
# # # # ### # ##### ######### ##### # #
# # # #   # # #   #       # #       # #
# # # ### # ### # # ##### # ######### #
# # #     #     # #     #   #     #   #
# # ##### ####### ##### ### # ### # ###
# #       #           #   # # #   # # #
# ######### ######### ### ### # ### # #
# #       #         #   # #   #     # #
# ##### # ############# # # ######### #
#       #     #         # #   #       #
####### ####### ######### ### ####### #
# #   # #       #           # #       #
# # # # # ####### ####### # # # ##### #
# # #   # #   # #     #   # # # # #   #
# # ##### # # # ##### # ##### # # # ###
# #   #   # # #   #   #     # # # # # #
# ### # ##### # ### ####### # # # # # #
#     #       # #   #     # #   # #   #
# ####### ##### # ####### # ##### ### #
# #   #       # # #     # #   #       #
# # # ####### # # # ### # # # # #######
#   # #     # #     #     # # #   #   #
##### # ### # ############# ##### ### #
# #   # #   #       #     #     # #   #
# # ### # ######### # ### ### # # # # #
#   #   # #   #     # #       # #   # #
# ### ##### # # ##### ####### ####### #
# #   #   # #   #         # # #   #   #
# ### # ### ############# # # # # # ###
#     # #   #     #     # #   # # #   #
####### # ### ### # ##### ##### # ### #
#             #     #           #     #
#######################################
