#######################################
#           #       #               # #
# # ### ##### ##### # ############# # #
# #   # #     # # #         #       # #
# ### ### ##### # ####### ### ####### #
#   # #   #     #   #     #   #       #
### # # ####### ### ####### ##### ### #
# # # # #       #   #       #     #   #
# # # # # # ##### ### ### ##### #######
# # # # # #   #   #     # #   #       #
# # # # ##### # # ### # ### # # ##### #
# # #   #     # #   # # #   # # #   # #
# # ##### ##### ### ### # ### # # # # #
# #   #         # #   # # # # # # #   #
# ### ##### ##### ### # # # # ### ### #
#   #     # #       # #   #   #   #   #
# ####### # ####### # # ### ### ##### #
#     # # #         # #   #   #     # #
### # # # ####### ### # ##### # ### ###
#   #   #   # # # #   # #     #   #   #
# ######### # # # # ##### ########### #
#             #   #   #   #     #     #
# ################### # ### ### # ### #
#         #           #     #   # # # #
# ######### ########### ##### ### # # #
# #         #   #     # #   # #   # # #
### ######### # # # ### # # # # # # # #
#   #         #   # #   # #   # # #   #
# ### ####### # ##### ### ##### # ### #
#   # #     # # #   # #   #     #   # #
### ### ### # ### # # # ########### ###
#   #   #   #   # #   #     #     #   #
# ### ### ##### # # ####### # ### ### #
#     # #     #   # #     # # # # #   #
####### ##### ##### ### # # # # # # ###
#           # #   # #   # #   #   #   #
# ######### # # # # # ######### ##### #
#         #     #   #                 #
#######################################
