###############################################################################
# # # # #     # # #     #   # #       # #                     # #   # # #     #
# # # # ##### # # ### ##### # ####### # # ####### ### ######### ### # # # #####
#   #     #             # #   #   # # #   #     #   # #   # # # #   #         #
# ####### ######### ### # ### # ### # # ### ########### ### # # ### # ### # # #
#         #         #   #   #   # # # # # #             # # # # #       # # # #
##### ### ############# ### ### # # # # # # ############# # # # ### ###########
#   # #         # #     # # # # #       #             #   # # #     # # #   # #
# # # ######### # ##### # # # # # # ##### # ############# # # ### ### # # ### #
# #   #   #     #     #   # # # # # #     #     #       # #   # #   #       # #
### ### # ##### ##### ### # # # # ### # ### ##### ####### # ### # ### ### ### #
# # # # #             #     # #       #   #       # # # #       #   #   # #   #
# ### ######### ##### ##### # # ############# ##### # # # ####### ### ##### ###
#         #   # #           # #   #       # #   # #   # #     # #         #   #
### ##### # ##### # ####### # # ### ####### ##### # ### # ##### # ### ####### #
#   #   #       # # #           #       # # #   # # # # #       #   #         #
####### ####### # ############# # ##### # # # ### # # # # ####### # # ##### ###
#               # #                   # # #                     # # #     #   #
##### ######### ######### ##### ######### # # ##### ##### ### ### #############
#   # #   #               #         #   # # #   #       #   #                 #
### ### # ### # ### ### ##### # ### # ### # ####### ######### ### ### #########
# #     #     # #   #   #     #   #           #   #         #   #   #         #
# ######### # ####### # ##### # # # # ### ### # ############# ### ########### #
#   #   #   #   #     # #     # # # #   #   #               #   #           # #
### ### ### # # # ######### # ######### ######### ##### # # ### ### # # # # ###
#   #       # # # # # #     #     #   #         #     # # #   #   # # # # #   #
### ### ########### # ##### # ##### ### ############### ####### ### ### # # # #
#       #   # # #   #       #         #             # # #     #   # # # # # # #
# # ####### # # ### ### ### # # ##### ######### ##### ### ### # ##### ####### #
# # #     #   #           # # #     #       #               # #           # # #
######### # ### ### # # ####### ##### # ######### ############# ##### # # # # #
#     #         # # # #     #       # #       #             # #   #   # #   # #
##### ##### # # # ### # ######### # ##### # ##### ##### # ### ######### #######
#           # # #     #   #       #   # # #     #   #   #   #   #     #   #   #
# ######### ##### # # # ### # # # ### # ### ### # ### ### ### ### ######### ###
# #         # # # # # #   # # # #   #     #   # #   # # #   #                 #
### ### ##### # ##### # # ### ### ##### ### ### ### # # ### # ####### #########
#   #   #             # #   # #       #   #   #   # #   #           #         #
###############################################################################
