###############################################################################
#   # #         # #           #   # # #   #   #       #     # #         # # # #
# ### ### ##### # ### ##### ##### # # ### # ##### ##### ##### # ######### # # #
#   #   # # # #       #   # #   #     # # # #       #     # #       # #   #   #
# ### ##### # ####### # ### # ### ### # # # # ####### ##### # ####### # ### ###
# # #   #       # # #     # # # # # # #   # # #   # #   # # # #   #     # #   #
# # # ### ##### # # ### ##### # # # ##### # # # ### # ### # # # ### ##### ### #
#   # # # # #       # #     #   #     # # # # # # # #   # #     #   # # # #   #
### # # ### ####### # # ####### # ##### # # # # # # # ### # ##### ### # # # ###
# # # #   # #     # # #       # # # # #     #   # #   # #   #   # # #   #   # #
# # # ### # ### ### # # ####### # # # ##### # ### # ### ### # ### # # ### ### #
# #       # #         # # # #       # #   #               #     # # # #   #   #
# ####### # ####### ### # # ##### ### ### # ####### ####### ##### # # # ### ###
#             #   #     # # # # #   #   #   #     #       # # # # #           #
##### ### ### ### ### ### # # # # ##### ### # ### ######### # # # # ###########
# #   #   #       #     #   # # # #   # # # #   #         #         #       # #
# ####### ####### ##### # ### # # # ### # # # ############# ######### ##### # #
#     # # #           #   #   # # # #   # # #     #         # #           #   #
### ### ############# # ### ### # # ### # # # # ### ######### # ###############
# # #   #       # # # #     # # # # # # #     #                             # #
# # ### ####### # # # # ##### # # # # # # ################# ########### # # # #
# #   #   #         #   #   # # # # # #             #     #         # # # #   #
# ### # ########### # ### ### # # # # # ####### ##### ######### # ### ##### ###
# #   # #   # #   # # # # # # # #   #         # #     #       # #       # #   #
# # ### ### # ### # # # # # # # # ### ######### # ### # ######### # ### # #####
# # #   # # # #       #   # #     #       #   #     #         # # #   #       #
# # ### # # # ##### ### ### ### ### ### ### ### ### # # # ##### ###############
# #   # # # # # # # #   # #   #       #     # #   # # # #                     #
# ### # # # # # # # # # # # ### ##### ####### ################# ### ### # # # #
#         # #   #     # #   #       #   # #     #       #     #   #   # # # # #
### ### # # ### ##### ### ### ########### # ##### ### ### ######### # ##### ###
#   #   # # #       # # #       # #   # #           #     # #     # #     #   #
# # ##### # ####### # # # ####### # ### # ########### # ### # ####### # ##### #
# # #       #   #   #                             # # #           #   #   # # #
# ### # # # ### ### # ####### ####### ##### # # ### ############# ### # ### ###
# # # # # # #               #     # #     # # #                 #   # # # #   #
### ### ### ####### ####### # # # # # # ##### ### ##### ### ##### ### # # # ###
#       #                 # # # #   # #     #   #     #   #     #   # #       #
###############################################################################
