###############################################################################
#         #             #             # #       # #   # #         #           #
##### ### ############# ####### ##### # ####### # # ### # ########### ##### # #
#     #         #       # # # # # #       #     #                         # # #
# ### ######### ####### # # # ### ####### ##### ### ############### # # # #####
# #   #     #   # #               # #   #       # # # #     #     # # # #     #
# ######### ### # ####### ##### # # ### ####### # # # # ##### ### #############
# #     # #     #   #     #     # #         #     # #       #   #     #     # #
### ### # ### # ### ##### ####### ######### ##### # # ####### ######### ##### #
# # #       # #           #         #   #     #   # # #           #       #   #
# # ####### ######### ############# ### ##### ### # # # ########### ######### #
#   #   # #           # #       # #                             #     #   #   #
####### # ######### ### ####### # # ### # # ### ### # ### ####### # ### ##### #
#                   #     #   # #   #   # # # # #   #   #         #   #   # # #
# # # # # # # ##### ### # ### # ### ### ##### ##### ### ####### ####### ### # #
# # # # # # # #   # #   #             # #             #   #   # #             #
######### ####### ### # # ##### # ### ######### # # # # ### ##### ####### ### #
#         #           # # #     # #   #         # # # #                 #   # #
##### # ##### # ######### ### # # ### ##### # # # # # # # ### ### ##### ##### #
#     # #     #   #       #   # # #   #     # # # # # # #   #   #     #     # #
# ### # # ### ### ####### ######### ####### # # # # ### # ########### ### #####
#   # # # #   #   #       #         #       # # # #   # #     #     #   #     #
##### ####### ########### ### # # ##### # # # # # # # # # ##### # # ######### #
#     #         #         #   # # #     # # # # # # # # #       # #         # #
# # ############# # ####### # ########### ### ####### ####### #################
# # #         #   # #       # #           #   #             #   #     #   #   #
######### # # ##### ### # # ### ####### # # ### # # # ### # ##### ##### ### ###
#         # #     # #   # #   # #       # #   # # # # #   #   #   #           #
# ##### ### ##### ### ##### # ########### ### # # ### # # # ### ### ######### #
# #     #   #         #     # #             # # # # # # # #       #         # #
# # # # # ##### ######### ### # ### # ### # ### # # ### ### ### # # ######### #
# # # # # #     #         #   # #   # #   # #   # #     #     # #           # #
# # # ### # # # # ########### ####### # ### # ##### # # # ### # # # # #########
# # #   # # # # # #             #     # # # #   #   # # #   # # # # #   #     #
# ### ########### # # # # ### ####### ### # ####### ### # ### # ##### ### #####
# #     #         # # # # #   #   #   #     #       #   #   # # # #           #
##### # # ##### ####### ### ##### ######### ####### ### # ####### #############
#     # # #     #       #   #                 #     #   #                     #
###############################################################################
