###############################################################################
#       #       #               #       # #                                   #
# # # ######### ####### # ##### ####### # ##### ##### ####### # ##### ### # ###
# # #       #         # # #         # # #   #   #     #       # # #   #   #   #
# # ##### # ######### # ### ### ### # # ### # # # ### # # ### # # ### ### #####
# # #     #   #     #   #   #   #             # # #   # # #   # #     #       #
# ### ##### # ##### # ##### # ######### # # # ### ### # # ### ######### # # # #
# #   #     #         #     # # # #   # # # # # # #   # # #   #         # # # #
################# # ### ##### # # ### # # ##### ################# ##### #######
#                 # #   #     #         # # #                     #           #
##### # ### # # # ########### ########### # # ########### # ##### # # # ### # #
#     # # # # # #   #         #       #   #     #         # #     # # #   # # #
# # # ### ### ### ##### ############# ##### # # ### ### # ##### # # ### # # # #
# # # #       #     #   #                   # # #   #   # #     # # #   # # # #
################# # ######### ############# ######### ####### # # ##### # ### #
# # # # #   # #   # #   #     #             #         # # #   # # #     #   # #
# # # # # # # ######### ################# # # ######### # # # # ##### # ### # #
# #     # #     # #                       # # #             # # #     # #   # #
# ##### ####### # ######### ### ####### # # ### ### ### # ##### # # # ##### # #
#       # #       #         #   #       # # # # #   #   # #     # # # #     # #
# ##### # ####### ##### # # ### # ### # ##### ### ####### # ##### ####### # # #
# # #             #     # # #   # #   # # #       #       # #   # #       # # #
# # ######### ### ### # # # ##### ### # # ### # ####### ####### ####### # #####
# # # # #     #     # # # # #       # # #     # #       #               #     #
### # # ########### # ######### # ################# # ### ### # # # ### # # ###
#       #                 #     # #                 # #   #   # # # #   # #   #
# ##### ####### ### # # # ### # ### ####### ########### # # # ### # # ### ### #
# #       #     #   # # # #   # #   #       # #         # # # #   # # #     # #
######### # # # # # # # ### # ######### # # # # # # # ### # ### # # ### # ### #
#           # # # # # # #   # #       # # # #   # # # #   # #   # # #   # #   #
####### # # # ### ### ### ### # # # # # # # # ### # ### ####### ### # # ### # #
#       # # #   # #   #   #   # # # #   # # #   # # #     #     #   # # #   # #
########### # # # # # ### ##### # # # # # ### # ####### ##### ##### # # ##### #
#           # # # # # #   #     # # # # # #   # #       #     #     # # #     #
### # ### ##### ##### # # # # # ######### ### ##### ########### # # # ####### #
#   #   #   #     #   # # # # # #         # # # #   #           # # # #       #
### ######### ### ##### ### # # # ### ### # ### ### # ####### # ### ######### #
#   #           #   #   #   # # # #   #   #         # #       # #   #         #
###############################################################################
