###############################################################################
#   #         #   # # # # # #     # #               #                 # # #   #
# # ######### # # # # # # # # ##### # ##### ##### ### ### ### # ### # # # # ###
# #       # # # # # # # # # # # # #   #   #     # # #   # #   #   # #         #
# ### ### # # # ### # # # # # # # # ### ####### # # # ##### # # ##### ### #####
# #   #       # # # # # #       # # #         # #         # # #     #   #   # #
# ########### # # # # # # ##### # # # ####################### ############### #
#   #   #               #     #                             #     #         # #
####### ##### ##### ##### ################# # ### # ### ####### ### ######### #
#     # # #   #       #                   # #   # #   #       #   # # #       #
### # # # ##### ### ##### ##### ####################### # ### ##### # # #######
#   #           #             #       #               # #   # # # #           #
######### ##### ### ### # # ########### ### ######### # ### ### # # ###########
#           #   #   #   # #         #     # #     # # #   #                   #
##### # # # ##### ### # ### # ####### ####### # ### ### # # # # # # ###########
#     # # # #     #   # # # #         # # #   #       # # # # # # #           #
# # # # # ##### # ### ### # ### ####### # # ##### ####### ##### # # ##### ### #
# # # # # #   # # #       #   #           # #   # #     #     # # # #   #   # #
# ##### # # # ####### ##### ### ##### ##### # ##### ### ##### # ### # ##### ###
# #     # # #             #   #     # # # #           #     # #   #       #   #
# # ### # ### # ### # # # # # # ### # # # # ### ########### ### # # ### # ### #
# # #   # #   # #   # # # # # #   # # # #     #     #     #   # # #   # #   # #
# # # # ##### # ### # # # ### # # # ### # ### ##### # ######### ##### # ##### #
# # # #   #   # #   # # # #   # # #         # #   #           # # #   #   # # #
### # # ##### ##### ### # ### ### # ### ##### # # # ####### ##### # # ##### # #
#   # #   #     #     # # #     # #   #     #   # #   #   #     # # #       # #
### ### # # # ### # ####### ### ### ### # ### # ####### # ### # # #############
#     # # # # #   #     #     #   #   # #   # #   #   # #   # # # #           #
# # # ### ### # # # # # # # # ### ### ### ### # ### ### ######### # ### # #####
# # #   # # # # # # # # # # # #     #   #   # #     #                 # # #   #
### ### # # # ### # ### ### # # # # # # # ### ####### ##### ### # ######### ###
#     # # #   #   #   # #   # # # # # # #   #             #   # #       # #   #
### # # # ### ### # # ### ### # # # ##### ### ####### ### # ##### ####### # ###
#   # # # #     # # #   # #   # # #     #   #       #   # #     #         #   #
# # # # # # # # ##### ### ### ### # ########### # # # ### ### ### ### ####### #
# # # # # # # #   #   # # #   #   # #   #   #   # # #   #   # # #   #     #   #
# # ### ### ######### # ####### # ### ### # # # # # ######### # # # # # ##### #
# #   # #   #           #       #         # # # # #         #   # # # #       #
###############################################################################
