###############################################################################
#     #   #         #                   #     #   # #       #   # #   # #     #
### ### ######### # ######### ##### ##### ####### # # ####### ### # ### # #####
#     # #   #   # # # #       # #   #       #   #     # # #   # # # #   # #   #
### ### ### # # ### # ######### # ### ####### ### ##### # ### # # # # ### # ###
#   # # # # # #   # # #   #   #   # # # #   #     #   #     #   #   #       # #
### # # # # ##### # # # # # ##### # # # ### # ##### ### ####### # ### ####### #
# # # # # # # # #     # # #   # # #       # # # #   #     #   # #     # #     #
# # # # # # # # ##### ### ### # # ####### # # # ### ### ### ### # ##### # # ###
# # #   # #   # #     # # # # # #   # # #   # #     #   # # # # #         #   #
# # ### # # ### # ### # # # # # ### # # # ### ### ### # # # # # # # # # # # ###
#   # # # # # # # #   # #       #     # #   #   # #   # # # # #   # # # # # # #
### # # # # # # ##### # ##### ####### # # ### ### # ##### # # # ############# #
#       # # # # #       #   # #     #   # #     # #   # # # # # #   # # #   # #
##### ### # # # ####### # ### ### ##### # # ##### ### # # # # # # ### # # ### #
# #   #   # # # #   # # #     # #     #       # # # # # #   #           # #   #
# ### ### # # # ### # # # ##### ##### # ####### # # # # # ### ########### # # #
#           # # #     #   #   #         #   #   # #   # # #       #   #     # #
### ####### # # ##### ### # ####### ##### ### ### ### # # # ####### ### #######
#   #       #     #   #         # # #         # # #   # #       #     #     # #
# ######### # # # ### ####### ### # # ######### # # ### # ######### ### ##### #
# # #         # #   # #   # #       # # # #   # # # # # #   #   #   #       # #
### ##### ######### # ### # ####### # # # # ### # # # # # ### # # ### ####### #
#   #     #             #   # # #     #   # #       # # #   # #   # # # #     #
### # # # # ######### # ### # # ##### ### # # ####### # # ### ##### # # # #####
#     # # # #         #       #   # # #                         #   # #       #
# ##### ##### ##### # ####### ### # # ### ##### ################# ### # #######
# #     #     # # # # #           # # # # #   #             #                 #
# ############# # ####### ####### # # # # # ####### ######### ######### #######
# #           # #       # #     # #   # #   # #   # # #       # #     #   # # #
# # ### ##### # ####### # ##### # ### # # ### # ##### # # ### # # ######### # #
# # #     # #             #   #                         #   # #         # #   #
# # ####### # ### ### ####### ######### ##### # ############### ######### # ###
# # #         #   #   #               # # # # #     # #   #   # #             #
############### ### ##### ########### # # # ######### # ##### # # ##### #######
# #   # # #   # #   #     # # #     # #           # # # # #           #   #   #
# ### # # ### ############# # ##### # # ######### # # # # # ##### # ####### ###
#                                               #               # #           #
###############################################################################
