###############################################################################
# #   # #                       # #       # #   # #     # # #     # #   # #   #
# ### # ########### ### # ##### # # ##### # # ### ##### # # ### ### ### # # ###
#           #     # # # # #       # #       # # # # #   #     #     # #   # # #
### ####### ##### ### # ######### ####### # # # # # ### # ##### ##### # ### # #
# # #     # # #   #   # #       #   #   # #   #   # # # # #       #   # # # # #
# ####### # # ### ### # ##### # # # ### ##### # ### # # # # ######### # # # # #
# #     # # #   #   # # #   # # # # #           #   #   #         #   #   #   #
# ##### # # ### ### # ##### ### ### ########### ### # ### ########### # ### ###
#           #   # # # #     #         #   # # # # #   # #   # # # #     #     #
######### ##### # # # ##### ######### ### # # # # ### # # ### # # ### ### ### #
#         #         # # # # #     #       #   #   #   #     # # # #   #     # #
# ### ### ######### # # # # ##### ####### ### ### ### # ##### # # ### # #######
# #   #       #         # # #               #   # # #     # # # # #   #   #   #
# ##### # ### ######### # # ############### # # # # ### ### # # # ### # ### ###
# #     # #   #                   #       #   #       #   # #     # # #   #   #
####### ##### ### ##### # ##### # ####### # # ####### # ### # ##### # # ### ###
#     # #   # # # #     # #   # # # #   #   # #   # # # #   # #   #         # #
# ######### # # ##### # ##### ### # ### ######### # # # ### # # # # ### # ### #
#     # #     # #     # #         #       # #           # # #   #     # # #   #
# # # # ##### # ################# ####### # ########### # # ### ########### ###
# # #   #             # #       #   # #     # #       # # # # #   # #       # #
# # ### ########### # # ####### # ### ##### # ####### # # # # # ### # ####### #
# # # # #           #                       # # #     # #   # #   # # # #     #
##### # ####### # ######### ######### ##### # # ##### # # ### # ### # # # #####
# #   #   # #   #   #       #         #             #         #     #     # # #
# ### # ### ############# ### # ########### ####### ####### ### ##### ##### # #
# #     #   #   #   # # # #   # #       #   #     #             #   #     # # #
# ##### # ##### ### # # # ########### # ######### ######### ##### # # ##### # #
# # #     # #   #     #   # # #       #         #     #         # # #   # #   #
# # ##### # # ####### ##### # ### # ### ####### ##### ### ####### ### ### # ###
#       # # #   # #     #     # # # #   #         # #       # #       #       #
####### # # # ### ##### ##### # ################# # ##### ### # ### ### # #####
# #     #           # # # # # # # #         # #         # #       # #   # # # #
# # # # ########### # # # # # # # ####### ### ######### # # ########### ### # #
#   # #   #           #                 # #           #             #         #
######### ########### # # ### # ####### # ### ####### # # ### ### ### ##### # #
#                       # #   # #             #         #   #   #         # # #
###############################################################################
