###############################################################################
# # # #           #       # # #   #   #   #   #   # #   # #         #         #
# # # # ######### ####### # # ### ### # ##### ### # ### # # ### # # ##### # ###
#       #   # # # # #   #   #               #   # #   # #     # # # #   # #   #
##### ##### # # # # ### ### # # # ### ### ### ### ### # ### # ### # ### # ### #
#     # #   #   # # #         # # #   #     #       # #     # #   #     # # # #
####### ### # ### # ##### # # ##### ####### ### ### # ############### ##### # #
#   # #             #   # # # #     #         # #             #       #     # #
# # # ### # # # # ##### ######### ########### ####### ####### ####### ##### # #
# #       # # # #   #   #     #   # #                 #       #     # #       #
# ### # ##### ### # ### # # # ##### ######################### ##### # # # ### #
# #   # #     #   #     # # # #                       #             #   # #   #
# ### ##### ####### ### ##### ######### # ########### ### ##### ### # # # ### #
# # # #     # # #   #         # # #     # #       #   #   #   # #     # # #   #
# # ######### # ### ######### # # # # ####### # # # # ####### # # ### # ### # #
# #     #   # # # # #       #     # # #     # # #   #           # #   # #   # #
##### # ### # # # ### ##### ### ########### # ##### # # ### ### ##### # ### # #
# # # # #             #     # # #   #         #     # # #   #   #     # #   # #
# # # ####### ############# # # ### ####### ####### ### ##### # ### # # # ### #
#     # #     # #   #       # # # # #     # #       #   #     # #   # # # #   #
##### # ##### # ### ####### # # # # ##### ### # ####### ### # # # ##### # # # #
#             #     # # #                     # #       #   # # # #     # # # #
####### ########### # # # ### # ##### # ##### # # # ################# # ### # #
#       #           # # # #   # #     # #     # # # #                 # #   # #
# # # ### ######### # # ### # # ### ######### ### ##### # ### ### ### # ##### #
# # # #   #     #           # # #   #           # #     # #     # #   #   # # #
# # ### # ### # ### ### ### # # # ### # # # ### # ################# # ##### # #
# # #   # #   #     #   #   # # # #   # # # #   # # #             # #   # #   #
# # ##### ####### # ### ##### ### # # # # ######### # # ### ##### ### ### ### #
# # #     #       # #   # #   #   # # # # #         # #   # #         #       #
# ################# ### # ### # # ### # # ##### # # # ### ### # # # # ### # # #
#     #   # #       #   #     # # #   # # #     # #   #   #   # # # # #   # # #
# # ##### # ################### ####### ### ##### # ### # ######### ### # # ###
# # #                 # # #       # #   # # #     # #   # #         #   # #   #
# ### ############### # # ##### ### ### # ### ##### ### # ### ####### # ### # #
# # # #       # #                   #       # #     # # # #     #     # #   # #
### ##### ### # ##### ### ### # # # # # ##### # # ### # ############# ### # # #
#         #           #   #   # # # # # #     # # #     #               # # # #
###############################################################################
