###############################################################################
#                     # #   # # # #     # #     # #         #         # #   # #
##################### # ### # # # ##### # ### ### # ######### ######### # ### #
#   # #       # #       #       #               #           #         #   # # #
# # # ####### # ####### ##### # ####### # ### # ### ######### ######### ### # #
# # #       #   #   # #   # # #   #   # #   # # #                   # # # #   #
### ### ### ### ### # # ### ##### ### ### ######### ################# # # # ###
# #     #     #   #   #         # #     # #   #   #     # # #   #   #   #     #
# ######### ##### ### ### ##### # ### # # # ##### # ##### # # ### ##### # #####
# #   # #   #     # # #   #   # # # # # # # # # #   #   # #   #         # #   #
# ### # ### ### ### # ####### # # # # ### # # # # ### ### # ### ######### # ###
# # # # #       # # #     #   # # #         #   # # # #     #     #     #     #
# # # # ####### # # ### ##### # # ### ######### # # # # ##### ##### ##### #####
#               #   #   # #     #   # # # #     #   #   # #               #   #
# ############# ### ### # ##### ### # # # ### ##### # # # # ##### # # # ### ###
# #                 #           #     # #     # #     #         # # # #       #
##### # ########### ##### ##### ##### # ### ### # ##### ##### # # ### # # # ###
#   # # #                 #     #     # #     # #     #     # # #   # # # #   #
### ### ### # ################# ##### # # ##### # # ###########################
#   #   #   # #     #     # # #         # # # #   #         #                 #
### ############### ### ### # ##### ### # # # # ### # # ### # ##### # ### ### #
# #                     # # #     # #             # # #   #       # #   #   # #
# ########### ######### # # ##### ##### ### # ######### ############### # ### #
#   # # # # #   #           #             # #   #     # #             # #   # #
### # # # # # ############# ####### ### # # # # # ####### ############# ##### #
#   #         #       #           # # # # # # #                       #     # #
### ### ##### ####### ######### ##### ### ##### # # # #########################
#       #     #                   #       #   # # # #                         #
# # # ##### ######### # # # # ### ####### # ####### ######################### #
# # # #   # #         # # # # #                   #                     # # # #
# ####### ### ### ### # ### # # # ### ### # # ### ##### ### ### # ### ### # ###
# #   #       #   #   # #   # # #   # #   # #   # #   # # #   # #   #       # #
##### ####### ### ### ### ### ### # ####### ####### # ### ### # ############# #
#             #   #   #   #   #   # #       #       #       # #           #   #
####### # # ### ##### # ### ####### # # ### # # # ####### # ##### # # # ### ###
#       # # # # #     #   # #       # # #     # #       # #     # # # #       #
##### ### ### ############# # ### ### # # # ##### # ### # # # # ############# #
#     #       #             # #   #   # # # #     #   # # # # #             # #
###############################################################################
