###############################################################################
# #         #   # #   #           # #     # #   # # # # # #   #       # # #   #
# ######### ### # ### ####### ### # ##### # ### # # # # # # ### ####### # # ###
# # # # # #   # #   #     #   # # # #             # #   #   # # # # #         #
# # # # # # ### ### ##### ### # # # ############# # # # ### # # # # # #########
# #   #         #           # #   #                 # # # # #   # # #   #     #
# ### ######### ####### ### ##### ######### ####### # ### # # ### # # ### #####
#               # # # # # # # # #   # # #   #         # # # # #   # #       # #
# # ########### # # # ### # # # ### # # ######### ### # # # # # ### # ####### #
# #   #         # #     # #       #         #     # #       #             #   #
####### # ##### # ##### # # # # ########### ### ### ####### # ############# ###
#       # #                 # #       # # # #   #   # #         # # #         #
### # # # ####### ### # # ######### ### # # ### ### # # ######### # # # # ### #
#   # # # # #     #   # # #   #   #           # #     # #             # #   # #
######### # ### # ########### ### ########### ####### # # ############# # #####
# # #     #     # #         #       # #   # # # # #       #   #     # # #   # #
# # ################# ##### # # ### # ### # # # # ### ##### ### # ### ####### #
#   # # #       #   # #       # #           #                   #   # #   #   #
### # # # # ### ### ### ### # ##### ####### ##### ### # ### # # ### # # ### ###
# #       # #           #   #   #   #   #         # # #   # # # #     # # # # #
# ############# ##### # ##### ######### ### # # ### # # ############### # # # #
# #               #   # # #   #             # # #     #     # # # #   # # # # #
# # # # # # ### ######### ############### # ######### # ##### # # # ### # # # #
#   # # # # #     #                       # # #       # # #   # #   # # #     #
# ### ### ##### ### ### # ##### ##### ### # # ### ##### # ### # # ### # # # # #
# #     # #     #   #   # #     #     #   # #     #           # #   # # # # # #
# # # # # ### # # ### # ### ### ##### ##### # # # # # ### # # # # ### # # #####
# # # # # #   # # # # # # # #   #     #     # # # # # #   # #               # #
# # # # ##### # ### # # # ######### ##### # ### # # # # # # ### ### # # # # # #
# # # #     # # #     # #     #     # #   #   # # # # # # #   #   # # # # #   #
# ##### # ############# # ### ####### # ### ########### ### # ### ### ##### ###
# #   # # #             # # #           #       #         # #   #   #     #   #
##### # # # ######### ##### ##### ### # ### # ### ########### ####### # ##### #
#       # # #     # # #   #       #   # # # # #   #           #     # #     # #
### # # ### ##### # ##### ####### # # ### # ####### ### # ### # ##### # # ### #
#   # # #   #       #             # # #     #   # # #   # #     #   # # # #   #
# ### ### ######### ########### # ############# # ### ### ### # # ####### ### #
# #   #   #                     # #                   #     # #         # #   #
###############################################################################
