###############################################################################
#           # # #   #                 #           # #   #     #               #
########### # # # ### ############### # ########### # ### ### # ##### #########
#     #           # #         #     # #                     #   #   #       # #
### # # # ####### # # ######### ####### ####### ### # # # ####### ######### # #
# # #   # #   #           #         # #       #   # # # #                 #   #
# ### # ##### ### ######### ######### # # ########### ### # # ### ##### # ### #
# # # # #                               #         #     # # #   #     # #   # #
# # ### # # # ### # ############# ####################### ### # ######### #####
#   #   # # # #   #             #                       #   # #       #       #
# # # # ### ### # ####### # ##### # ##### ######### ########### # ######### # #
# #   # #   #   #     #   #     # #     #         #   # #   #   #       #   # #
# # # # # # ##### # # ### # ##### # ##### # ### ####### # ##### ### # ### ### #
# # # # # # #     # #   # #     # #   #   #   #     #       #     # # #     # #
### # ### # ##### # ####### ### # # ##### # # ### # # ####### ##### # ### ### #
#   #   # # #     #   #   #   # # # # # # # #   # #       # # #   # #   #   # #
### ### # ##### # # # # # # # # # # # # ### # # ### ####### ### ### ####### ###
#     # #   #   # # #   # # # # # #       # # #   #     # #     # #   #       #
# # # ### # # # # # # # ### # ### ### ########### # # ### # ##### ######### # #
# # # #   # # # # # # #   # #   #   #           # # #         # #       #   # #
# ### # ##### ### ########### ####### ### # ##### ####### ##### # # ####### ###
#   # #     # #             #       #   # #   # # #   # # # # #   # #     #   #
# ### # # # # ####### # ##### ##### ### # ##### ### ### ### # # ##### #########
#   # # # # # #       # # # # #   # #   #       #     # #       #     # # # # #
# # # # # # ### ### # # # # # # ##### ### # # # # # # # # ####### ##### # # # #
# # # # # #   # #   # #     #       #   # # # #   # # #                 # #   #
# # ### # # # # # ####### ##### ### # # ### # ######### ### # # # ### ### # ###
# # #   # # # # # #           #   # # # #   #       #     # # # #   #   #     #
# # ##### # # ##### ### # ### ##### # ### # # ### # ### ####### ### ####### # #
# # #   # # #   #   #   #   #   # # #   # # # #   #           #   #         # #
### # # # ### # ### ### # ### ### # ####### # # ### ######### # ############# #
#     # #   # # #   # # #   #     # # #   # # #   #   #     # #             # #
# # # ### # # # # ### ### # ### # ### # ##### # ##### # ########### # # # ### #
# # #   # # # # #   #     #   # #         #   # # # # # #     #   # # # # #   #
# # ### # # # # # # # # ### # # # # # # ######### # ### # ####### # # ### ### #
# # #   # # # # # # # # #   # # # # # #       #   # #         #   # # # # #   #
# # # # ### # ### ####### ### ### # # ####### # ### ### ####### ### ### ##### #
# # # #   # #   # #       #     # # #     #                       #         # #
###############################################################################
