###############################################################################
#                 #   #     # #     #       #   # #             #       #     #
# ############# # ### # ##### ##### # ### ##### # # ############# ####### #####
# #     #       # #       # # #     # # #   #     #     # # #   #   #   # # # #
##### # ######### ####### # # ### ### # ####### ### ##### # # ##### # ### # # #
# # # #             #   # # # #   #     # # #   # # #             #       #   #
# # ##### ####### ##### # # # ### ### ### # ### # # # ######### ### ######### #
#         #         # #   # #     #   #   # #   # #   # #   # #           # # #
################# ### ### # ##### ### # ### ### # ### # # ### # ####### ### # #
# # # # # #     #   #       # # #     # # # #   #         # # #     # # #     #
# # # # # ##### ### ####### # # ### ### # # ### # ######### # ####### ####### #
# # #     # # # #   # #   # # # #   # # #     # #     # # #         # #       #
# # ### ### # # ### # ### # # # ### # # # ##### # ##### # # ######### ### #####
#         #   #       # # # # #     # # #   #       # # #       # # # # #     #
######### ### ####### # # # # ##### # # # # ### ##### # # ### ### # # # ### ###
# #     #         #   # #   #       #     # # #     #     # # #   # # #   # # #
# ##### ######### ### # # ######### # ####### ### ##### ### ### ### # # ### # #
#       # # # #         # # #     #   # # # # # #           # #     #   # #   #
# ##### # # # ######### # # ### ##### # # # # # # ########### # ##### ### ### #
# #   # # #     # #     #       #       # # # # #   #               # # # #   #
##### # # ##### # # ### ####### ####### # # # # ### # ############### # # # ###
# #                 # #   # # # # # # # #   # # # # #   #   # #     #   #   # #
# ########### # ##### ### # # # # # # # # ### # # # # ### ### # ####### # ### #
#     #   #   # #         # #     # #   # # # # # #     #     # # # # # #     #
##### ### ############### # ##### # ### # # # # # # ##### ##### # # # # # # ###
# #                       #     # # # #   #   # #       #           #     #   #
# # ####### ######### ### ##### # # # ### ### # # ####### ########### ### # # #
# # # #   # #   #     #       # # #   #   #         #     # #           # # # #
# ### # # ### # ##### ####### # # ### ### # ######### ##### # ########### # # #
#   #   # #   #   #   # #         # #     #                 #           # # # #
### ##### ##### ####### ######### # ##### # ################# # # ### #########
#           #     # #   #     # #   # # # #                 # # #   #         #
##### # # # ##### # ### ##### # ### # # # # ################# ### ######### # #
#   # # # # #       #   #   #   #   #   #     #   #             #   #   #   # #
# # # # ### ####### ### ### # # # # # ### # ### ### ################# # ### ###
# #   # # #       #           #   #     # #   #                   #   #   #   #
# ####### # ##### ####### ########### ### ##### ############# ##### # ##### # #
# #         #             #                                 #       #     # # #
###############################################################################
