###############################################################################
#   #                   #           # # # #   #   #                 # #       #
# ### ##### ### ##### ### # ######### # # # ### ### # ### ########### # #######
# # #     #   #     # # # #               # # #     # # #           #     #   #
# # # # # ### ######### # ### ### ### ### # # ### # ### ############# ##### ###
#     # #   #       #       # # #   # #       #   # #     #           #       #
### ########### # # # ### ##### ############### ##### ##### # # # ##### # # # #
#             # # #   #           # #   #       #     #     # # #   #   # # # #
# ######### ####### ##### # ####### # ### ### # # ##### ### ##### ### ### # # #
#         #     # #   # # #           # #   # #           #   #   #     # # # #
# # # # # ####### ### # ########### ### # ######### # ############# # ##### ###
# # # # # #   #   # # #   #       #         #     # #     # #   #   #     #   #
# # ##### # ### ### ### ### ### ######### ### ##### # # ### # ### ##### #######
# #     #                   # #     # # #         # # #       #   #   #       #
# # ######### ### # ### ##### # ### # # # ### ### # ### ####### ### # ### #####
# #         #   # # #         #   # # # # # #   # #   #             #   # #   #
### # ############# # # ### ######### # ### ####### # ### ##### ##### ### # ###
#   #         #   # # # # #         # # #         # #   #     #     #   #     #
# ### ##### ### ### # ### # # ####### # # ### ######### # # # ### ### ##### # #
# #       #       # #     # #               #         # # # #   #   #     # # #
# # # ### ### # ##### ######### ### # ################### ############### # # #
# # # #     # #   # #   #     # # # #                 # #         #     # # # #
### # # # ##### ### ##### ### ### ############# # ##### # ### # ### ##### ### #
#   # # #     #             #     # #         # #       # # # #         #   # #
### # # # # # # # # # ######### ### # ######### # ##### ### ### ############# #
#   # # # # # # # # #     # # #             # # #   #         #           # # #
# ####### ### ### # ##### # # # ######### ### # # ########### ######### ### ###
# #         # #   #     #     #   # #   #   # # #   # #     # # #     #       #
# # # # ##### # # # # # # ### ### # # ####### ####### ### ##### # #############
# # # # #     # # # # # # #     #   # #       # #             #         #     #
# # # # ##### # ######### ### ####### # ####### # ############# ######### ### #
# # # # #     #   #   # # #         #   #         # # #             #   # # # #
# ### ##### ####### ### ### ####### # ### ######### # # ######### ### ### # ###
# #   #                 #         # #     # #     #             #   # # # # # #
# # # # ### ### ### # # ### # ### # # ### # # ##### # # # # ##### ### # # # # #
# # # # #   #     # # #   # #   # #     #           # # # #     #     #       #
# ### ##### # # # # ### # # ##### # ### ####### # # # ### ##### # # ### #######
#   # #     # # # #   # # #     # #   #       # # # #   #     # # #           #
###############################################################################
