###############################################################################
#     #   #       # # # #                     #   # # #         #       # #   #
# # ### ### ####### # # # # ### ####### ######### # # ### ####### # ##### # ###
# #   # #     #   # #     # # # #     # #   # # #     # #   # # # # #   #   # #
### ### # ##### ### ##### ### ### ####### ### # # ##### # ### # # # # ### ### #
#   # #       # #   # # #       # #   #   #   # # #   #           #     #     #
### # # ####### ### # # # ####### # ### # ### # # # # # ################# #####
#   # # # # # #   # # # #         # #   # # # # #   # # #         #   # #     #
# ### # # # # # ### # # # ######### # ##### # # # # ### # ### # ### ### # #####
#   # #       # # # #     # #     #       # #     # #   #   # #               #
### # # ####### # # ### ### # ### # ####### # ####### ### ####### ######### ###
#     #       # #   #     #   # # # # #   # # # #             #     #   # # # #
# ### # ####### # ### ##### ### ### # # ### # # # ################# # ### ### #
# #   #   # # # # # # # #     # #     #         #   #       # # # # #     #   #
### # ### # # # # # # # # ##### # ##### ######### ### ####### # # ### ### # # #
#   #     # #   # # # # # #   # #     #     #         #     # # #   # # #   # #
##### ##### # ### # # # # # ### # ##### ##### ######### ##### # ### # # #######
#   # # # #     # # # #       # #       #   #           #         #           #
# ### # # ### ### # # # ####### # # ##### ### ##### ##### ######### ###########
# #     # #   # #     # #     #   # #           # # #   #       #           # #
# ### # # # ### # ##### # ##### ##### ##### ##### ### ### ##### # ### ##### # #
# #   # # #   #   # # #   # # #         # #         #   #     #     #     #   #
# ##### # # ### ### # # ### # # ######### # ### ##### ### ##### ### # ##### ###
#   # # #     #     # #   #   # #         #   #   # #         #   # #   # #   #
### # # ### ### # ### # ### ### # ##### ########### # # ##### ########### # ###
# #     # # # # #       #   #   #   # #               #     # #     #     # # #
# # ### # # # # ######### ### ### ### ########### # # # # ##### ##### ####### #
# # #           # #   #     #     # # #     # #   # # # # #           #       #
# ##### # ####### # ##### ### ##### # # ##### ####### ##### ########### #######
# # # # # #         #                     # # #   # #     #     #             #
# # # ### # ### ##### ########### ### ##### # # ### ####### ### # #############
#           # #       #     #   # # # #     # #   # #   # # # #             # #
####### # # # ### ### # ##### ##### ### ##### # ### # ### # # ############### #
#       # #     # # #             #       # # # #   #     # #     # # #   #   #
####### # # # ### # ############### ####### # # # ### ##### # ##### # ### # ###
#       # # # # #   #   #   # #   #           # #                         # # #
### ####### ### ####### # ### # ### ####### ### # # ######### # ########### # #
#   #                                     #       #         # #               #
###############################################################################
