###############################################################################
#       #                     # #   # #   # #       #   # # # #             # #
####### ### # ### ####### ### # ### # ### # ####### ### # # # ##### # # # ### #
# #   #     # #   #       #             #   #   #   #   # # # # # # # # # #   #
# ### ####### ####### ### ############# # ##### ### ### # # # # # # ####### # #
#   #   #     #   #   #   #   #     # # #   # # # #     # #   #   #   # #   # #
### # ########### ########### ##### # # ### # # # ### ### ### # ### ### ### # #
#           #         #       # #   # # # #   #       # # # #       #   #   # #
########### ######### ####### # ### # # # ### ##### ### # # ### ##### ### #####
#               #             # #         #   #     # # # #     #         #   #
############### # # ######### # ######### # ####### # # # ##### # ########### #
#     # #     #   # # # # # #         #   #   # #   #   #   #     # # #       #
# ### # ##### ####### # # # ##### ### ### # ### ### ### # ####### # # # ##### #
# #   #             # # #     # # #           #   # # # # # # #   #     # # # #
# ### ############# # # ### ### ### ######### ### # # # # # # ### # ##### # ###
# #   #                   # # # # # #         #   #   #   # # # # # # # #     #
##### ############### ### # # # # ########### ### ### # ### # # # # # # # #####
#                     #   # #   #       #       #     # #   #   #   # #       #
##### ################### # ### ####### ####### # ### # # ### ##### # # ##### #
#       #                 #       #   # #       # #       # #   #         #   #
### ##### ############# # ####### ### # # ### # ######### # # ##### ##### #####
#   #     #       #     #                 #   #     # #       #         #     #
# # ### ######### ######### ##################### ### ### ### # ########### ###
# # #   #   #         # #   #       #   #     # #   #   #   #         #   #   #
# # ####### ####### ### ########### ### ##### # ### ### # ##### # ### # ##### #
# # #       #     # # # #     # # #     # #                   # #   #       # #
##### # ### ##### # # # ##### # # # # # # ##### # # ### ####### # ##### ### # #
#   # # #         #           # #   # #         # # #         # #     #   # # #
### ############# # ######### # ##### ####### # ### ### # ####### ####### ### #
# #   # #   #       #           #     #       # #     # #       #     # #   # #
# ### # ### ##### ############# ######### # # ##### # # # ### ### ##### ### ###
# # #   #         # #         #     #   # # # #     # # #   # # #         #   #
# # ### ########### # ####### # # ##### ### ####### # # # ##### ##### ####### #
# #     #     # # # # #   #     #       #       #   # # #   #     #         # #
# ##### ##### # # # # # # # ### ####### # # # ##### # ### ### ########### #####
#               # # # # #   #   # #       # # #   # #   #       #     #       #
# # ######### # # # ####### # ### # # # ##### # ##### ##### ### # ### # ### ###
# # #         #             # #     # #   #         # #       #     # #   #   #
###############################################################################
