###############################################################################
#   #               # # #               #         #                         # #
# ########### ####### # ### # ### ####### ######### ##### # # ##### # # ##### #
# # #       #       #   #   #   #     #           #     # # #     # # #       #
# # ####### # ####### ### # ### # # ### ########### ########### ### # # # # ###
#   # # # #       #   # # #   # # #           #     # #   #   # # # # # # #   #
# ### # # # # # ### # # # ############### ##### ##### # # # ### # ##### # # # #
#   # # #   # # # # #     #   #         #       #   #   # #           # # # # #
# ### # # ####### # ####### ##### ######### # ### ### ######### ########### # #
# #   #   # #     #   #                 # # #   #       #   #           # # # #
# # ### ### # # ### ### ### ### # # # ### # # ### ####### ### # ####### # ### #
#   # # #     #         # #   # # # #     # #           # # # #       #     # #
# ### # # # ########### # ##### # # ### ### ### ####### # # ### ###############
# #     # #           #       # # # # #   #   #   # #         #               #
# # ### # ### ########### ########### ######### ### ### # # # # ####### #######
# #   # # # # #       #     #       #   #     #       # # # # #       #       #
# # ##### # ### ############# ######### ### ############# ####### # ##### #####
#   # # #   #       #       #   # #       #             #       # #   # #   # #
# ### # # ### ######### ##### ### ### # ### ####### ################### # ### #
# # # # # # #       #                 #   # #     #   #         # #     #   # #
# # # # # # # # ### ### ############### ### # ####### # ######### # ######### #
# #           # # # # #             # #         #   #     #     #             #
# # # ########### ### # ############# ########### ######### ##### #############
# # #   #         #     # #       #   #   #   #       # #   #   #           # #
# # ##### # # ##### ##### # ####### ### ### ### ####### # ### ### ####### ### #
# # # #   # #   # #                       # #                           #     #
# # # # ### ##### # ##### ################# # ### ##################### ##### #
#         # # # #       #                       #               #     #   # # #
### ### ##### # # ################################# ### # ####### ######### # #
#     # # #           #   # #     #   #           #   # #   #               # #
# # # # # # ####### ### ### # ##### ### ######### ########### ####### ##### # #
# # # #           #     #   #             #   # # #     #           #     # # #
# # ### ### # # # ##### # # ### ### ####### # # ### ### # ####### # ### #######
# #   #   # # # # #       #       #   #     #     #   #         # #   #       #
# # # # # ### ##### ### ### # ### # ### ########### ################# #########
# # # # #   #     #   # #   #   # #                               # #     #   #
# # ### ######### # ### # ########### ### # # ######### ####### ### # ##### ###
# #   #         # #   # #           #   # # #         #       #     #         #
###############################################################################
