###############################################################################
# #         #     #         #   # #     #             #     # # #             #
# ######### ##### ##### ####### # ### ### ### ##### ### ##### # # ######### # #
# #   #     #       # #     #   #   # #     #     #   # #         #   #   # # #
# ### ##### ##### ### ### ##### # ### # ##### ######### # ######### ### #######
# #   #   #     # # #   #   # # #   # #     #   #                 #     # # # #
# ### ### ##### # # ### ### # # # ### # ######### ### # ############# ### # # #
# # # #         #   # #     #   # # #   #           # #         #   # #       #
# # # # ####### # ### ### ##### # # # # # ##################### ### # # #######
# # # # # #   #     #   # # #   # #   #         # #     #     #     # # #   # #
# # # ### ### ### ### ### # ### # # # ### ####### ### ### ########### # ### # #
#   #   # # #   # # # #   # #       #   #   # # # #   #           #   # # # # #
### ### # # ### # # # ### # ### # ########### # # # ##### ######### ### # # # #
#     # #   # # # #   # #       #         # # #   #   #       # # #   #   # # #
# ### # ### # # # ### # # ############### # # # ### ### ####### # ### # ### # #
# #     # #         #   #   # #       # # # #   #         #           # # # # #
# ##### # ######### # ### ### ### ##### # # # ### ######### ########### # # # #
# #               # # #         #       # #   #     #   # #                 # #
##### ########### # # ### ######### ####### ### ### ### # # ################# #
# #   #         # #   #               # # #   #   #   # # #   # #     #       #
# ############# # ### ### ########### # # # ### ##### # # # ### # ##### ##### #
#       #     # #     #     # #     #   # # #       #         #             # #
####### ##### # # ### # ##### # # ####### # # ##### ########### ### ##### ### #
#         #     # #   # #       # # # # #         # #     #   #   #     # # # #
######### ##### ##### # # ##### ### # # # # ########### ### ### ########### ###
# #   #     # #               #   #       #                       #         # #
# ### # ### # ####### ######### ### ############# ### ##### ####### # ####### #
#     # #       #   # # #     # #     #     # #     # # #     #     #         #
##### ### ##### ### # # # ### ### ##### ##### ######### ### ### # # ### ### ###
# #   #   #     #     #   # #                 # #   #   # #     # #   #   # # #
# # ########### # ### ### # ################### # ### ### ##### ##### # # # # #
#     #           #     #     #           #           #       #     # # # #   #
# ### ######### ### ### # ##### ##### ####### ######### ########### ####### ###
# #             #   #         #     #   # # #   #   #         #   # #         #
### ##### ####### ##### # ##### ### ##### # # ### ### # # # # # ####### # ### #
#   #     #       #     #   # #   #               #   # # # # #   #   # # #   #
### # ############### # # ### # ##### ######### ### ##### ##### ### ##### ### #
#   # #               # #           #         #         #               # #   #
###############################################################################
