###############################################################################
# #             #           # #     #     #   # # #   #     #   # #   #     # #
# ##### ### ######### ##### # # ######### ### # # ### ##### # # # # ####### # #
# #     #   #     #   #   # # # #     # # #     #     #   #   # # # # # # #   #
# ######### # ### ####### # # # ##### # # ### ### ####### ### ### # # # # ### #
# #       #   # #   #           # #             #   #     #   # #     # # # # #
# ####### ##### # ### ##### ### # ############# ### ##### ### # # ##### # # # #
# #                   # # # # # # # # # # #   #     # #   # # #     #   # #   #
# # # # ############### # ### # # # # # # ### # ##### ### # # # ##### ### ### #
#   # # #                 #     #   # # # # #   # #     #   #         #     # #
# ### ########### ##### ####### # ### # # # # ### ##### # ##### ####### ##### #
# #   #             #   # #     # #           # # #   #     # #   #   #   #   #
# ### ##### ########### # ### ### ##### ##### # # # ### ##### # ### ### ##### #
# # # #     # # #   # # # # #   # #   # # #   #   #   # # # # #   #   #   # # #
### ######### # ### # # # # # ### ### ### ### # ### ### # # # # ### ##### # # #
#   # # #             # # # #     # #   #   #             # # # #     # # #   #
# ### # ####### ##### # # # ##### # ### ### # ### ######### # # # ##### # ### #
#   #   # #     #         #       #   #     # #     #   # # #     # #     #   #
### ### # ######### ##### ##### ### # ##### ##### ### ### # # ##### # ##### ###
# #   # #   #       # # #   # #   # #             # #       #   #     # #     #
# ### # ### ### ##### # ### # # ######### ####### # ####### # ### ##### # ### #
#     #         #     #           # # # # #   # #   #   # #       #         # #
##### # # ########### ####### ##### # # ##### # ### # ### # ####### ###########
# #     # # # #     # # #     #   # #   # # # #       #   #                 # #
# ##### ### # ### # # # ##### # ### ### # # # ####### ### # ### ### # # ##### #
# #     #     # # #     #       #   #         #   #       #   #   # # #   # # #
# ######### ### # ##### ####### ### ######### # # # # ### # # ##### ### ### # #
# #       #   # # # #         # # # # # #   #   #   # #     # #   # # #       #
# ####### ### # ### # # # ### # # # # # ### ############# ##### ##### ##### ###
# # # #     #         # # #       # #   # #   #             #           #     #
# # # ##### # # # ##### ######### # ### # ### ########### ##### ############# #
#   # #       # #     # #   #   #           #       # # # # # #             # #
### # ################# ### ### ### # ##### ####### # # # # # # ######### ### #
#                 #     #           #   # # # # # #   #         #       #   # #
### # # ### ##### ### ########### # ##### # # # # ### # ######### #############
#   # # #   # #   #   #           # #     # # #   #                   # # #   #
##### ### ### ### ### ######### # ####### # # ### ### # # # ### # ##### # # ###
#     #   #           #         # #                   # # #   # #             #
###############################################################################
