###############################################################################
#   #               #               # #                           # #         #
### # # ##### ##### ####### ####### # ##### # # ### ### ######### # # #########
# #   # #     #             #       # # # # # # #   #   #       # #   #   # # #
# ########### ######### # ### ### ### # # # # # # ### ######### # # ##### # # #
#   #   #     #   #   # # # # # #   # # # # # # # #   #   #     # # # # # # # #
### ### ######### ### ##### # # ### # # # ########### ### ##### # # # # # # # #
#         #                 # #   #   # # # # #       #         # # # # # # # #
####### ################### # # ##### # # # # ################# # # # # # # # #
#       #     #   #           #     # #     # #   # #   # # #       # #       #
### ### ##### ### ### # ##### ##### # ##### # ### # ### # # ####### # # #######
# # #     #   #       #   #   # #                 # #   # # #       #   # #   #
# # # ### ### ######### ##### # ##### ########### # ### # # ##### # # ### # ###
# # # # # #   #     #     # # #       #                     #     #     #   # #
# # ### # # ####### ####### ######### # ############# ### # ########### ### # #
# # #         # #     # # #           # #       #     # # #   # # # #   # # # #
# ### ####### # ##### # # ########### ######### ####### ### ### # # # ### # # #
#     #     # # #     # # #   #       #   #             #   # #   # # #   # # #
# ######### # # ##### # # # ########### # ####### ##### ### # ### # # # ### # #
# #             #   #   # # # # #   # # #   # #   #         #         # # # # #
### ##### # ### ### # ### # # # ### # ##### # ####### # ### # ####### # # # # #
#   #   # # #                 #   #     # # #     # # # # #   # # #   # #   # #
# ##### ########### ######### ### ##### # # ##### # ### # ##### # # ### # ### #
# # #               # #       # # #   # #               #             # #   # #
# # # # ### # ##### # ####### # # ### # ##################### ### # # # # ### #
# #   # #   # #     #           #                   #   #     #   # #         #
# # # # # ##################### # # ##### ### ##### ### ########### # # # #####
# # # # # #                       #   #   #   #           #         # # #   # #
####### ####### ################# # ##### # # ##### ##### ########### # # ### #
#       #       #     # #         #   # # # #   #   #                 # # # # #
################# ### # ######### ### # ########### # # ################# # # #
# #   # # # # #   #                 #   #           # # #     #   # #   # #   #
# # ### # # # ##### ####### ### # ### ### ### ##### ######### ### # ### # # ###
#               #   #       # # #   # # # #   #     #       # # #   # # # # # #
# # ### ### ### ############# ### ### # ### ########### ### # # ### # # # # # #
# # #   #   #         #           #   #   #   #       # #     # # #       #   #
### # ### ##### ##### # # ### # ######### # ### # ### ####### # # ##### # # ###
#   # #   #     #       # #   #     #         # # #                     #     #
###############################################################################
