###############################################################################
# #   #     #         # #     #       #           # # #   # #     # # #     # #
# ### ### ##### ##### # ### # ####### ##### ####### # ### # ### ### # ##### # #
#         # #   #   #     # #   # #             #   #   #   # # # #     # #   #
######### # ####### # ### ##### # ####### ### ##### ### ### # # # # ##### ### #
#   #         # #       #   # #       #   #     # # #         # # #   #   # # #
# ########### # ########### # ####### # ### # # # # ######### # # # ##### # # #
# # #   #   #   #   # #     #         #   # # #     #     # #       #   # #   #
# # ### # # ### ### # ##### ######### ####### ##### ##### # ####### ### # # # #
#   #     # # #     #   #                       #   #     #   #   # #     # # #
# # ####### # ##### ### ####### ####### # # # ##### ##### ### ### # # ##### ###
# #     # #       # #     #     #   # # # # # #     #   #         # # #   #   #
####### # ### ### # ##### ######### # ####### ##### ### ######### # # # ##### #
#             #     # # # #     #   # #   # # #   #     #     #         # # # #
##### ############# # # # ##### ### # ### # ##### ### # ##### ######### # # # #
#     # #     # #   #       #   #     #       # #     # #   # #     #         #
# ### # ##### # ### # ##### ### ### ##### ##### ### ### ### # # ####### #######
# #   #             # #                   # # #     #     #   # #     #       #
######### ####### # ################# # ### # ########### ### # ##### # ##### #
#   # #   #       # #           #   # #   #     #     #   #   #       #   # # #
### # # ### ####### ########### ### ##### ##### ##### ### # # # ##### # ### # #
#       #   # # #             #   #   # # #   #   #         #   # #         # #
####### ##### # ### ##### ### ### ### # # ### # ######### # ### # # ### #######
#       # #       # #     #     #         # #   #       # # #   #     #       #
######### ####### # ##### ##### ### # ### # ### ####### ##### ##### ### # #####
#   # #               #   #       # # #       #   #   #       #       # #     #
# # # ############### ##### ### # ##### # ### # ##### ####### ##### # # # #####
# #             #     #     #   #       # #     # #           #     # # #   # #
### # ######### # # ####### ##### ######### ### # ### ##### # # ### # # # # # #
#   # #     #     #   #     # #   #         #         #     # #   # # # # #   #
### ####### ##### ##### # # # ##### # # ### ##### ### ### ### # ### # ### # # #
# # #       #         # # # #       # # #   #     #     # #   #   # #   # # # #
# ######### # # # ############### ####### # # # # # # # # ### # ####### # ### #
#   #         # #   #   #   #     #       # # # # # # # # #   # #     # #   # #
# # ### ##### ######### ### ### # # # ############# ##### ### ### ### # ##### #
# # #   #     # #       #   # # # # # #                 # # # # # # #       # #
# ##### ##### # # # # # ### # ### ### # # # ####### ### # # # # ### # ### # # #
#         #   #   # # #           #   # # # #       #   # #       #   #   # # #
###############################################################################
