###############################################################################
# # #         #         #   #   # #   #           #   #   #   #               #
# # ######### # ########### ### # ### # ##### ##### ### ### ### ##### # # ### #
#   # #   # # #               #             # #           # # # #   # # #   # #
### # ### # # # ########### ######### ######### ### # # # # # # # ### #########
# # #     # # # #   # # # # # #     # #     #     # # # # #   #   # # #       #
# # # ##### # # ### # # # ### ##### # # ##### # ######### # ### ### ######### #
# #   #     # #   # # #     # #     #         #   #     #         #   # #     #
# ### ##### # # ### # ### ### ##### # ############# ############### ### ### ###
# # #       # # # # # # # # #   # #                   # #     # #   # # #   # #
# # ### ### # # # # # # # # ### # # ### ##### # ####### ##### # # ### # ### # #
# # #   #   # #     #   #   # # #     #   # # #     #     # # #       #   #   #
# # ####### # # ####### ### # # # ### ##### ########### ### # # # ####### # ###
# # #   #   #   # #   # #           #   # # # # #   # #   #     # # #         #
# # ### ### # ### ### # # ############### # # # # ### # ##### ##### # # ### ###
# #       #     # # # #                 # # # #   #   # # # #     # # # #   # #
# ####### ### ### # # # ### ############# # # # ### ### # # # ##### # ##### # #
# # #   # # #     #   #   #   # #   # # # #   #   #   # #   #     # # # #   # #
# # ### # # # ##### ### ####### # ### # # # ### ### ### ### # ##### ### ### # #
# #     # # #     # #   # # # # #     #     # # # #     #         #   #   #   #
# ##### # # # ##### # # # # # # # ####### ### # # # ####### ######### ### # ###
#       # #       # # # # # # # #     # # # #   #       # #   # # # # #       #
### ### # # ### ### # ### # # # # ### # # # # ### # ##### # ### # # # ##### ###
#   #       #         #     # # #   #   # #       # #     #   #       #     # #
############### ####### ##### # # ####### # ######### ##### ### ####### ### # #
#             #   # # # # # # #   # #   #   #   # #   #   # #   # #   #   #   #
######### ### ### # # # # # # ### # # ### ### ### # ### ### # ### ### # ##### #
#         #         #   #               #   # # # # #   #           #       # #
##### ####### ##### # ##### ### # ##### ### # # # # ### ### # ### ### #########
#     #     # #     #         # #     #           # #       #   #             #
# ### # # # ####### # # # ##### # # ############### ### ### ######### ### # # #
# #   # # #         # # #     # # #                     # #         #   # # # #
######### ### ### # # ### ########### # ################# ####### ##### ##### #
#     # # # # #   #     #   #   #   # # #   #       #         # # #   #   #   #
# ### # ### ######### # ##### ### ####### # # ####### # # ### # ### ######### #
# #   #               # #       #         #           # # #     #   #     # # #
# ### ########### # # # # ##### # ##### ##### ### ################# # # # # ###
#   #             # # #       #       #   #   #                       # #     #
###############################################################################
