###############################################################################
#     #   #   # #     #     #         # #   #             #     # #   #       #
##### ### ### # ##### # ##### ##### ### # ############# ### ##### ### ### # ###
# #         # # #       #   # #       #   #       # # # # # # # #   #   # #   #
# ####### ### # ####### # ### # ### ### ######### # # # # # # # ### ### ##### #
# #     # # # # # # # #       # #     # #   # #     # # # # #   # #     # # # #
# ##### # # # # # # # # ############# # ### # # ### # # # # ### # ##### # # # #
#     #           # #   #       #     #   # # # # # #   #     #     # #     # #
# ######### # ### # ########### ##### ### # # ### # # ##### ####### # ##### # #
#     #     # #       #             #   # #   # # # # #         #     # # # # #
##### ######### # ### ##### ##### ### ### # ### # # # ####### ### ##### # # # #
#     #         # #         #   # #       # # # # # #   # #   # # # # # # #   #
##### ### ####### ### ### ### # # ##### ### # # # # ### # ### # # # # # # ### #
# #   # # # # # # #   # # #   #     #       # # # # # # # #   # # #   # # # # #
# # # # ### # # # ##### ######### ### ##### # # # # # # # ### # # # ### # # # #
#   #           # #       # #   # # # # # # # #   # # #   # #     # # #     # #
####### ####### ####### # # # ### # ### # # # ### # # # ### ##### # # # ##### #
# #     #         # #   #       # # #   #     # # # # # #       #   #     # # #
# ### ### ####### # ########### # # ### ##### # # # # # ####### # ### ##### # #
#     # # #     #     # # #   #     # #   #       #   #   #     # # # #   #   #
# ### # ####### ##### # # ### # ### # ### ### ### ### # ##### ### # # # ### ###
# #   #     #   # #   #     # # #   # # # # # # # #     #   #       # #   # # #
# ######### # ### ### ##### # ##### # # # # ### # ##### ### # # ##### # ### # #
#     # #     #     #   # #     # #     #             # # # # # # # #   # # # #
####### ##### ##### ### # ##### # # ### # ######### ### # # # ### # # ### # # #
# # #   #         #     # # # # #   #     #   # #                 # #   #     #
# # ### ##### ### ##### # # # # ### # ### ### # ############### ### # # # #####
#             #                 # # # #   #     #       # #         # #   # # #
# ##### ### ##### # # # ####### # ### ### # # # ####### # ####### ### ##### # #
# #     #   #     # # # #             #   # # # #   #   # # # #   #   # # #   #
### # # ##### # # ### # ##### # ### # # # # ### ### ### # # # # ##### # # # ###
#   # #   #   # # #   # #     #   # # # # # #           #     #   # # #     # #
####### ############### ####### # ####### ######### ### ##### ### # # # ##### #
#       #   #           # #   # # #       #         #           #           # #
# ### # # # ### ##### # # ### # # ### # ##### ################# # # # # # ### #
# #   # # #     # # # # #   # # # #   # #       #       # #       # # # #   # #
##### ### # ##### # ##### ### ### ####### # # ##### ### # ####### # ######### #
#     #   #   #                     #     # # #     #             #           #
###############################################################################
