###############################################################################
#                       # # #             # #     #                       #   #
# ### # ##### ### ####### # # ############# # ### # ####################### # #
# #   # #       #         # #       #           #                     # #   # #
# ### # # ### # # ### # # # # ####### ######### # ##### # ##### ####### # # # #
# # # # #   # # # #   # #   #         #       # #     # #   #             # # #
# # # # # # ### # ### ####### ### ##### ### ### ### # ##### ####### ### ##### #
# #   # # #   # # #             # # #     #   #   # #     #     # #   #   # # #
# ### # ### # # # ### ### ######### # ########### # ####### # ### ######### # #
# #   #   # # # # #     #           # #   #   # # #       # #               # #
####### # ####### # # # ### # # ##### # ##### # # # ### ######### ### #########
#       #   #     # # #   # # #           # #   # #   # # #     #   #         #
# # ### # ####### # ### ### # # # ### ##### # ### ### # # # ##### # ### #######
# # #   #     #   # #     # # # # #             # #   #   #     # #   #   #   #
### # ####### ### ##### # # # # # # ##### ########### # # # ### # ### ####### #
#   # #         #   #   # # # # # #     #           # # #     # # # #     #   #
# # # # ##### ### # ### ##### ##### ### ##### # # ################# ### # ### #
# # # # # #   # # #   #   #   # #     #     # # #     #           #   # #     #
# ####### # ### ##### ##### # # # ### # # ######### ### # ##### ### ####### # #
# #   #             #     # # #     # # #   #   # #   # #     #         # # # #
# # # ### # # # ####### ##### ### # ### ##### ### # ### # ##### ##### ### #####
# # # #   # # #     # # #       # #   #           #     #     #     #         #
# ### ### ### # # # # ##### # # # # # # # # ####### ##### ### # ### ####### # #
# #         # # # # #       # # # # # # # # # #   #   #     # #   #     #   # #
# # ####### # # ##### # # # # # ##### # # # # # # # ######### # ###############
# # #       # # #   # # # # # #   #   # # #     # #         # #               #
# ### # # ### # ### # ### # ### ### # ####### # ### # ### ### ### ### ### #####
#   # # #   # #     #   # # #   #   # #     # # #   # #     # # #   # #       #
# # ### # # ### # ########### # ##### ### ####### ##### ####### # #############
# #   # # #   # #         #   #   # #           #     #         # #   #       #
# ##### ### ##### ##### ### ### ### # # ####### # ### # ####### ### ### ### ###
# #     #       #     #   # #     #   #       # #   # #   #         #     # # #
##### # # # # # ####### # # # # # ### ### # ##### # ##### ### # ####### ##### #
#     # # # # #     #   # # # # # #   #   #   #   #     #   # #   #     #     #
# ##### ### ##### ### # ##### # # # # # ##### ### ### ####### # ### # # # #####
# #     #     # #   # #   #   # # # # #     #   # #     #   # #     # #       #
# ### ### # ### # ### ####### ####### # ### # # ##### ### ####### # # #########
#   # #   #     #   #     #     #     #   # # #   #             # # #         #
###############################################################################
