###############################################################################
#                     #   # #                       #                         #
######### ##### # ##### ### # ####### ### # ######### ### # ##### # ###########
#           # # #                   #   # #           #   #     # #     #   # #
# ### ### # # ### ##### ############### # ### ####### ### ### # # ####### ### #
# #   #   #   #       #               # #   #     # #   #   # # #   #     # # #
# ### ### # # # # # # ##### ### # ##### ##### # ### # ############# # ### # # #
# #   #   # # # # # #     # #   # # #       # #   #           #         #     #
# ### ### # # ##### # # ##### ##### ### # ##### ####### ######### # ### # #####
# #     # # #     # # #   # #   # #   # #     # #     #       #   #   # #     #
##### ### # # ### ### ### # ##### # ### ######### ### ### # # ### # ### # ### #
#     #   # #   #   # #   #   #     # #           #     # # # #   #   # #   # #
# # # # ### ##### ##### # # ### ##### ##### ### ##### ### ### # ### # # # ### #
# # # #   # #     #   # #                 #   #   #     # #   #   # # # #   # #
# ### ########### # ### # ### ##### ### # # ### # ### ### # ### # ### # # # ###
# #             #     # # #     #     # # #   # #   # # # #   # #   # # # # # #
# # # ########### ################# ####### # # ### # # ####### # # # ### ### #
# # #       #           #         #       # # # #   #         # # # # #       #
# ##### # ####### ### # # ### ### ### ### ### ### # ####### ####### ### # # ###
# #   # #       # # # #     #   #   # #     # #   # #   # #     #   #   # # # #
##### # ##### # ### # # # # ### # # # # ### ######### ### ### ### ##### # ### #
#           # #     # # # #   # # # # #   #   #   # #       #   #     # #     #
# ### ##### # # # ### # # ##### # ### # # # ##### # # # ########### # # # ### #
# #       # # # #   # # #     # # # # # # #   #       #     # # # # # # #   # #
##### ### ##### ####### ### ### ### # # # ### # ######### # # # # ##### ### ###
#   # #       #   #   #   #   # # # # # #   #           # #         #     #   #
### # # ### ### ### ##### # # # # # ### # # # ##### ######### #################
#     #   # # #       # # # # #     # # # # # # #       # # # #         #   # #
# # ### ##### ####### # # ##### ##### # # # ### ### ##### # ### ##### ### # # #
# #   #             # # #     #       # # # #     #       #         #     # # #
# # # ### # # # # # ### ################# ### ##### ######### ##### ### ### # #
# # # #   # # # # #           #   # #   #       #     # # #       #   #   #   #
# # # # ##### ### # ##### ##### ### # ### ### ######### # # ####### ### ### ###
# # # # #       # #   #                 #   #           #         # # # #     #
# # ### # # # # # # # ### ### ##### ############# ### ### # # ##### # ##### # #
# # # # # # # # # # # #     #     #             #   #     # #     #       # # #
# # # # # ### ### # ### # # ### ############### ##### ################# #######
# # #   # #     # #   # # #   #               #     #                 #       #
###############################################################################
