###############################################################################
#   # #           #       #   #     #       #                             #   #
### # ########### ##### ##### ##### ##### ##### ########### # ### # ######### #
# #       #   #   #   # # #     # # # # #   #     # #     # #   # #         # #
# ##### ##### # ##### # # ### ### # # # ### # ##### # ##### ######### ### ### #
#   # #       # #     #     # # #                     #   #     #   # # #   # #
### # ### ### # ##### ##### # # ####### ### ####### # # ######### ##### ##### #
#   #     #       #     #   #             #       # #                         #
# ##### # # ##### # ### ### ####### ### # # # ### # ##### # # ### # # ####### #
#       # # #   #   # #   #   #     #   # # #   # #     # # #   # # #       # #
# # # # ####### ##### ### # # # ##### ### # ####### # # ### # ##### ### ##### #
# # # # #                   #   #       # #       # # # # # #   #     #     # #
### ########### # ### ### # # # # ### ##### ### # # # # # ############# # # ###
# # #     #     # #   #   # # # #   #   #     # # # # #         #     # # #   #
# ### ### # # # # # ### ##### # # # # ### # # # # # # ### ### ### ####### #####
#     #     # # # # #   #     # # # #   # # # # # # #   # #           # # #   #
##### ### # ### ####### # ##### # # # # ####### ######### ############# ### ###
#     # # # #   # #     #   #   # # # #       # # #     #                     #
##### # # ### ### ##### ######### ####### # ##### # # ############# ######### #
#       #   # #     #   #               # #         #     #   #   # #   #   # #
# ############### # ### ####### # # # # ### ####### ### # # ### ##### ##### # #
# #               #     #       # # # #   #       # #   #           #     #   #
# ########### # ############### # # ### # # # # # ##### # ########### #########
# #         # # #   #     # #   # #   # # # # # #   #   #         #       #   #
####### # # # # # # # # # # ##### ### # ####### # ### ### ##### ### ### # # ###
#       # #   # # #   # # #         # #   #     #   #   # #   #       # #   # #
# ####### ##### ##### ### # ### # # ### # # ### # ##### # # ### ### ####### # #
# #   # # #     #     #     # # # #   # # #   # # #     #     #   #   #   #   #
##### # ####### ######### # # # ### # ####### # ### ### # ##### # ### # ##### #
#     #   # # #   #       # #   #   #       # #   #   # #     # #   #       # #
# ### ### # # ########### # ### ####### ### # # ##### # ### # ### # # ##### ###
# #     #                 # #         #   # # #   #   #   # # #   # #     # # #
# # # # # ### ##### # # # ### # # # # # ### # ##### # ### # ####### # ### # # #
# # # #   # # #     # # # #   # # # # #   # #   #   #   # #   #     # #   #   #
# ##### ### ####### ### ### ####### ### ##### ####### # # ##### ##### # # ### #
# #     # #         #     # #       #       #     #   # #   #   #     # # #   #
# ####### ######### ### # # ### ### # ####### ### # # # ####### ##### # # # # #
# #                   # # #   # #   #       #   # # # #     #     #   # # # # #
###############################################################################
