###############################################################################
#                 # #                             # #   # #   #   # #     #   #
# ##### ### ### # # # # # ####### # ### # # # # # # ### # # ### ### ##### ### #
# # #   #   #   #     # # # # #   # #   # # # # #   #   # #   #   #   #   #   #
### # ### # # ### ##### # # # ####### ##### # # # ### ### ### # ##### # # # # #
# #   #   # # #   #   # # #   #       #     # # # #     #       # #   # # # # #
# ##### # ######### # ####### ######### # # ##### ### ######### # # ##### # ###
# #   # # #     # # #                   # # #   # # # #     # #   # # #   #   #
# ### ######### # # ########### ######### ##### # # # ##### # ### # # ### # ###
#       # # #       #     # #   #   #   # #   #       # #   # # # #   #   # # #
# ### ### # ########### ### ### # ### ####### # ### ### ### # # # # ##### # # #
# #               #     # #   # # #     # #   # #           # #   #   #   # # #
### ############# # ### # ### ### ##### # ### ####### ####### ### ### ### # # #
# # #     # # #     # #   #             # #   #           #       # # #       #
# ####### # # # ##### # ############### # ### ####### ### ####### # # # #######
# # #     # #   #       #       # # #   #         # #   # #         # #       #
# # ##### # # # ####### ####### # # ### ######### # # ############# # # #######
#         # # # #   #   # # #       #           # # #     # #   #     # # #   #
# ####### # ####### ### # # ### ### ########### # # ### ### ### ### # # # # # #
# #                           # # #     # #     # # # # #     # # # #     # # #
### ### ##### ##### ### ### ##### # ### # ##### # # # # # ##### # # ### ### ###
#     # #     # #   #   #           #           #   # # # # # # # #   # #   # #
# ######### ### # # # ######### # ############# ### # # # # # # # # ##### ### #
#   # #     #   # # # #         # #                   # # # # #     # #     # #
##### ####### ########################### # ######### # # # # ##### # ### ### #
#   #               #   #         # #   # # #       #     #   # # #     # # # #
### ######### ##### ### # # ##### # # ########### ##### ##### # # # ##### # # #
#           # #     #     # # #             #   #       #   #   # # #   # #   #
### ####### ### ### ##### # # ############# ### ##### # ### # ### # # ### # ###
#   #         # #         # #       #                 #   #   #   #   # #     #
# # ######### # # # # ### ##### ### # ########### ####### ### # ### ### # #####
# # #       # # # # # #   # # # #   # #           #   #         # #   # #     #
### # ##### # # ##### ##### # ##### ####### ######### ######### # ### # ### # #
#   #   # #     #   # # # #   #   #   # # # #                               # #
# # # ### # ##### ##### # ### ### ### # # # ######### ##### ### # ##### #######
# # # #       # #           #             # #         # # # # # # #         # #
# ########### # ### ####### # ##### ##### ### ### ### # # ### # ### # # ##### #
#   #         #     #         #     #         #   #   #           # # #       #
###############################################################################
