###############################################################################
#   #       # #       #   #     #     # #   #         # #   #     #   #   #   #
# ##### ### # ### ##### ####### # ##### # ##### # ### # # ####### # ### ### # #
# # #   #       #           # #               # #   # # # #     #   # # # # # #
# # ####### ### # ########### ### ########### # ### ### # # ##### # # # # ### #
# #         # #   # # # #   # # #     #     # # # # # # #   #   # #     #     #
# ########### ### # # # # ### # # ##### ### ##### # # # # ##### ####### # #####
#       #   # #     # # # #   #       #   # #   #   #       #     #   # #   # #
### ### ### # # ##### # # ### # ####### # # ### # ##### # ### ##### ### # ### #
#   #       # #         # # # #   #     # # # #   #     #               #   # #
# ######### # ### ####### # # # ### ######### ### # ######### # # ####### # # #
# #   #           #     #   #   # #     # #   # # #         # # #         #   #
# ### ######### ### ##### ##### # # ##### # ### # # ####### ####### # # #######
# # # # # #   #   # # #   #   #       # # #   # # #       #     #   # #   # # #
### # # # ### # ### # ### # ### ####### # # ### # # ####################### # #
# # # # # #       # # # # # #   #   #   #   #         #   # # # #   # # # #   #
# # # # # ##### ### # # # # # ### ##### # ##### ####### ### # # ### # # # # ###
# # # # #     #   # # # # # # #   #   # # # #   #     #       #     # #       #
# # # # ##### ### # # # # # # # ##### # # # # ##### ####### ### ##### # ### ###
# # #   # # #   #   #               # #     # # #   #   #   # #   # #     #   #
# # ### # # ### ### # ############### # ##### # # # # ### # # # # # # ##### ###
# #     #     #   #       #     # # # #       #   # # #   #     # #       #   #
# ### # ##### # ### ######### ### # # # ####### ### # ### ### ### # # ##### # #
# #   #     #   #         # #         #   #       # #     # #   # # #     # # #
# ### ### # # # # # ### # # # # ####### ### ######### ### # # ####### #########
#     #   #   #   #   # #     #             #         #   # #   #         #   #
######### # # # # # ##### # # # # # ### ##### ############# ### # ######### ###
#         # # # # # #     # # # # #   #           #     #     #         #   # #
##### ##### ### # # # # # # # # ##### ### ##### # # ##### # ### ####### # ### #
#   # #     #   # # # # # # # #   # # #       # #         #   #       #   #   #
# # ############# # # # # ####### # ##### # # ############# ####### ####### ###
# #               # # # #       #   #     # #           # # #     #     # #   #
# ##### # ##### ### # ##### # # ##### # # ####### # # # # ### # # ####### # ###
# #     # #       # #   #   # #   # # # #       # # # #   #   # #       #   # #
# ##### ### # ### ### ####### ##### ######### # ### # ##### # ##### ##### ### #
#   #   #   #   #   #     #   #             # # #   #       #   # #           #
# ####### ### ##### # ### # ### ##### # ######### # ######### # # # ######### #
#       # #   #     # #   #         # #     #     #       #   #   #     #     #
###############################################################################
