###############################################################################
#   # #           #         #   # # # # # # #       # # # #               #   #
### # ### ### ##### ######### ### # # # # # ### ##### # # # # ### ####### ### #
#   # # # # # # #         #   #     #     # #       # # # # #   #     # # # # #
### # # # # ### # ######### ### ### ### ### ####### # # # # ########### # # # #
# # # # # # # #             # # # # #   # #     #       # #           # #   # #
# # # # # # # # ### ######### # # ### ### # # ### ####### # # ####### # ##### #
#   #   #   #     # #             #     # # #   # #         #       #   #   # #
### ### # ### ######### ####### ### ##### # ##### # # ######### ##### # ### # #
# #   # # # #   #     #       #   #   # #     #     #         #     # #   # # #
# ### # # # # ### ### # ### ### ### ### ### ##### ##### ### ##### ######### # #
#   #   #       #   #   # # #   #     # #     #       #   #     #             #
### ### # ####### ####### ####### ##### ##### ##### ### ##### # ##### ##### ###
# #   #           #       #   #   # #   # # #       #     # # #     #     #   #
# # ### ####### # # ####### ### ### ### # # # ############# ### ####### ### ###
# # # # #   # # #   #     #   #       #   #     # #       #   #       #   #   #
# # # # # ### ####### ##### ### ### ### ### ##### # ####### ##### # # ### ### #
#     # #       # #   # # # #   # # #   #     #   #         # # # # #   #   # #
### # # # ### ### # ### # # ### # # # ### ### # ### ######### # ### # ##### # #
#   #       # # #   #           # # #       #   # #         #     # #   #   # #
# # # ######### # ### ##### # ### ##### ### ##### # # ####### ##### ### ### # #
# # #             #       # # #       #   # #     # #   # #       #   #   # # #
# # # # # # ####### ########### # ##### ##### ##### # ### # ####### ### ### ###
# # # # # #   #               # # #     #           #       #     #   #   #   #
### ### # # ### ##### ### ##### ### ##### ######### ##### ### # ### ### # ### #
#   #   # #   #     #   #       #   # #     #   # #   # #     #   #   # #   # #
####### ### ### ####### ##### # # ### # ##### ### ##### # ### ### ### ### ### #
#       #         #   #   #   #   #       #             #   #   #   # #   #   #
##### ### # # # ### # # ####### ### ##### # # ### ####### ### ### ####### ### #
#     #   # # #     # # #     #         # # #   #       #   # #         #   # #
# # ### ### # ### ##### # # ### # # # ##### ### ####### ##### ##### ####### # #
# # #   #   #   # # #     #   # # # #         #       #     #     # #     # # #
# # ##### # # # ### ### ##### ### # # ### # ### ### ####### ####### # ##### # #
# #   #   # # #       #   #     # # # # # #   #   #       # # # # #   #     # #
# ##### # ### ### # # ##### # # # # ### # # # ### ##### # # # # # # ####### # #
# #   # # #     # # #   # # # # # # #   # # #   #     # # #       #       # # #
# # # # # # # # # ####### ### ### # ### # ### ### ####### ### # ### ######### #
# # #   # # # # #         #     # #     #   #   #     #     # #   #       #   #
###############################################################################
