###############################################################################
#     #         # #             #       #   #       # #         #   # #     # #
### # ### # # ### ########### # ####### ### ####### # ##### # # # ### # ##### #
#   #     # #   #     #       #               # #   #       # #               #
##### # ####### ##### ##### ############# ### # ### ### # ### # # ### ### ### #
#     # #             # #     #             #           # #   # #   #   #   # #
####### ### # # # # # # ######### ##### ########### # # # # # ### # ##### # # #
#   #   # # # # # # #             #     # #         # # # # #   # #     # # # #
### # ### ### ####### ### ##### ### # ### ####### # ### ##### # ### ######### #
#     #       # #       # #     #   # #         # # #       # #   #     #   # #
### # # ### ### ### # ### ######### ####### ### ####### # ##### # # # ### # ###
#   # # # # #       # #   #           # #     #         #   #   # # #     #   #
# # ### # # ##### # ### ########### ### ### ##### ##### ##### # # # ### # #####
# # #   #   #     # #       # #     #       #         #     # # # #   # #     #
# ####### ### ############### ############# ##### # # # # ##### # ### # #######
# # #     #     #         #       #         #     # # # #   #   # # # # #     #
# # ##### ### ### # ### # ####### # ### # # # ##### # # # ### ##### # # # #####
#   #   # # #   # # #   #           #   # # # #     # # # #         # #       #
####### # # # ### ### ##### ########### ### ### # # ### # # # ### ### ##### # #
#       # #     # #   #     #       #     # #   # # #   # # # # #   #   # # # #
####### # ### ####### ############# ##### # # ##### # # # # # # ### ##### ### #
#         #   # #   # #             #     # # #     # # # # #     # #         #
# # # # # ### # ### ##### ### ### # # # # ####### ##### # ### # ########### # #
# # # # # #   #         # #   #   #   # #   #   # #   # # #   #   #         # #
# # ### # ######### ### ######### ### # ####### ### # # # ### # ##### ##### # #
# # #   # #           #           #   # #       #   #   # #   #   #   #     # #
### ### ####### ### ##### # ##### ### ##### ### ### # ##### # # ### # ### # # #
# # #   #       #     #   # #     #   #     #       #     # # #   # # #   # # #
# ########### # # # # ##### ### ######### ##### ### ### ### ### ### ### # ### #
#             # # # # #     # # #         #       #   #   #   #   # #   # #   #
# # ####### ##### # ### ### # ### ##### # # ### ### ### ####### ### ##### # # #
# # #       # #   # #   #   #     # #   # # #   #     #       #   #   #   # # #
### # # # ### ################### # ##### # ### # ### ##### # # ### ##### ### #
#   # # # #     # #       #     # #   # # # #   #   # #     # # #       #   # #
# # ### ####### # ####### ##### ### ### ####### ### # # ####### # ### ### ### #
# #   # #                           # #           # # #       # # # #   #   # #
# # # ####### # ######### ### # ### # ##### # ##### ### ### # ##### # ### ### #
# # # #       # #         #   # #           #   #   #     # # #         # #   #
###############################################################################
