###############################################################################
# #     #   # # # # #     #   #         #   #   # #                 #     # # #
# # ### # ### # # # ##### # ######### ### ##### # ########### ##### ### ### # #
#   #                   #               # # #   #         #   # #   #   #   # #
# ### ### ######### ### ### # ##### ### # # ### ####### # ##### ### ### # ### #
# #     # #     #   #   # # # # #   #       # #         #     #         # #   #
### ####### ### # # ### # ##### ####### ### # ############### ######### # # ###
#     #     #     # #   #             # # #     # # # # # #   #               #
# # ##### # ######### # ############# ### ### ### # # # # ### ##### # # ##### #
# # # #   # #       # # # #                             #         # # #     # #
##### ############# # # # ########### ### # ########### ####### ##### #########
#       #   #         #               #   # #         # # # # # #   # #       #
# ### ### ##### ################# # ####### ### ##### # # # # # # ### # # # ###
# #   # # # #   #         #       # # #     #   #       #               # #   #
# ### # # # ### ######### ####### # # ################# ########### # #########
# # # #         #           #     # #                   #           #         #
### # ############# # ##### # ### ################### ############# # # ##### #
# #           #   # # #       #   # #             # #           #   # #     # #
# ### # ##### ### # ############### ##### ####### # # ####### # # # ### # ### #
#     # #         # # # # #       #     # #     #     #       #   #   # #   # #
# # ####### ##### # # # # ####### ##### ####### # ########### # ####### # # ###
# # #       #         # #     #             #       #         #       # # #   #
# ### ### ##### # # ### # ### ### ### ##### # # # ### ### # ##### # ####### ###
# # #   # #     # # # #     # # # #   #   #   # # #   #   # #   # #       #   #
### # # ### # # ### # ####### # # ##### # ##### ### ####### ### ### # # ### # #
#   # #   # # # #   #               # # #         # #   #   #       # # #   # #
# # # # ##### ### ####### # ### # # # ### # ##### ##### # # ### # # ### # # # #
# #   # #     #   # #     # #   # #   #   # #       #     # #   # #   # # # # #
# ### ############# ### # ### # ##### ### ####### # # # # # # # ### # # ### ###
#   # #   #             # #   # #     #   #       # # # # # # #   # # # #     #
##### ### # # ### ### ######### # ### ##### # # ##### ### # ### # # # ### # # #
#   # #     # #   #     #       # #   #     # # #       # # #   # # # #   # # #
# ### # # ####### # ### # # # ##### ### # # # ### # # # ### ####### ### ##### #
# #   # # #   #   # #   # # # #       # # # # #   # # # #   #       #   #   # #
# ##### # # ##### ### ####### ##### ########### ### ##### # # # ### ### ### # #
#     # # #       #       #   #     #     #     #   #     # # #   # #       # #
# # ##### ##### # ### ##### ########### # ######### # ##### ##### ##### # ### #
# #       #     # #     #   #           #           # #       #   #     #   # #
###############################################################################
