###############################################################################
# # # # # # #   #     # # # #       #     # #   #   # #     #   #       #     #
# # # # # # # ### # ### # # ### ### # ### # # ### # # # ##### ### ########### #
# # #   #       # #   #   #   #   # #   # # # #   # #       #   # #           #
# # ### ### # ### # ##### # ### ##### ##### # # # ### ##### # ### ##### ##### #
# #       # # # # # # #     #     # # # #   #   # #     # # #     #     # #   #
# ##### ### ### ### # ### # ### ### # # # ### ######### # ##### ##### ### #####
#   #       #   #   #   # #   #   # # # # #   #   #   #     #       #     #   #
# # ##### ### ##### # ####### ### # # # # # ### ##### # # ### ####### # ##### #
# #   # #         # #     # #   #     # #   # # #   # # #     #     # #       #
### # # # ####### # ### ### ### # ##### ### # # # ### # ##### # # ### # # #####
# # # # # # #   # # # #   #   # # #     #   #     # # #     #   #     # #   # #
# # ### ### ### # # # # ### ### # ##### ### ### ### # ### # # ### ####### ### #
#       # # # #       #     #     # #   #   #     #   # # # # #         # #   #
### ##### # # ### ### ### ### # ### ### # ### ### # # # # ######### # ##### ###
#     # #   # #   # # #       # # #   #   #   # #   #             # #     #   #
##### # ### # ##### # ### ##### # ### # ### ### ##### ### # ### # ### # ### ###
#     #   #   #   #           # #   #     #       # #   # #   # # #   # #   # #
##### ### # ##### ##### ########### # # ### ####### # # ##### # ### # ### ### #
#     # # #   #   #   #     #   # # # # #   #   #   # # # # # #   # #         #
# ### # # # ### ##### ### ##### # # # # # ### ### ### ### # ### ####### # #####
# #     #   #   #   #     # # #       #   #   #   # # # #     # #     # #   # #
### # ### ### ##### ##### # # ##### ######### ### # ### ### ######### # ##### #
# # #           # # # #   # #   #   # # #     # #         # #   # # # #       #
# # # ### ##### # # # ### # ### # ### # # ### # ### ####### # ### # # ### # ###
#   # #   # #       # # #   # # # # #   #   #   # #   # # #         #   # # # #
# ### ##### ### ##### # ### # # # # # ### ##### # # ### # # ### # ### ### ### #
#   # # # #   #   #       # #   #     # #     #               # #     #     # #
# ### # # # ##### ####### # ### # ### # # ### # ##### # ################# ### #
# #   #   # # #         # # # # # #         # # # # # #     #         #       #
# # ##### # # ####### # # # # # ### # ######### # # ### ### # ### ### # # ### #
# # #               # # # # #   # # #   # # # #       #   #     # # # # #   # #
# ##### ########### ### # # # ### # # ### # # ######### # ### # ### ### ### ###
# # #   #         #       #         #                 # #   # #   # # # # # # #
### # ### ####### # ##### # ### # ### ### ##### ### ############### # ### ### #
#     #   #   # #     #       # #   # #       # # #     #               # #   #
############# # ########### # # ### # # ### ##### ### # # # # # ##### ### # # #
#                           # #   # # #   #         # #   # # #   #         # #
###############################################################################
