###############################################################################
#   #   # #   #       # # # #   #   #   #   #   #     #   #         # #     # #
### # ### # # ### ##### # # # ##### # ### ### ### ##### ##### ##### # ### ### #
#   #     # # # #           # # #   # # # #     #       # #   #   #   # # #   #
### ### ##### # # ########### # ### # # # # ####### ##### # ### ####### # ### #
# #       #                 #   #   #         # # # #   # #       # # # # # # #
# ##### ####### ### ########### ### # # ####### # # ### # ##### ### # # # # # #
# # #     # #     #   # # # # #   # # # #   #   #   #     #   #   # # #     # #
# # ##### # # ######### # # # # ### # ##### # ##### ##### ### ### # # # ##### #
# # #   # # # #       #   #       #   #             # #   # # #       # # #   #
# # # ### # # # ### ### ##### ##### ### # # # # ##### # ### # ### ##### # # ###
#   # # # #   # # # #     # # # #       # # # # #         # #   # #     #   # #
# ### # # # ### # ####### # # # # ####### ##### ##### ##### # ### # ####### # #
# # # # #         # # #   # #     # #   #     # # # #         #         # # # #
# # # # # ######### # # ### # ##### # ########### # ### ### ### ######### # # #
#     # # # # #     # #     # #     #   #     #   # #   # #     #   # # #   # #
##### # # # # # ### # # # ### # ##### ### ##### ### ### # # ##### ### # # ### #
#   # #   # #     #   # # # #     # #   # #   # #     #   # #             #   #
### # # ### # ######### ### # ### # # ### # ### ##### # ##### ### ######### # #
#   # #     #     #     # #   # #   # # # # #     #   #       #       #     # #
### # # ##### # ### ##### # ### ##### # # # ### ##### # ######### ### # #######
#   # # # #   #     #   #   #     # #     #       # #           #   #         #
### # # # # ######### ### ##### # # ### ##### ##### # ####### ### ####### #####
# #             # # # #     # # #       # # #   #           #   #       #     #
# # # # # # ##### # # # ##### # ######### # # ##### ### ######### # ####### # #
#   # # # #   #           #   #   #   #     #   #     #       #   #     # # # #
##### ### ##### ########### ### ### ####### # ### # ### # ##### # # ##### ### #
#     # #     #             # #   # # #     #     #   # #     # # #         # #
### # # # ### # # ######### # # ### # # ##### ########### # # ### # ######### #
#   # #     #   #         #   #                 # # # # # # #   # #       #   #
##### ##### ####### ########### ####### # ### ### # # # ##### ### #############
#     #         # #     #       # #   # #   #             # # # #             #
# # ### # ### ### # ##### ####### # ### # # # ### # ####### # # ### # # # ### #
# # #   # # # #           #       #   # # # # #   #     #   #     # # # #   # #
# ####### # # # ### # # ### ##### # # ############# ### # ### ### ##### # ### #
# #       #   # #   # #   #   # #   #       # #   #   #   # # #       # #   # #
# ####### ### ### ### ### # ### ### ######### # # ##### ### # ### ####### # # #
# #       #   #   #     #         #             #     #     #   #       # # # #
###############################################################################
