###############################################################################
#   #       #   # # # # #   #     # #   # #   #         #   # #   # #         #
### # ####### ### # # # # ####### # # ### ### ### ######### # ### # ### # ### #
# #   #     #       # #       # # # #   #   # # #       # #     #   # # #   # #
# # # ##### ####### # ### ##### # # ### ### # # # # ##### # # # # ### ##### ###
# # #   # #     #   # #       # # #   #   #   # # # #   # # # # #   # #     # #
# # ### # ### ### ### ### ##### # # ### ##### # ### # ### # ##### ### # ##### #
# # # # #   # # #   # #     #   #   #     #   # #   #   #   #   #       #     #
# # # ##### # # ### # # # ### ### # # ##### ### ### # ### # ### ### ##### #####
# #   # #   #   # # #   # # #   # #   # #   #   # #     # # # #           #   #
# ### # ### ### # # # ### # # ### ##### # ##### # ##### # ### ### ######### ###
#     #       # # #     #       # #   # #         # # # #   #   # #       # # #
### # ####### # # ########### # # # ### ####### ### # # # # ### # # ####### # #
# # #               #     #   #       #   # # #   # # #   #                   #
# ### # ##### ### ### ##### ########### ### # # ### # # ####### ### ### ##### #
#     # #     #         # #   # #   #     #   #     # #   #   #   #   #     # #
############### ####### # ### # ### ### ##### # ### # # ### ##### ##### # #####
#         #     #   #     #       #   #   # # #   # # #     #         # #     #
# ####### # ####### ##### # ######### ### # # # ##### # ########### ##### # ###
#   #       #           #   # # #   # # # # #   # #     #   # # #     # # # # #
### ############# # ### ### # # ### # # # # ### # ### ### ### # ####### ##### #
#   #       #     # #     #     # # #   #     #               #   #   #   #   #
########### ####### ##### ##### # # # ### ##### ### # # # ### # ### # # ### ###
#         #   #     #                             # # # #   # #   # # #   #   #
######### ### ######### # ##### # ##### # ### # # # # ########### ### # ### ###
#         #             #     # #     # # #   # # # # #         # #   #     # #
####### ### # ####### # # # # ##### ### # # ### ##### # # # # ### ### ### ### #
#     #   # # #       # # # # #     #   # # #     #     # # #       # # #     #
##### ### ### ########### ### # ##### # # ### # # # # ##### # # ### # # # # ###
#             # #         # # # #     # # #   # # # # #     # # #         #   #
##### ##### ### ####### ### # ####### # # # ### # # # ####### ### # # ### #####
# # # # #     #         #   # #       # # #   # # # #       # #   # #   #   # #
# # # # # # # ####### # ### # ### ### # ##### ### ##### ### # ####### # # ### #
#   #   # # # #       #   #   # # #   #     # #   #   #   # #   # #   # #     #
### # ####### ### # ########### # ### ##### ### # # ########### # ##### ### # #
# # # #         # # #         #     #   #   #   #       # #     #     # # # # #
# # # # ### ### # ####### ### ##### ########### # ####### ##### ##### # # # # #
#     #   #   # # #       #                   # #             #       #   # # #
###############################################################################
