###############################################################################
#   # #   # # #                 #   #     #   #   # # #       #     # # # # # #
### # # ### # # ### # ### # # ### ####### ### # ### # # ####### ##### # # # # #
# # # # #   # #   # #   # # #     # #           #   #   # # #           #     #
# # # # ### # # ##### ######### ### ### # ####### ### # # # # ######### # # ###
# # #     #       #     #     #       # # #   # #     #           # # #   #   #
# # # ####### ########### ####### ##### ### ### # ####### # ##### # # #########
#       #           #   #   #   # #       # #     # #   # #     #   #     # # #
##### # ##### ####### ### ### ######### ### ### ### # ####### # # ### ##### # #
# #   #                         # #   # # #   #   #     # #   # #           # #
# # # # ### ########### ### ##### # ### # ### # # # ##### ########### ####### #
#   # #   #           # # #       # #     #   # #     #     #       #         #
##### ### # ### ######### ######### # ##### ### ### ##### ### ####### #########
#     #   #   #           # # # # # # #           # #     #       # #   # # # #
### # ### # ############### # # # # # # ######### # # ####### ##### ### # # # #
#   #   # #                 # # # #           # # #   #   #   #   #   #       #
### ### ### ##### ##### ##### # # # ##### ### # ####### ##### # ### # # #######
#     #   #     # #   #   #   #     # # #   #     #                 # #       #
# # # # ##### # # # # ### # ##### ### # ### ####### ####### ######### ### # ###
# # # #     # # #   #   #     #       #   #           #   #   #   #   # # #   #
# # # # # ######### # # # # ####### ### # ### ##### ### # # ### ### # # ##### #
# # # # # #       # # # # #       #     #   #     #     # #     # # #       # #
# # ### ### ####### # # # # ##### # # # # # ### # ### # # ##### # ##### ### ###
# # #           # # # # # #   #     # # # #   # # # # # #     #       #   #   #
# ######### ##### # ### # # ##### # # ##### ####### ### ### ####### # #########
#         #     #   #   # #     # # #     #   #     #     #   #   # #         #
### ### ### ########### ##### ### ### # ### ### ########### ### ####### ##### #
#   #   # #     # #       #     #   # #   #             # #       # #       # #
### ##### ####### ####### ### # # # # # # # ### # ### ### # # ##### ######### #
#   #   # #       #     # #   # # # # # # #   # # # # # # # #               # #
# # ### # ### ##### # ##### # # ##### # # ### ##### ### # ##### ############# #
# #     #           #     # # #     # # #   # #     #   #     #       # #   # #
### ### # ### ######### # ### # # # ### # # # # # ##### # ######### ### # #####
#   # #     #   #     # #   # # # #   # # # #   #                 #     #   # #
# ### # # ####### # ##### # ##### ##### # # # # # # # # # # ######### ##### # #
#     # #         #     # #     #     # # # # # # # # # # #         #       # #
##### ### ##### ####### ### ### # # ##### ### ### ##### # ##### ########### # #
#       #     #       #   #   # # #     # #   #     #   #     #         #     #
###############################################################################
