###############################################################################
# #   #     #       # # #   #     # #   #   #       # #     # # #   #         #
# # ### # ####### # # # # # # ### # # ### ######### # ##### # # # ##### ##### #
# # # # # #       #       #   # #   # # #           # #     #           # #   #
# # # ### # ####### ########### # ### # ######### ### # # # ### ######### #####
# #   #   # #   #   #       #   # #       # #         # # #   #     #     # # #
# ### ### ##### ##### ### # ### # ####### # ### ########### ##### ### ### # # #
#       # #   #     # #   #   #             #         #   #   #     # # # #   #
####### # # # ### ##### ##### ####### ### # # ### # ##### # ### ##### # ##### #
#     # # # #   # #     # # #   #     # # #   #   # # #   #     #   #     #   #
##### # # ##### # ####### # ### ####### ####### ##### ### ##### # # # # ##### #
#   #       #   # #     # #                         #     #     # # # # # # # #
# ######### ### # ##### # ### ### ### ######### ### ##### ### ### ### ### # # #
# # # # #                     #   #   #     # # #       #   # # # # # # # # # #
# # # # # # # ### ########### ############# # ######### # # # # # # # # # # # #
#         # # #   #   # #     #   #             #         # # #       # #   # #
# # ##### ########### # ####### ######### ##### ########### # # ####### ### # #
# #   #   #           #               #   # # # #   # # # #       #   # # #   #
##### ### # ####### # ######### # ### ### # # # ### # # # # ####### ### # # ###
#   # #   # #       #           # # #     #   #       #           # #   #   # #
# ########### ##### ### ### ### # # # ####### ### # ####### ####### # ### ### #
#             # # #   # #     # # #     #         #   #   # # # #   #         #
##### ### ##### # ### ### ##### ######### # # # ##### # # # # # ### # ### #####
#     # # # #     #   # # #       #       # # # #       #           #   # #   #
####### ### # ### # ### # ################# ######### ### # # ####### ### # ###
# # #   #   #   #   #     #   # #   #       #   # #     # # # # # #   # #   # #
# # ### ### ####### ### ##### # # # ##### ### # # # # # ##### # # # ### ##### #
# # #     #     #   #     #       # #     #   #     # #   #       #           #
# # # ### ##### ####### ####### ### # ######### # ##### ### # ### # ### ##### #
#     #                   #     #     #         # #     #   #   #     #   # # #
############# ####### # # # ####### ### # ######### # # ##### # # # # ##### ###
# #           #       # # # #       #   # #     # # # # #     # # # # # #   # #
# ################# ### # ######### # # # ### # # # # ######### ####### # ### #
#   # # # #           # # #         # # # #   # #   #   #                   # #
### # # # # ### # # ##### ### ### ### ##### ### ### ### # ### ### ######### # #
#   # #   # #   # # #     #   #   #   #   # #         # # # #   #       # #   #
# ### ### ### ### # # ######### ##### # ########### ### ### # ### # ##### # ###
#             #   # #   #       #     #               #     # #   #     #     #
###############################################################################
