###############################################################################
# #   #         #           # # # # #         #                   #     # #   #
# ### # ##### # ########### # # # # ######### # ####### # ######### ##### # # #
#       #     #   # # #     #     #   # #     # #   # # #   #       # #     # #
######### ### ### # # # ######### ### # ##### # # ### ######### ##### # #######
#         #   #       #   #         # # #     # # #   #   #   # #   # #       #
##### ############# # # # # ####### # # ##### # # ### # ### ### # ### # #######
#     #     #       #   # # #   #   # #   #             # # #     # #   #     #
# ######### ### ### ##### ##### ### # ### ##### # ##### # # # ##### ### # #####
# #             #   # # # #   # # # # #   #   # # #     #   #   # #     # #   #
### ### ##### ####### # # # ### # # # # ##### ### ##### # ##### # # ##### ### #
#   #   #     # #             # # # #   # #   # #   #   #     #               #
### ####### ### ######### ### # # # # ### ### # ####### # ####### ### ####### #
#     #     #     # #     #       #       # #     #       # # #   #       #   #
############# ### # ############# # ####### ### ####### ### # # ###############
#       #     #         # #       # # # #     # # #     # # #   #   # #       #
# ######### ########### # ####### # # # ##### # # ##### # # # # # ### ### ### #
# #         #       #     # #   #   #   # #   # # # #   # #   #       #   # # #
# ##### ########### # ### # ### # ##### # ### # # # # ### ### ### ##### ### ###
# # # # #   #       # # # # # #     # # #   # # #   # #   #   # # #     #     #
# # # ##### ####### ### # # # ##### # # ### # # ### # # ### ### ### # ### #####
#     #   #   #     # # #   #     #   #   # # #   #     #       # # #   # # # #
##### # # ### ##### # # ### ### # ### ### # # ### ### ### ### ### # ##### # # #
#       #               #   # # #     # #         #     # # # #   #   #   #   #
### ##### ########### # ### # ####### # ####### ### ##### # ### ### ### ### ###
#   #     #           #   #       #     # #   #   #         # #         #   # #
### # # ### ##### ##### # ### # # ##### # ### ### ### ### ### ### # ####### # #
#   # # #   #   # #     #   # # # #           # #   # # #   # # # #       # # #
##### ######### ########### ### ####### ##### # # ### # ##### # # ######### # #
#       # #     #       #     # # #     #   #     #       # # # # # #   # # # #
######### ### # # # ### ##### # # ####### ### ##### ####### # # # # # ### # # #
# # # #   #   #   # # #     # # #       #         #   # #   # # # #         # #
# # # # ### ######### ##### # # # ### ########### ### # ### # # # ### ####### #
#       #   #       # #   #       #   #   #       #   #   # # #   #   #   #   #
##### ######### ### # ### ########### ### ####### # ##### # # # ### ### ##### #
#   #       # # #   #   #             #   # # #         #     #   #     #   # #
# # ####### # ### # # ##### # # ##### # # # # # ####### # ### # # # ##### ### #
# #               #         # # #       #             #     #   #             #
###############################################################################
