###############################################################################
#   # #         #   # # #   #         #   # # #   #   # #       # # # #       #
# ### ####### ##### # # ### ######### ### # # # ### ### ##### ### # # ### ### #
# #   # #   # # # # #     # #   #             #     # # # #     #     # # # # #
# # # # # ### # # # ##### # ### ##### ##### # # ##### # # ##### # ##### # # ###
# # #     # #       # #       #   #   # #   #       # #   #   #     #     # # #
# ##### # # # # ### # # ##### # ####### ##### ####### # ##### # ####### # # # #
# # #   #   # # # # # #   # # #     #     # #   # #   #       #       # # # # #
# # ####### # ### # # ##### # ### ### ### # ### # # ### ######### ##### ### # #
# #   # # # # # # # # #   # # #   #   #           #   # #   # #               #
# ### # # # ### # # # ### # # ### # ########### ### ### # ### # ### ####### # #
# # #     #             #     #   # # #                 # # #     #       # # #
# # ##### ### ######### ### # # ##### ##### ##### ####### # # ### # ##### # # #
# #   #       #     #       # #   #   #     #         # #       # #     # # # #
# ### ############# ######### # ##### ######### ####### # ##### ###############
#   #     #                           #         # #   #       #   #     #     #
### ### ### # # ##### # # # ######### ### # ### # ### # ### # # ### # ### ### #
#           # # #     # # # #       #     # #   #       # # # #     # #   #   #
# # # ######### ##### ### ##### ####### # # # # # ### ### # ####### ### ### # #
# # #   #       # # # # # #             # # # #     #     #       #       # # #
# ### ########### # # # # ### ### ##### # ####### ############### ### #########
# # #   #             #   #   #   # #   # #     #       #       # #           #
### ######################### ##### ######### # # # ####### ##### # ######### #
#   # # #       #       #     # # #           #   #             # #   #   #   #
# # # # ####### # ### # ##### # # ### # # ##### # # # ############# ### # #####
# # # # # # #     #   #   #   #   #   # #   #   # # #         #   #     # #   #
### # # # # ####### # ### ####### ### # # ##### ##### # # # # # # # ######### #
#       #           # #     #   #     # # #       # # # # # # # # #           #
####### ######### ######### ### ### # # # ##### ### ### ### # # ######### #####
#       # # #     #   # # #     #   # # # #           #   # #           # #   #
##### # # # ######### # # ### # # ### # # ### ### # ##### # # ####### ##### ###
#   # #   #       # #     #   #   #   # # # # #   # #   # # #       # #       #
# ### ### ### # # # ##### # # ### ### ##### ##### # # # ##### ######### # ### #
# #   #       # #     #     # #   #     #       # # # # #   # # #   # # #   # #
# ##### ##### ### ### ##### # ####### # ### ### # ### # # ### # # # # # #######
#     # #     #   #     #   # #     # #   # #         # #   #   # #       # # #
##### ### ####### ### # # # ####### # ### # # ### # # # # # ##### # ##### # # #
#         #       #   #   #   #         # # # #   # # #   #       #     #     #
###############################################################################
