###############################################################################
#     #   #     #       #         #         # #                   #     #     #
##### # # # ### ### ### ### ##### ##### ##### # # ############# ##### # # # ###
#   #   # # #     #   # # # #   # # # #   #   # #             #       #   # # #
# ### ### ####### ### ### ### ### # # # ### ### ####### ### ##### ########### #
# #   # # #             # #   #   #     # #   # #   # # # #   # #         # # #
# # ### ##### ##### # ### ### ### # ### # ### # # ### ### ##### ####### ### # #
#   #   #   # #     #       #         #           # # #     # # # #   # #   # #
# ### ### # ##### ##### ######### ################# # ### ### # # # # ### # # #
# # # #   #     # # #   # # #           # #     #   #           #   #   # # # #
# # # # ####### ### ### # # ### # ####### # ### ### ### ####### # ##### ### # #
#     # #   #     #     # # # # #   #   #     # # # # # #     # # #   # #   # #
# # ##### ### ### ##### # # # ### ### ##### ##### # # # # ####### # ##### ### #
# #   #   #     # # # #         #   #         # # #         #   # # #         #
# ##### ### ##### # # # ######### ### ######### # # ######### ### # # ### #####
# # #           # #   # #     #   #     #     #   #   # #   # #   # # #     # #
# # ##### ########### # # ####### # ######### # ### ### # ### # ### # ####### #
#       # #   #       #     #   # # #   # #     #   # # #   # # # #       #   #
# ##### # ### ### ### ### # ### # # # ### ### ### ### # # ### # # # ##### # ###
# #     #       # #     # #     # # #   #       #   #   # # # # # #     # #   #
### ### ##### ######### ####### # # ### # ##### # # ### # # # # # ### ##### # #
#   #   #   # # #     #   #   # # #   # #     #   #   #         # #       # # #
# # # # ### # # ### ##### ### # # # ### # ### # ### # # ##### ### # ### # ### #
# # # #     # # #   # #             #       # #   # #       # #     # # #   # #
# ### # # ### # ### # ########### ##### ########### ##### ### ### ### # # # # #
# #   # #         # # #   #         # #   #     #     #   #           # # # # #
### ##### ####### # # ### ##### ##### # ### ############### # ### ######### # #
#   #     #   #                 # # # #     # #         #   # #           #   #
############# # # ### ######### # # # ### ### # ############# ### ### # ### # #
# #         # # # # # #     # # #   # #             #   #   #   #   # # #   # #
# ####### # # ##### ### ### # # # ### # ### ##### # # ### ####### # ####### ###
#     # # #             #     # #   #     # # # # #     #     #   #       #   #
##### # # ### ########### # # # # ### # ##### # ######### ### ############### #
#     #   #   #     #     # #         #           #     #   # # #   #       # #
##### ##### ##### # # # ######### ### # # # ### ### ##### # # # # ### ##### ###
#   # #   # # # # #   # #     # #   # # # #   #       #   # #   # # #     #   #
### # # # ### # ##### # ### # # # ##### ####### # ##### ##### ### # # ####### #
#       #             # #   #         #       # #           #           #     #
###############################################################################
