###############################################################################
# # # #         #     #   # # #                 #   #     #   #     # # #   # #
# # # # ### ### ### # ### # # ##### # ### # ##### ### ##### ### ##### # ### # #
#   #     # #       #   #     #     # #   #       #   #   # # #             # #
### # ##### ####### ### ##### ######### # # # ### # ### ### # # ####### ##### #
#     #     # #     #           #   #   # # #   # # #     #       # # #       #
# ### # ##### ############### ##### ### # ### # # # # ### ### ##### # #########
# # # #   #       #         #           # #   # #     # # #       # #       # #
# # ##### # ##### ####### # ####### ### ######### ##### ### # ### # # ####### #
# #       # #             #         #       #               #   # # # #   #   #
########### ####### ####### # ### ######### ### # # ### # # ####### # # ### ###
# #     # # # #     #       # #   #           # # #   # # #                   #
# ##### # ### # ##### ### ### ######### # # # # # # ### # # # # # ### ##### # #
#       # # #   #     #   #     # #     # # # # # #   # # # # # #   #   #   # #
# ### ### # # ######### # # ### # # ### ####### # # # ### # # ### # # ##### # #
# # # #   # # #     #   # # # #   #   #   # #   # # #   # # #   # # #   #   # #
# # ### ### ##### # ### ### # # # ##### # # # # ####### # # ### # ##### ##### #
#   #             #     #   #   #   #   # #   #       # # #   # # #   #   #   #
### # ##### # ### ##### ####### # ############### ### ##### # ####### #########
#     # #   # #     #   #     # # #               #       # #     # #       # #
# ##### ### ### # ####### ### # # ##### ####### # # ### # # ### # # # ##### # #
# #       #   # # # #     #     #     #   #   # # #   # # # #   # # #   # # # #
# ####### ######### # ##### # ### ########### # ##### ##### ####### # # # ### #
# #   #       #   #   #     # #   #   #             #     #           #     # #
# ### ####### # # ### ### ##### # # # # ### # # ### # # # ##### ### ### # # # #
#   #       #   # #   #   # #   #   # # #   # # #   # # #   #     # #   # #   #
# ######### ##### ##### ### ### # # ### # # # ### # ##### ####### # # # # ### #
# #         # # #         #     # #   # # # #   # #     #     #   # # # #   # #
# ##### # # # # # ####### # # ### ##### # ### ### ##### # # ### ##### # # ### #
#     # # # #     #   #   # #   #   #   # #     #     # # # #     #   # #   # #
##### ##### ##### # # ##### ### ### ### # ##### ### ### # ##### ######### ### #
#       # #         #   #     #   # #   # #     #     # #     #       # #   # #
# ####### # ##### ### # # # ### ##### ### # ####### ### ### ##### ##### # ### #
#     #   #   #     # # # # #       #   # # #         #   #     # # # #     # #
# ####### # # # ##### # # # ### ##### ##### # ### ### ####### # ### # # # # ###
# # #       # #     # # # # #     #   #     #   #   #   # #   #   # # # # #   #
# # ##### ### ### # # # ### ### # # ########### # ### # # # ### ### # ##### # #
#     #   #     # # # # #     # # # #           # #   #   # #       #       # #
###############################################################################
