###############################################################################
#   #             #   #   #         #                       #       #     #   #
# ########### ### ### # # # ### # ##### ######### # ### # ### ### ### ### ### #
# #     #     # #   #   #   #   #   #   #   #   # # #   #   #   # #   # #     #
# # ### # ### # ############### ### ####### ### # ########### # ### ### # #####
#   #   # #   #   # #   #   # # #   #     #   #   # #   #   # #     #   #     #
####### ### ### # # ### # # # ### # ##### ### # ### # ### ### ##### # ### # ###
#       #       # # # #   #       #   #   #   # #       # # #   # # #   # #   #
####### # # ##### # # ####### ##### ##### ### # ### ##### # # ### ### # # ### #
# #   #   # #   #   # # #   # #         # # #   #   # # # #   #       # #   # #
# # # ### ### # ### # # ### ##### ##### # # ### # ### # # # ### # ####### # # #
#   #       # #   #   #   # #   # #   # # # #   # #           # #     # # # # #
##### ######### # # ##### # # # ##### # # # ### # ### # ####### # # ### ### ###
#     #         #   #   # #   #   #                 # #       # # #       #   #
# ##### ####### ### ### # # # # # ######### ### # # # # # # # # ##### ####### #
# #   # #   # # # # # # #   # # # #         #   # #   # # # #       #       # #
# ### ##### # ### # # # ######### ### # ####### # # # # # ### ######### #######
#   #         #   #   #   # # #       # #       # # # # # #           #     # #
##### # ##### ### # # # # # # ##### ### ### ### # # # # # ##### # ### ### ### #
# # # # #     # #   #   #       # # #   # #   # # # # # # # #   # # #   # #   #
# # # # ### # # ##### # ####### # ### # # # ##### # ### # # # # # # ### # # ###
# # # # #   #     #   # #   #     #   # #   #   # # #   # #   # #     # # #   #
# # ### ######### ####### # ##### ### ##### ### # ####### ### ### ######### ###
#           # # # # # #   #             #   #     # #     #     #             #
# ########### # # # # ############# # # # ### ### # ### ##### ##### ### # #####
# #         #     #                 # # # #     # #     #       # # # # # # # #
########### ### ### ### ### # ####### # ##### ### ####### ### ### ### # ### # #
# #   #     #       #   # # # # #     # #     #   #         #         #       #
# ### ##### # # ### # ### # ### ### # # # # ### ### # # # # ### ######### #####
#             # #   #     # #   #   # # # # #   #   # # # #   #         #     #
##### # # # # # ##### ### # # # # # # ### ### ### ####### # ### # ### ### # # #
#     # # # # #   #     # # # #   # #   # #   #   #       #   # #   #   # # # #
# ### ### # ##### ### # # # ### ##### ##### # ### ### # ##### # # # ######### #
#   #   # # #       # # # #   # #     #   # # #     # #   #   # # #       #   #
# # ##### # # ### ### ##### # ##### # # ##### ##### # ### ### ### ######### # #
# # #   # # # #   #       # # #     #   #   # # #   #   #   #   #       #   # #
# ### # # ##### ### ### ########### ### # ##### # ### # ### # # # # # ### #####
#     # # #     #   #   #             # #         #   # #   # # # # # #       #
###############################################################################
