###############################################################################
# #       #   # #                 # # #     # # #       #     #     #     #   #
# # # # # ### # ######### ##### ### # ##### # # ### ### ### ### ##### # ##### #
#   # # # #   #     #     # #   # # #   #     #   #   # #     #       # # #   #
# # # ### ### ##### ####### ### # # ### ##### ### ##### ##### # ######### # # #
# # #   # #               #           # #       #   #   #       # # #     # # #
### ##### ### ##### ##### ######### ### ####### # ### ##### ##### # ### ##### #
#   #   #       #   # #   #   # #     #     #       # # # #       # # # #   # #
# ##### ### ####### # # # # ### ### ####### ### ### # # # ####### # # # # # # #
# # #       # #   #   # #             # #   # # #     # #   #     # #   # # # #
### ### ##### ### # ### ############# # ### # ####### # ### ### ### # ### # # #
# #   # #   # #     #   # #     # # # # #     # # #   # # # # #         # # # #
# # ####### # ##### ##### ##### # # # # ##### # # ### # # # # ##### ####### # #
#         # # # #   #         #               #   #     # #   # # # # #       #
# ####### # # # ####### ##### ####### ####### # # ### ### # ### # # # # #######
#   #   # #   # # # # # #   #         #   #     #   #         #     # # #   # #
####### # ### # # # # ##### # ########### # ####### # ##### # # ##### # # ### #
# #   #   # #   #       # #   #     # #     # #   # #   #   # # # #   # #     #
# # ### ### ### ####### # ### ##### # ##### # ### # ####### ### # # ### ### ###
#     # # # #   #           #   #         # #           # # #   #   # # #     #
# # ### # # ### ########### # ####### ### ##### # ### # # # ### # ### # ##### #
# # # # #   #   #   #   #   # #         #     # # #   #       # # # #   #   # #
# ### # ### # ##### ### # # # ######### # ### # ######### ### # # # # ##### # #
#       # # #     #       # # #   # #   #   # # #         #   #   # #       # #
####### # # ##### ######### ### # # # ##### ################# # ### # ####### #
#         # # # #         # # # # # # #         # #     #     # #   # # #     #
# # ### ### # # # ### ### # # ### # # # # ### # # ### # ##### # # # # # # #####
# #   #         # # # # #     #     # # # #   # # # # #   #       #         # #
##### ######### ### ### ### # ### ### ##### ### # # ##### ### # ########### # #
# #   #               #   # #     #   #   # #     #     #     #           # # #
# ##### ############# ### ##### ####### ####### # ##### # # ### # ####### ### #
# # # # # #   # #           #         #         # #       # #   #     # #     #
# # # ### # ### ########### ##### # # ### ####### ####### # ### # ### # #######
# # #       # # #         #   #   # # #   #     #         # #   #   #         #
# # # ### # # # ##### ### # ######### # ##### ##### ##### # # # ####### # #####
#   # #   # #   #     #   # # #         #     #   # #   # # # #       # # # # #
# ####### ### # # # ####### # ##### # # ##### # # # # ######### ### # # # # # #
#             #   #                 # # #       #   #             # # # #     #
###############################################################################
