###############################################################################
#   # #   #   #   # #     # # # #   #             #           #               #
# # # # ##### ### # # ### # # # ### ### ### ####### ######### # ##### # ##### #
# #   # #     # # # # # # #     #   #   # #   #   # # #   #         # #     # #
# ### # ##### # # # ### # ##### # # ##### # ### ##### ### ### ##### # #########
# # #     # # #   # # #       # # #       # #   #   # # # # #     # # #       #
### ##### # # ### # # ##### ### ######### # # # # ### # # # # ######### ##### #
# #     # #     # # #             #     #   # #   #   #   #         # # #   # #
# # # # # ##### # # ############# ##### # ### # # # ##### # ######### # # # ###
# # # #             # #   #       # # # #   # # # # # # # # # #     #     #   #
# # ############# ### ### ####### # # # # ### ##### # # # # # # ####### ### # #
# # #     #   #                 #   #   # # # # # # # # #         # #   # # # #
# # ##### ### ################# ### ### # # # # # # # # ### ####### # ### # ###
#   # #             # #   # #   #   # #     # #   # # # #   #             #   #
# ### ############# # ### # # # ### # # ### # ### # # # # ### ### #############
# # #             #   #     # #     #   #     #     # # #       #     #       #
### # ########### ### ### # ####### ####### ### # ### # # # ####### # # ### # #
#     #                   # #             #     # #       #   #   # #     # # #
# ####### # ####### ### # # # ### ####### ### ### # ### ##### # # # # # #######
# #       # #       #   # # # #     # #         #   #     #     # # # #   #   #
# ### ### # ##### ### # ### ####### # ### # ####### ### # # # # ######### # ###
# #     # # #     #   # #     #     #     #       # #   # # # #     #   # #   #
# # ### ### # ##### # ####### ##### ### # # # ### ##### # ##### # # # ### # # #
# # # # #   #   #   # #   #         #   # # # #   #   # #     # # #     #   # #
# # # ### # # ### # # ### ########### ### ##### ### ######### # ### ##### ### #
# # #     # # # # # #   #   #   #     #     #               # # # #     #   # #
### ##### ##### ### ####### ### ### # ### ##### # # ### # # ### # #############
#   # #       #     # # #           #   # #     # #   # # #   #               #
### # ######### ##### # ##### # # # ##### # # # # # ### ######### # ######### #
# # #         # #             # # # #   # # # # # #   #       #   #       #   #
# # # # ##### ### ####### ### ######### # # ### # # # # ### ##### ### ### ### #
#   # # #         #       #       #       #   # # # # #   #   #     #   #   # #
### # ####### # # # # ### ### # ####### # ##### ### # # ##### ### ####### #####
# # # #       # # # # #   # # # #   #   #     # # # # #   #   #       #       #
# ####### # ### # # # ### # # # # ### # ######### ##### #######################
#   #     # #   # # #   # #   # #     #         # # # #       #               #
# # ### ########### ##### ### ##### # ### # ### # # # # ####### # # ### # ### #
# #     #           #     #   #     #   # #   # #               # #   # #   # #
###############################################################################
