###############################################################################
#   #                     #   #       # #   #         # #     # #   # #     # #
# ### ### ######### # ### ### ##### ### # # ######### # ### ### ### # ### ### #
#     #   #     #   # # #           # # # #   #   # #   # # # # # #     # # # #
# ##### ### ### # ##### ##### ####### # # ####### # ### # # # # # ### ### # # #
#   #   #     # # #               #   #         # # # #   #   #   #   # # #   #
# ##### ### # # ##### ####### ####### ######### # # # ### ### ### # ### # # ###
# #     #   # #     # #     #   #   #   # #       # #     #   #     #   # #   #
##### ####### ### # ####### # ### ##### # # ##### # ### ##### ### ### ### ### #
#     # #   # #   #   #       # #     # # # #         # # #       #     # #   #
####### # ### # # # ######### # ##### # # ########### # # ### ##### ##### ### #
#       #     # # # #   # # #           # # #           # #     #     #   #   #
####### # ####### # # ### # ########### # # ##### ### ### ### ### # ### ### ###
#         # #     #   #         #       # #     # #     #   # #   # # # #   # #
########### ### ##### ####### ### # ##### # # ######### # ### # # # # # # # # #
# #   #   #     #     # #   #     #   # # # # #   #   #         # # # # # # # #
# # # # ########### # # ### # # ##### # # # ### ##### ####### ####### # # ### #
# # #         #     #         # #         # # # #       # # #       # # # #   #
# # ##### ### ######### ######### ##### # # # # ####### # # # ####### # # ### #
# # #   # # #           #         #     #     #     #         # # # #         #
# # # ##### ### # ######### # # ##### ### ### # ### # # # ### # # # # ### # ###
# # #   # #   # # #   #     # #   #   #   #     # # # # #   #       #   # #   #
# ##### # # ####### ### ### ##### ### ### # ##### # ##### # ######### ##### # #
# # # #           #     #       # #   #   # #   # #   #   #             #   # #
# # # ##### # # # # ########### ############### # ### ##### # # # # ### #######
#         # # # #   #           # # # #       #         #   # # # #   #   #   #
# ##### ### ##### ### ########### # # ####### ######### ### ##### ######### # #
#   #     # # #   #   # #   # #   #   #   # #                 # # #         # #
### # ### ### # ### ### # ### ### # ### ### # ####### ##### # # # # ###########
# # # #         #   # #     #       # # #     #       #     #   #             #
# # ### ############# ##### ####### # # ##### ########### # # # ### # # ### # #
#   #   # # # #   # #     # #       #     #   #   # #     # # #   # # #   # # #
### # # # # # # ### ##### # ##### # # ### # # ### # ##### # # # ##### #########
# # # # #     # #       #   #   # #   # #   # #           # # #   #       #   #
# ### # ### # # ##### ### ### # # # ### # ######### ### # ### ### # # ##### ###
# # # # #   #         # #     #   #   #   #           # # #     # # # # #   # #
# # ### ### ######### # ### ####### # ### # ### ##### # ######### ##### ### # #
#       #     #                 #   #   # #   #   #   #         #             #
###############################################################################
