###############################################################################
# # #   #   #   #   #               #             #     # #     # #   #       #
# # # ### ### # ### ####### ### ####### ### ### # # ##### # ##### # ##### # ###
# #   #   # # # #   #     # # #   # #     # #   #   #             # #   # # # #
# # # ### # # ### ### # # # # ##### # ####### ### # ### ### ####### # ### ### #
#   # # # # # # #     # # # #       #   #   #   # #   #   #     #   #   # # # #
##### # # # # # # ### ### # ### ####### ### ### # ### # ####### # ##### # # # #
#   # # #       # #   # # # # #     # #   # # # #   #       # # #   #     # # #
# ### # # ########### # ### # # ##### ### # # ############### ##### ### ### # #
#   #   # # # # # #   # #   # #       #   #   #     #   #       # #     #   # #
# # ### # # # # # ### # ### # # ######### # ### # ### ### ####### # ##### ### #
# # # #   # #     #   # #   # # #           #   #     #       #       #     # #
### # # ### # ##### ### # ### # ##### ######### ##### # ####### ########### # #
# #   #     #     #   # # #     #   # #   # #   # # #   #     #     #   # #   #
# ### # ##### ####### # # # # # # # # # ### # ### # ### ### ### ####### # # # #
# #     # # # # #   # #     # #   #             # # # #   #     #     #   # # #
# # # # # # # # # ### ##### ######### ####### ### # # # ### ##### ####### # ###
# # # # #       # # #   # #         #   #   #   # #   #   # #     #     # # # #
# ### # ##### ### # ### # ##### ##### ### ####### # ####### # ##### ##### # # #
# #   #         # # # #       #   # # #       #       # #         # # # #     #
# # ####### # ### # # ####### # ### # ### ##### # # ### # ### # ### # # ##### #
# #   #   # # # #     #   #     #   # # # # # # # #       #   #   # # #       #
# # ##### # ### # ##### ### ##### ### # # # # ### ##### ########### # ##### ###
#   #   # # #         #       #   # # #             #     #                   #
####### # # ### ####### ##### # ### ##### ########### # # ### ####### ####### #
#   #     #   #             # #     # #     # #     # # #     #   # #     # # #
### ##### ### # ####### ### ### ##### # ##### # # ### ######### ### ####### ###
#     #           #   #   #                     #   #   #   #   #   # # # #   #
### ####### # # # # # # ### ####### # ########### # ##### ### ### ### # # # ###
#     #     # # #   # #   #       # #   #       # #   #       #   # #   # #   #
##### # # # ####### ### # # ####### # # ### # # # ##### ### ### ### # # # ### #
#       # #       #   # # #   #   # # #     # # #     #   #           #     # #
# ##### ### # ##### ##### ### # # ### ######### # # ### # # ####### # ### ### #
#   #   #   #   #   # #     # # #   # #       # # #   # # #       # #   #     #
# ### # # ##### # # # # ### # ### ### # ####### # # ### ####### ####### # #####
# #   # #   #   # #   # #   #   # # # #   # # # # #     #     #       # # #   #
### # # ### ####### ### ##### ### # # # ### # ########### ######### # ##### ###
#   # # #     #     #       #       #                             # #         #
###############################################################################
