###############################################################################
#           #   #     # # #   #               #   # #   #   #         #       #
# ####### # ### # ### # # # ##### # ############# # # ### ### ### ##### # ### #
# #       #   #     # # # # #     #   # # # #   #   # # #   # #         #   # #
### ####### ### ####### # # ##### ##### # # ### # ### # ### # # ####### # ### #
#   #       # # # # # # # #         # # # #     # #           #       # # #   #
# ### ##### # # # # # # # # ##### ### # # # # # # # ### # # ### # # ##### ### #
# #   #     #       # # #       # #     # # # #       # # #   # # #   #   #   #
# ### ##### # ####### # # ####### # ##### ### ### ### ##### ### # # ######### #
# # # #         #   #         # #               # # #     # #   # #     # #   #
### ########### # ### # ##### # ##### ### ######### # ### # ### ##### ### ### #
# #   #     #         #     #     # #   #           # #   #   #     # #     # #
# ### ##### # # # # ### # ######### ############### ##### # # # ### # ##### # #
# #       #   # # # # # #   #     #   #           #     # # # #   # #   # # # #
# # # # # ### # ##### # # ### ##### ### ######### ### # # ##### ####### # # # #
#   # # #     #     #   #           #         #     # # #     #       #   #   #
# # ######### # # ### # # ######### # ### ############# ##### # ######### ### #
# # #         # # #   # #         #     #   #     #   #   # # # # #   # #   # #
# ####### ### ### ##### ### # ### ### # # # # ##### ##### # ### # ### # ##### #
#     #   # # #       #   # #   #   # # # #   # #     #   # # #   #       #   #
######### # ### # # # # # # # ##### # ### ##### # ######### # # ### ###########
#           #   # # # # # # #     # #   # #     #     #   #   #   # #   #     #
### ##### ### ### # ### ### ########### # # # ### # ### ### ####### # ### # # #
#       #   # #   # #   # #     #   # # #   #     #       # # #   #       # # #
# # # ### # ### # ####### # ##### ### ############# # ##### # # ### ### ### ###
# # # #   #   # #     #   # #     #   #         #   #         #   #   #   #   #
# # # ### ### # ##### # # # # ##### ### ######### ### ### ### # ### ### #######
# # # #     # # #       # #   #               # #   #   # #     #     #       #
### ####### ### ### # ### ##### ##### ######### ##### # ######### ##### ##### #
#     #     #   #   #   #         #           #     # #   # #   #     # #     #
# # # ##### # ### # ######### ### # ####### ### ####### ### # ### ### #########
# # # #     #   # # # #         # #       #   #       #   # #     #           #
# # # ### # # ### # # # ### ### # ##### # ### # ########### # ##### ####### # #
# # #   # # #   # #   # # #   # #   #   #   #         #           #       # # #
# ######### ##### ##### # # ####### ##### # ##### ##### ### # # ####### ##### #
# #       #     # #     #     #   #   #   #     #       #   # #     # # # # # #
# # ##### ### ##### ####### # # ### ### # ################### ####### ### # # #
# # #             #     #   #     #   # #                   #             #   #
###############################################################################
