###############################################################################
# # # #     # # #     # # #   # #   #   #   # #   # #   # #     #         # # #
# # # # ### # # # # # # # # # # ### ### ### # # ### # ### # ### ### ####### # #
# # #   #   #   # # # # #   #                 # #   #         #     # #     # #
# # # ##### ### ### # # # ### ######### ### ### ### # ##### ####### # # ##### #
# # # # # #       # #     # #   #       # #   # #         #     # #         # #
# # ### # ##### ##### ##### ####### ##### # # # # ####### ####### ### ##### # #
#   #   #     #         #     # #   #     # #   #       # # # # #   #     #   #
# ### ####### ############# ### ######### # ##### ##### ### # # ### ###########
# #     # #     # #           # #   #   # # # #     # # #       # #   # # #   #
# ### ### ##### # # ##### ### # ### ### # # # ##### # ### ##### # ### # # # ###
#               #   #     #   #   # # # #     # #   #         # # # #     #   #
# ########### # ####### ### # # ### # # ##### # # ### ######### # # # ####### #
#   # #   # # #         #   #   # #   # # #   #   # # #       # #   #         #
##### # # # ####### ######### # # ### # # ### # ### # # ####### ### # ### # # #
#       #         # #       # #   # # #   #   #             # #         # # # #
####### # ####### ######### ##### # # # ##### # ##### ####### ### ### #########
#   # # # #     # # #     #   #   # #       #       #     # # # # #     # # # #
# # # # ##### ### # ##### ### # ### ####### # ##### ####### # # ######### # # #
# # # #   #         # #         # # #   #   # #   #   #   #                   #
# # # ############# # ######### # # ### ### # # ######### # ### ###############
# #       #     #   # # #   #     # #   #       #   #   # #   # #     #   #   #
######### ##### # # # # # # ### # # ### ### ####### # ### # ### # # ### ##### #
# #               #     # #   # #   #   # #     # #     #     #   # #   #   # #
# # ######### ####### # # ### ##### # # # # ##### # ### # ######### # ### # # #
#     # # #   #       #   #         # #           #   #           #       #   #
# # ### # ################# ####### ####### # ##### ### ### ############### # #
# # #     #     #     # # #   #             #         # #                 # # #
# # ### # # ### # # # # # ####### ##### # # ########### # # ############### # #
# # #   #   #     # #             #     # #       #   # # # #       #   # # # #
########### # # ####### # ##### ### ### ### # ##### ##### ### ##### ### # ### #
#   #   # # # # #       # #     #   #   #   #         # #         #   #     # #
# # ### # # ##### ############# # ####### # ##### # # # # ### ##### ### #######
# # # # # # #     #             #   #     #     # # #   # #     # #         # #
# ### # # ##### ####### ############### # ### # # ##### ##### ### # ##### ### #
#   #   #   # # #       #   #       #   # #   # #     # #   # # # #   # # #   #
# # ### # ### # # # ##### # # # # # # # ### # # ### # ### # # # # ##### ##### #
# #             # # #     #   # # #   #   # # # #   #     # #                 #
###############################################################################
