###############################################################################
# #       #             #   #             #           #     #       # # # #   #
# ####### # ############# # ### # ### ########### # ####### # ####### # # # ###
# #   # # # #           # # # # # # # #   #   # # # #   # #     # # #     #   #
# ### # # # # ############# # ##### # # ### ### # # # ### # ##### # ##### # ###
# #         #   #       # # #   # #       # #   # #         #     # # #       #
# ### # ##### ### ####### # ### # # ####### # ##### ### ### # ##### # ### #####
#   # #     # # #   # # #   # #     # #   #       #   #   #             # #   #
### ####### # # # ### # ### # ##### # # ### ##### # ##### # ############# # ###
# # #   #   #   #     # #   #   # # #         # # #   #   # #       # #       #
# # ### # # # ### ##### # ##### # # # ### ### # ### ####### # # ##### # # #####
# #       # # #   #     # # #     # # #     #     # #     #   #         #     #
# ##### ### # # ### ##### # ### ### # ### ### # # # # ### # # ########### # ###
# # # # #     #     # # #   #           #   # # #       # # #     #     # #   #
# # # ##### ### ##### # # ##### # # # ######### ##### ### ##### ### # ####### #
#   #   # # # #     #   # #   # # # # #     # #     #   #     #     #   # # # #
# ### ### # # # ##### ### # ### # ##### ### # ### ### # ####### # ### # # # # #
# # #   #         # # #     #   # # # # # # #       # #       # #   # # #   # #
# # ### ### ####### # ### # # ##### # # # # # ##### # ### # ######### # # #####
# #     #         # # # # # # #     # # # # #     # #   # #   #     # # #   # #
# ### # # ######### # # # ### # # ### # # # # ### # ### ### # # # # # # # # # #
# # # #     #   # # #   #       #     # # # # # # # # # #   # # # # # #   # # #
# # ### ##### ### # # ### ### ##### # # # # ### ##### ######### ##### # ### # #
#         #     #         #     #   # #   #   # #   #   # #   #   # # # # # # #
######### # # ### ################### # ####### # ### ### # # # ### # # # # # #
# # # # #   #           #     #     # # #     # #   #   #   # #   # # # # # # #
# # # # # ########### ### ####### ### # ### ### # ### ##### # # # # ### # ### #
#   # #           # #   # # #       # #   #     #   #       #   #     # # # # #
### # ### ### ##### ##### # # ##### # # ### ####### # ### ####### # ##### # # #
#           #     # #     # # #   # #       #   #     #   #     # # # #       #
# # ##### ##### ### # ### # # ### # # ####### ### ##### # # # # # # # # ##### #
# # #         #         #     #   # #     #         #   #   # # # # #   # # # #
### # # ### # ####### # ####### ####### # # # ### ##### # ####### ##### # # ###
#   # # #   #     # # #   # #     #   # #   #   #   #   #     #       # #     #
# # ####### # ##### ##### # # # # # # ### # # ### # ### ##### # ##### # # ### #
# #   # # # #   # #     #     # #   #   # # #   # # #   #   # #     #   #   # #
# # ### # # ### # # ### ### ### ####### ### ### ######### ########### ####### #
# #   #     #         #   #   #       # #     #               #               #
###############################################################################
