###############################################################################
# #   # # #   #   # #   #     # #     # # #   #     #   #         #   #       #
# # ### # # # # ### ### # ### # # # ### # # ### # # ### # ########### # ##### #
#         # #     #       #   #   # #   # #     # #   #   #     #   #   #   # #
######### # ### # ### # # ### ##### ### # # ##### ####### # # ### ### ##### ###
#     #     # # #     # #   #       # #   # # #   # # # # # #     #   #   #   #
# ######### # ### # ### # ### ### # # # ### # ##### # # # # ####### ### ### ###
#   #       #     # #   # # # #   #       # #     #               #   #   #   #
### ############### # # # # # ####### ##### # ####### ############# ### ##### #
# # # #   #   #     # # # # # # # #   # #     #             # #           #   #
# # # # ##### ### ######### ### # ### # # ##### ### # ####### ### ### ### ### #
#     #   #       # #   # #   # # #   # #       # # #     # #       # # # #   #
##### ### ####### # # # # ### # # ### # # ####### # ##### # ##### ##### # # # #
#                 #   #         #       # #       #     #     # #     # # # # #
# ### ### ##################### ####### # # ################### # # # # # ### #
#   # # # #                               #   #   # # # # #   #   # #   #     #
### ### # # ### ### ############### ##### # ##### # # # # # # # ### ### # # # #
# #   #   #   # #   #     #     # # # #                     #     #   # # # # #
# ### ##### ### ### ##### ##### # # # # # # ########### ##### ### # # ### # ###
#       #   #   # #   # #     # #   #   # #           #   # # #   # #   # #   #
######### # # # # ##### ##### # ### ### # # # # ######### # ### ####### ##### #
# # # # # # # # #       # # #         # # # # #     #         #   #   # #     #
# # # # ##### ### # ### # # ######### # ######### ##### ### # ### # ######### #
# # # #         # # # #               # # #         # #   # #   #       #     #
# # # ### # # # ##### ##### # # # ####### # ### ##### # # # ####### # # # #####
#   #     # # # #     #     # # # # #         #     # # # #       # # # #   # #
# ####### ### ##### ##### # ### ### # # ### ### ##### ### ####### # ### ### # #
#       # #   # #         #   # #     # #   #           # #     # # # #   #   #
# ##### ####### ### ####### # ### ### ##### ### # # ### ### ### # ### #########
# #     #           # #   # #   # #     # #   # # #   #       # #     #     # #
##### # ########### # # # # ######### ### ########### ### # ############# # # #
#     #     #       #   #     #               # #   #   # # #   #       # #   #
######### ### ### # ### ########### ### ####### ### # # # # # # # ####### #####
#     #   # # #   #   #     #     #   #           #   # # #   # # # # #       #
# ### ### # # ####### # ### # # # # # # # ######### # # # ####### # # ####### #
#   #     #     # #   #   # # # #   # # #       #   # # # #   # #             #
# ### ### ### ### # ############# ##### ####### # ##### # # ### # # ######### #
# #   #         #   #                 #       # #   #   #         #         # #
###############################################################################
