###############################################################################
#   #   # #       #             #       #   #     #           #     #       # #
### ### # ##### # # ####### ### # ##### ### ##### ### ############# # # ##### #
# #     #       #     #     #     #   # #   #         #       #     # # # #   #
# ### # ####### ### # # ########### # # # # # ##### # ####### ### # ### # # # #
#   # # #   #   # # # # #     #     #     #   # #   #   # #     # #   #   # # #
# ### ##### ##### # # # ### # ################# ### ### # # ######### # ##### #
# #   # # #   # #   # # # # #                 #   # # #       #   #     #   # #
# ### # # # ### # ####### ####### ##### ##### ### ### ### ####### ### ##### # #
#     #         # #       #     # #     #   # # # # #   #   # # #   # #       #
# ### ######### ### ##### # ############### # # # # ### # ### # # ### ### #####
#   #   #           #       # # # #         # # #   #         #     # #   #   #
##### # # ####### ### ### ### # # ####### ### # ### ##### ### # ##### # ##### #
#   # #   #   #   #     #           # # # #   #     # #   #             #   # #
### ######### # # # ### # ######### # # # ### ### ### # ##### ######### ### # #
#       #   #   # # #   # # #                         # #   #     #   # #     #
# ### ### # ### # # ####### ######### ##### ######### ### # ### # # ####### ###
#   # #   #     # # #                   # # # #       # # #     #   #     #   #
##### # # ##### ### ### ####### ### # # # ### ####### # ########### # ##### # #
#       # #     #   #   #       #   # # #                 # #     #       # # #
### ### ### # ### ####### # ### # ### ### ########### ### # # ##### # ####### #
#     # #   # #   # #     # #   # # # #   #   #       # # #     #   # # # #   #
# ### # # ######### ####### ### ### ### ##### ######### # ##### # ##### # ### #
# #   # #   #   #     #     #     #     #           # # #     #   # # # # #   #
# ####### ### # ##### # ### ##### # ####### # ### ### # ### # ### # # # # ### #
#   # #   # # # # #     #   #     # #       # # # #     #   #   #   # #   #   #
##### ##### ### # # ### ##### ####### ### # ### # ##### ### ### # ### ### ### #
#     #             # # #   #   #     #   #   #     #     # # # # # # #       #
##### # # ########### ##### # ### ##### ##### ##### # ### ### # # # # ##### ###
#   #   # #   #       #       #     #   #     #       # #           #     # # #
# ####### # # ### # ##### ########### ### ########### # # ####### # # ##### # #
#     # #   # #   # #     #       #   #   #   #     # #     # #   #           #
# ##### ######### ############### # ######### # ############# ##### # ### #####
#   #           # # #           #   #   #             #   #   # #   #   # # # #
# ########### # # # # ######### ####### ######### ### ### ### # ##### ##### # #
#         #   # #   # #         # #         #       # #   # #             # # #
### ### # # ### # ##### ### ### # # ####### ##### # # ### # ##### ### ##### # #
#   #   #   #           #     #     #             # #             #           #
###############################################################################
