###############################################################################
#     #       #       #     #       #     # #         #     #     # # #       #
# ##### ### ### ### ### ### # ##### # # ### # ####### ##### # ##### # ##### ###
#       #   #     #     #     # #     #       # #   #     # # # #   #   #   # #
# ####### ##### # ############# ### ########### ### ### ### # # ### # ### ### #
# # #     #   # #   # # # #   #   # #     #       #     # #   #   #     # #   #
# # ### ### # ####### # # # ##### ### ### ####### ### ### ### ### ### ### ### #
# #       # #                 # #     # # # # # #   #   #   # # # #   #       #
# ####### ############### # # # ### ### # # # # # ##### # ### # # ### ##### # #
# #   #   # #     # #     # #     #   #     #   #     # # #   #   #       # # #
# ### ### # ##### # # ### ####### ####### # ### ##### # # ### # ##### ####### #
# #           # # # #   # #     #       # #     #       #     # #   # #   # # #
# # ####### # # # # ########### # ##### ### # ######### ### ### ### # # ### # #
# # #   # # # #   #   # # #   #       #     #   #       # # # #   #   #   #   #
### ### # ### # # ### # # ### ############# ##### ##### # # # ### ### # ##### #
#   #     #     #             #           #     #   #   # # # #   #   # #   # #
# ####### ### ### ##### # ### # ######### # # ##### ### # # # # ### # # # # # #
#     # # #   #   #     #   #   #     # # # # #   # #     # # # #   # # # # # #
# ##### # # ### ########### ##### ### # # # ##### ####### # # # ### ### ### # #
# #           #   #   # # # #     #   # #   # #   # # #       # # #   #     # #
### ### ### # ##### # # # ########### # # ### ### # # ##### ### # # ### ##### #
#   #   #   # #     #   # # #           # #     #       # #       #           #
# ##### ######### # # # # # ### ####### # # # ####### ### # ##### # ### ### ###
# #         # #   # # #   #     # #         #   #     #   # #   #   # #   #   #
############# ### # ### # # ##### ####### # ######### ### ### ##### # #########
#   # # #         # # # #   #       #     # #   #   #       #           # # # #
### # # # ### # ### # ##### # ##### # # ### # # ### ### ### ####### ##### # # #
#   #   # #   # #   #       # #     # # #     #   #     #       # # #         #
# ##### # # ### # ########### # # # ### # ####### ############# # # # #########
#   # #   #   # #   #     #   # # #     # #   #   #           #       # #     #
### # ### # ### # # ### ### ### ############# # # # # ##### # # ####### # ### #
#     #   #   # # # # #     #       # #       # #   # #     #   #         #   #
# ########### ### # # # ### # # ##### # ### # # ####### ### ### # # ##### ### #
#           #   # # #     # # #   # #   #   #   #     #   # #     #     #   # #
####### ### ### # ##### # # # ##### # # ####### ### ### ##### ### ####### # ###
#       # #     # #     # # #   #   # # #       # #     #   # #     #   # # # #
# ####### ####### # ##### ### ### ##### ### ##### ####### ####### # # ### ### #
#   #             # #     #       #       # #                     #     #     #
###############################################################################
