###############################################################################
# #     #     #     #   #     #     #         # #         #     #   #         #
# ### # # ##### ### # ##### ####### ### ####### # ##### ### ##### ### ##### # #
#   # # #       #   #       #         # #     # #     #   #   #           # # #
### # ######### # # ### ### # ####### # # ### # ### ####### ### ### ##### ### #
#             # # #   #   #   #     #   #   #       # # #     # #   #   # # # #
# ######### # # ##### ####### ### # ### # ##### ### # # ##### # # ##### ### # #
#   #     # # # #   # #       #   #   #   #   #   # #       #   #   # # #   # #
# ### # # # # ### ### ####### ### ### ### # ########### ### # # ##### # # ### #
# # # # # # #   #     #     # #     #     # #   #   # #   #   #       # #     #
# # ### # ##### ##### ##### # # ######### # # ##### # ### # # ######### #######
# # #   # #     #   #   #     #       #       # # #       # # #   #     #     #
### # ### ##### # ##### ####### # ####### # ### # # ####### ### ### ##### ### #
#   # #         #       #       # #       #             # # # #     # #   # # #
# ### ### ##### ### ### # # # # ### ### ##### # ##### # # ### ### ### # # # # #
#   #   # #           #   # # # #   #   #     #   # # # # #   #   #   # # # # #
# ############# ##### # ### # # ##### ##### # ##### # ### # ##### # ### ### ###
#     #       # #     #   # # # #     #   # # #     #         #   # #       # #
# # # # ##### ########### ### # ### ##### # # # ####### ### ### # # # ####### #
# # # # #   # #     #     # # #   #   #     #         # # # # # #   #       # #
# # ##### ### ### ### ##### ################# # ### # # # ### # # # ### # # # #
# #     # #   # #   #   # #     # # #   #     # # # # #         # #   # # # # #
# ####### ### # ### ##### ##### # # # ##### ##### # # # ############### ### # #
#       # #       #       #   # #     # #       #   # #               # # #   #
# ### # # ####### # ##### ### # ##### # ### ### # # ### # # # ######### # # ###
# #   #     #       #         #               # # # #   # # #     #     #     #
# # ####### ####### # ####### ### ### ### ##### ############# ######### #######
# #   # #         # #   #         #   #       # #     #   #                   #
####### # # # # # # ##### # # ### ### # ### # ##### ### ### ### # # # # #######
#       # # # # #       # # # #   #   # #   #             #   # # # # # #     #
### ### # ##### # # ### ##### ##### ####### # ### ##### ##### ### # # # # ### #
#     # # #     # #   # #   #   #   #       # #       # #   #   # # # #   #   #
### # ### ### # ### # ### ##### # ##### # # # # # # ### ### ######### ##### ###
#   # # #   # #   # #   # # #   #     # # # # # # #   #     #     #     #   # #
# ### # # ### # ####### # # ########### # ### ### ### # # ### ####### ### ### #
# #   #   # # # # #           #         # #   #     # # # # #       # #   #   #
# # # # ### # # # # ########### ### # ####### # ####### ### # # # ### ##### # #
# # #     #   #   # #           #   #       # # #             # # #         # #
###############################################################################
