###############################################################################
#                     #             #   #   #       #   #     # #   #     #   #
# ##### ### ### # ############### # # # # # ### # # # ### ##### ### ##### ### #
# #   # # # #   #         #   # # #   #   #     # # #     # # #   #       #   #
##### # # # # ######### # # # # # ### ########### # ### ### # # ### ####### # #
#       #   # #         #   #     #   #         # #     #               #   # #
### # ######### # ### # # ### ########### # ### # ##### ##### ############# # #
#   #   # #     #   # # # #   #           # #     #         # # #   # # #   # #
# ####### ####### # # ##################### ####### ### # # # # ### # # # #####
# #   #   #       # #     # #   #           #         # # # # # # #       #   #
# ### ### ##### ### ####### # ####### ############### ### ### # # # # ##### ###
# #           # #   #         #       #       #       # #       #   #         #
####### ### ##### ### ####### ########### ####### # ### # # ### # #############
#   # # # #     # #   #       #       # #     #   #     # # #   #             #
# # # # # # # # ### ######### # # ### # # ####### ### # ####### ### ##### ### #
# # #   #   # #     # # #   #   # #         #       # # #   #           #   # #
# # ####### # ### ### # ### # # # ##### # # # # # # ### ### # ### ########### #
# #       # # #   # #     # # # # #     # #   # # #   # #     #         #   # #
# ##### # # ####### ### ### ### ##### ### ### ### ######### ### # ####### #####
# #     # # # #   #                 #   #   #   #   #         # #       #   # #
### ##### ### ### ########### ##### # ##### ####### ############# ### ### ### #
#     #         # # #       # #   # # #         #   #     #       # #         #
### ######### # # # ####### # ### ##### # ### ### ####### ### # ### # #########
# #   #   #   # # #     # # # # #       #   # #   #         # #   #           #
# ### ### ##### # ##### # # # # ########### # # ### # # ### ##### # # ### #####
#   # #   #   #     #         #   # #   #   # # # # # # #         # #   #     #
# # # # # ### # ### # # ### ### # # # # # ### ### # ### # ####### # # ##### # #
# #   # # #       #   # #   #   #     #   #   #   #   # # #       # #     # # #
######### # ### # # ### # ######### ### ### ### # ### ##### # ##### # ### # ###
#       # # #   # #   # #   #         # #       #   #     # # #     # #   #   #
# ##### # ### ### # ### ### # # ### ##### # ####### # ##### ####### # # ### # #
#   #         #   # #   #   # # #       # #       # #     # #       # # #   # #
# # ##### ####### ### ### ##### ####### ### ### ##### ##### ### # ##### # # ###
# # #       #       # #     # # #   #   #     # #     #   # #   # # #   # #   #
# ########### ### ##### ##### ##### ######### ### ##### ########### ##### # ###
#   #     # #   # # #   #   #             #   #     #       #     #       #   #
# ### ### # ####### ##### ### ##### ### # # # # ### # ##### # ##### ### # ### #
# #     #                     #       # #   # #   # #   #           #   #   # #
###############################################################################
