###############################################################################
#   #       #                                   #                             #
# ######### # ################# # # ####### ### # ######### # ### ### ##### # #
#     #         #             # # #   #     #     #         #   #   #     # # #
### ############### # ### ### ######### # ####### ####### ### ### ### # ### # #
#                   # #   #     #   #   # #   # # # #   # #     #   # #   # # #
######################### ##### ### ### # ### # ### ### # ### ##### # # ### # #
# # #                 #   #     # #     # # #     #       #     #   # # #   # #
# # ### ##### ### ### ##### ### # # ####### ##### # ### # # # # # ### ####### #
#       #     #     #       # # #         #         #   # # # # #   # #     # #
# # ######### # ####### # ### # ##### # ########### ### ##### # # # # # ### # #
# # #     #   # #       # #           #   #           # #     # # # # #   # # #
### ### # ### ############# ### # ##### ### # ### # # # ####### # ### # # ### #
#   #   #     # #     #     #   #     # #   #   # # # #   #     #   #   # # # #
# ############# ##### ##### # # ####### # # ############# ##### # ######### # #
#   #   #                   # #     # # # # #   # #       #     #           # #
# ### # ########### # ##### # # ### # # ####### # ### ### # ### # ##### ##### #
# #   #             # #   # # #   #   #   #           #   #   # #     #     # #
# ### ##### ##### # ##### # # # ### ######### ############# # # # # # # # # # #
# #   #     # # # #   #     # # #   #       # #             # # # # # # # # # #
# # ####### # # ##### # # ##### # # ### ### ### ##### ### # ### ####### # ### #
# # #       #         # # #     # #   #   #     #   # # # # #   #       # # # #
# # ##### ### ##### # ### ### ##### ##### # ### # # # # # ### # ### ##### # ###
# # #       # #     #   # #   #   # #     # #   # # #   #   # #   # #         #
### ############### # # # # ### ######### # ##### ### # # # # ### # # ### ### #
# # # #           # # # # # #   #     #   #   #       # # # #   # # #   #   # #
# # # ### ####### ### ### # # ####### ##### # ### # ####### # ### ####### ### #
# # #   # #     #       # # # # #   #       # #   # #   #   #   # #   #   #   #
# # # ### # # # ### # ####### # # # # # ### ### # # # # ### # # ### # # # ### #
#   #     # # #     # #   #       # # # #   #   # #   #   # # # # # #   #   # #
####### ####### # ### # # ####### # ### ######### ##### # # ### # ### # ### ###
#   #   #     # #   #   #   # #   # #   #     #   #     # #   #   #   #   #   #
# # # ####### ##### ### # ### ### ####### ### ### # ### ### # # # ### ### # ###
# #   #         #     # # #   #             #     #   #   # # # # # # #   #   #
# ########### ### ####### # ######### ######### # ### ####### ### # # ##### # #
# #                 #     # #   #     # #     # # # #   #     #     # #     # #
# ############# # ### ##### # # # ##### # # # # # # # ##### ######### ### ### #
#         #     # #           # # #       # #   #   #   #   #         #     # #
###############################################################################
