###############################################################################
#   #   #       # #                         #   # #   # #   #       #     #   #
# ##### ##### # # ### ### # ### ##### ### ### ### # ### ### ##### ##### # ### #
#             #       #   #   # #       #               #               # # # #
# # ##### ### ### ### ##### ### # # ### # ### # ########### ########### ### # #
# # #     #   #   #   #     #   # #   # #   # #     #           #   #     #   #
### ##### # ### ##### # # # ### ##### # ##### ######### ### ##### # ### # # # #
# # #     # #       # # # #   #     # #     #     # # # # # #     #   # #   # #
# ### ### # # # ### # ### ##### ##### # # # # ##### # # # # # # ########### # #
#   # #   # # # #   # #   #   # # #   # # # #             #   #   #     # # # #
### ########### ##### # # # # ### ### ### # # # ### ### ##### ### # ### # ### #
#               #   # # #   #   #       # # # #   #   #     # #     #       # #
####### # ### ### ### # ##### ### # ####### ### # ### # # # # # ##### # #######
#       # #       # # #     #   # # #     #   # #   # # # # # #     # # #   # #
# # ##### # # ### # ##### # # ##### # ############# # # ### ##### ##### # ### #
# # # # # # # #       #   # #   #                 # # #   #   # #   #     #   #
# ### # ### # # # # # # ##### ##### # # ##### ### # ##### # ### ### ### ### ###
# #         # # # # # # #   # #     # #   #   #   # #   # #       #   #     # #
### ### ### ####### ### # # # ### # # ################# ######### ##### ##### #
#   #   #     #       # # # #   # # #               #         #   #     # #   #
# ### ### # ##### # ### ### # # # # ### ######### # # ##### ### ### # ### # # #
# #     # # #     #   # #     # # #   #   #     # #   # # # #   #   #   # # # #
# # ### ### # ### ### ### # # ####### ### # ########### # ######### ##### # # #
# #   #   # # #   #     # # #   #       #             #   #     # #   #     # #
# # ##### ##### ### # ############# # # # ### ##### ### ### # ### ### ### #####
# # #     #   # #   #       #       # # #   # #           # #     # #       # #
### # # ### # ### # ######### ### # # # # ### ### ### ### # # ##### ####### # #
#   # # # # #     #   #       #   # # # #   #   # #     #   #     # #     #   #
# ### ### # ### # # # # # # # # # ### # # # ##################### # # ### #####
#   # # #   #   # # # # # # # # # # # # # # #           # # #   #   #   #     #
### ### # ##### ### # # # ##### ### # ### # # ######### # # # # ### # ### # ###
# #   #   # #     # # # # #       #     # #           #     # # # # # # # #   #
# # ##### # ####### # # ##### ### ####### ##### ##### ### ### ### ### # ##### #
#   #     #     #   # # #     # # # #         #     # #           #   #   #   #
# ############# # # ########### # # # ##### # ##### # # ##### ### # ### ### ###
# #   #   #     # #     # #       #   # #   # # #   # #   #   # #     #   # # #
# # # # # # # ####### ### ### ### ##### ### # # # ##### ### ### ######### # # #
#   #   #   # #         #       #   #       #   #     #   #       #           #
###############################################################################
