###############################################################################
# #   #   #         #   # #   # # #   #                       #             # #
# # # # ##### ##### # ### ### # # ### ##### # ####### ####### # ### ##### ### #
#   # # #     #     # # # #   #       #     # #     # #     #   # # # #       #
# ### # # ##### # ### # # ### # ############# # ####### ##### ### ### ### ### #
# #   # # # #   # #     # # #       #   #     #   # #   #   #   #       #   # #
# # ### ### ##### ##### # # # ##### # # ##### ### # # ##### ### ### # ##### # #
# # #     # #                 # #     # # # # #   # # #       #   # #   #   # #
### ##### # # ######### ####### # ##### # # # ### # # # ######### # ##### #####
# # #       # #   # # # #       # # # #       # # #   #   #     #   #   # #   #
# # ####### ##### # # # ##### # ### # ### ### # # # # # ### ### ##### # ##### #
# #     #       #     #     # # # #       # #       #         #       #     # #
# ### # # # # # # ### ### # # # # # ##### # ### ####### ####### # # # ####### #
#     #   # # #   #       # # #       #   #           # #   #   # # # #   #   #
# # # ##### # ##### ############# ####### ##### # # # # # ######### ##### # ###
# # #   # # # #     #     #   #   #     # #   # # # # #   #   #           #   #
### ### # # # ### # ##### ### # ####### ### # # ####### ##### ############### #
#   # #   # # # # #   #   #     #   #       #       #           #             #
# # # ####### # # ##### # # # ##### ####### # ### ### ##### ### # ####### ### #
# #   #   # #   # #     # # #   #           #   # # #     #   #   # # # #   # #
### ### ### ### ### ### # # # ### ####### ### # ### # # ####### ### # # ### ###
# # #     # # # # # #   #   # #   #     #   # #     # # #     # #   #     #   #
# ### # ### # # # # # ### # # ##### # # # # # ######### # # # ### # # # ##### #
#     #     # #   # #   # # #   #   # #   # #         #   # #   # # # #     # #
# ##### ### # ### # # # ##### # ### ##### # # # ### ### ### # ##### # ####### #
#   #   #   #     # # #   #   # #       # # # #   #   # #   #           #   # #
# ##### ### # ##### # ######### ### ### # # # # # # # # ### # ##### # # # # # #
#   # # #   #   # # # # #   #   #   #   # # # # # # # # #   # # #   # #   # # #
### # # ### # # # # ### # # ##### ######### # # ### # # ##### # ##### ### # # #
#   #     #   # #   # #   #       #         # # #   # #   #   #         # # # #
##### # ####### # ### ##### # ##### ##### ##### # ##### # ### # ### ##### # # #
#     #   #     # #     # # #   #     #     #   #     # #   # # #   #     # # #
# # ##### ############# # # ### ### ##### ##### # # ### ### # ### ##### # # # #
# # #       #             # #   #   #   # #     # #   #   # # #   #     # # # #
# ############# # # ##### # ### ##### # # # # ##### # # ##### ######### ### ###
# #   #     #   # # #       # # #     # # # #     # # # # #     #   #   #   # #
# # # # ### # ##### ##### ### ####### # # ######### ##### # ####### ### # # # #
# # #   #     #       #   #           #           #       #           # # #   #
###############################################################################
