###############################################################################
#     #       #     # #     #   #                       # #     #       #   # #
### # # # ##### # # # # ### ### ########### ##### ### ### # ### # ### ##### # #
#   # # #   #   # # # # # # #     # # #   # #   # # # #     # # # # # # #   # #
# ##### ##### ##### # # # ####### # # # ##### # # # # ### ### ### # ### ### # #
#     #   #   #   #         # # # # # #   #   # # #         # # # # #   # # # #
# ### ### ### # # ######### # # # # # ### # ######### ####### # # # ### # # # #
# #       #     #   #         #   # # # # #     #   #     #   #         # # # #
### ########### ### # # ### ##### # # # # # ####### # ### # ####### ##### # # #
# #       #   #   # # # # # #       #   # #   #       # #   # # # #       # # #
# ### ### # ### ######### # ####### # ### ### ### ##### ### # # # # ####### # #
#       #     # #   #     # #     #     #   # #   # #   #   #     # #   #   # #
# ##### ### # ### # ##### # # ### # # ### ### # ### ### ######### # ### # ### #
#   # #   # #     #   # # #   # # # # # #     #   # #   #       #   # #   #   #
##### # ### # ####### # # ##### # ### # # ####### # # ######### # ### # ##### #
#     # # # #   # #   # # # #     #     # #   # #   # # # #       # #     #   #
# # ##### # ### # ##### # # ##### # ##### ### # # ### # # ### ##### # ##### # #
# #           # #         #       # #   #   #       #   # # # # #   #   #   # #
############# ##### ### # ### # # # ### # ####### ### # # # # # # ##### # ### #
#   #       #   # # #   #   # # # #   #           # # # # # # #       # # # # #
### # ### ##### # ##### ### ### # ### ### ### ### # # ### # # # # ##### ### # #
# #   # #       #     # #   #   # #       #     #     # # # # # #     #   #   #
# ##### ### ### ### ##### # ##### ########### ####### # # # # ### ####### # ###
#   #       #       # # # # # #     # #   # # #     # # #     # #     #       #
# # ### ##### # ### # # # ### ##### # ### # # ##### # # ### ### ##### # ##### #
# #   # #     #   # #   #     #     # # #   # #       #     # # #           # #
### ### ########### # # ### ##### ### # ### ### ##### ### ### # ##### ### #####
#   #       #     # # #     #         # # #   # #             # # # # # #     #
# ### ### ### ### # ####### # ### ##### # ### ############### # # # # # #######
#   # #   # # #         #   # # #     # # #     #           #             #   #
# # # # # # ##### ### # ### ### ### ### # # ### ##### ### # ### ####### # ### #
# # # # # #       #   # #     #           #   #       #   #       #     # #   #
# # ################### # ##### ### # ### ########### ### # # # ####### # # ###
# #       #       #   #   #   # #   #   #   #     # # #   # # # #     # # #   #
# ####### ### ####### ### ### ### # ####### ### # # # ######### # # ##### ### #
#   #     #   #     #       #     # #       #   #   # #           # # #   #   #
# ##### ### # # # ### # ### # ### ### # # ######### # ### ########### # # # # #
# #         #   #     #   #   #   #   # #             #   #             #   # #
###############################################################################
