###############################################################################
#   #       # # #           #   #     #   #   #               #     #   #   # #
# ### ####### # # ### # ##### ### # # # # # # ### ######### ##### # # # # # # #
# # # # # #   #     # # #     #   # #   #   #     #     #   # # # #   #   #   #
# # # # # # # ##### ####### ### ### # ########### ### # # ### # # #############
#   #     # #   #         #   #   # #   # #     # #   # # #   #   # #       # #
### # ### # # ##### ### ##### # # ####### ### ### # ### ### ### ### ##### ### #
#   # #     #     # #   #   # # #   #   #       #   #   #     # #             #
### # ##### ######### ### # # # ### # # # # # ############# ### # #############
# #   # #       #       # #   # # # # #   # #   #     #         #   #     #   #
# # ### ############### # ### # # ### # ##### # # # # # # # ### # ##### ### ###
# #     #     #   # #       #   #   # # #   # #   # #   # #   # #     # #   # #
# # ### ##### ### # ### ####### # ### ### # ####### ########### # ##### # ### #
#   # # # #   #     # # #   #     #     # #       # #   #     # # #   #   #   #
# ### ### # ### ##### # # ########### ### ### ### ### ##### # # # # ### ### ###
# # #   #         # # #   #     #           # #     # #   # # #   # #   # #   #
# # # ########### # # # ### ####### ####### ### ### # # # ### # # # # ### # # #
#     #   #   #   # # # #     #   #     # #   #   # # # #   #   # # #   #   # #
# ### ### # # ### # # # # ##### ### ### # ### # # ### # # ##### ### ### # ### #
# # #   # # #   #     #           #   #   # # # # #   # # #   # #   # #   # # #
### # ### # ######### # ### ### # # # ##### ####### ### # # ##### ### # ### # #
#               #       #   #   #   # #     #       # # # # #   #   #   # #   #
# ### ### # ### # ######### ############# # ### ##### # ### # ##### ### # # ###
# #   #   #   #           #   #         # #   #           #           #   # # #
# ##### ######### # # # ##### ### # ####### ### ########### ### ##### ### ### #
#     # # #       # # #   # #     #   #   #   #     #     #   #     #     # # #
# # # ### # # ### # # ##### # # # ####### # # ##### # # ####### ####### # # # #
# # # #     # #   # #       # # # # #       #   #   # #         #   # # #   # #
### ##### ### ### ##### ##### # ### ##### ####### ### ### ####### # # # # ### #
#     #   #   #     #   #     # #     #   #   #     #   #       # #   # #     #
# ### ##### # # # ### # # # # ### # # ### # ### ####### ##### ### ##### ##### #
#   #   #   # # # #   # # # #   # # # #           #         #         #     # #
# # ##### ### ### # # ### ### ### ############# ### ####### ##### ####### # ###
# #     #   # #   # #   # #     #               # # #     # #   #       # #   #
# ### ### ##### ### # # ####### # # ######### ### # # # ##### ### ### ### ### #
# #     #   #   #   # #     # #   #   # #   #     #   #     #   #   #   #   # #
### ##### # ### # # ### ### # ### # # # # ######### ### ####### # ######### ###
#   #     # #   # # #     #   #   # #                 #         #       #     #
###############################################################################
