###############################################################################
# #           #   # #           # # #     #                       #   #   #   #
# # # ### # ##### # ##### ### # # # # ########### ####### ### ##### ### # # # #
# # # # # #       # #   # # # # # # # #     #     # #   # # #   #   #   # # # #
# # ### ######### # ### # # ##### # # # ####### # # ### # # ### # ### ### ### #
# # #   #   #     # #       #   #   # #   #     # # # # # # # #   #     # #   #
# ### # ### # ### # # ##### # # # ### # ##### # ### # # ### # ####### ### # ###
# #   #     # #         #     #   #   # # # # #   #   #     #       # # #   # #
# # # ### ##### # # ############# ### # # # ##### # ### ### ####### ### ### # #
#   #   #     # # #   # #   #   # #   # # #   #       # # #     # # #   #     #
### ######### # ##### # ### # ### # ### # ### # ####### # # ##### # ### # #####
#   #       #   # #     # #     # # #     # #             #     # # #   # #   #
### ##### # ##### ##### # ### ##### ### ### # ####### ####### ### # ### # # # #
#       # #     #     #       # # #       #     #   #   #         #     # # # #
# ### ### ### # ### ##### ##### # ##### # # ##### ################# ##### # ###
#   # #   #   #   #         # #   #   # # #   # #             # #       #     #
########### ### ##### ### # # # ### ##### ### # # ### ### ##### # ########### #
#     #     #     #   #   #   # #     #   # #     # # # # # #   # #           #
# ### # ##### ### ##### ### ### ### ### ### # ##### ### ### ### # # ### ### ###
# #   # # #   #     # # #     #   # # # #   # #     #     # # #       #   # # #
# # ##### ##### ### # ##### ##### # # # # # # # ##### ##### # # ### # # ##### #
# #   # #   # # #     # #   #     #     # # #     #     # # # # # # # #   #   #
##### # ### # ####### # # ### # ### # ### ### ##### ##### # # ### ### ####### #
#         # #             #   #   # #   #         # #     # # # # # # #   #   #
######### # # ########### # ##### # # # ### ####### # # ### # # # # # # ### ###
# #   # #   # #   #     #   # #     # # #       #     #   #       # # #   #   #
# # ### ### ##### # ### ### # ############# ### ### # ### # # # ### # # ##### #
# #   # # #         #         #   #       #   #     # # #   # # #   # # #   # #
# # ### # ####### # ### # # ### ### ####### ##### # ### ##### ##### # # # # # #
#     # #         # # # # # # #   # #   #   #   # #     #   # #     # # # #   #
# ### # ### # ####### ##### # # ### # # # ### # # ### ### ### # # ### # # ### #
#   #     # # #                 #     #   # # #     #     #     #   # # #   # #
# ####### ### # ##### ####### # # ######### ##### # ############### # # # # ###
#   # #   #   # #     # #     #                 # #           #   # #   # #   #
### # ##### # ### ### # ### # # ##### ### ##### # ### ##### # # # # # ### ### #
#     #     #   # #   #     # # #   # # #     # #   # #   # # # #       #   # #
# # ####### ### ##### ####### ### ##### ### ####### ### # ##### ####### ##### #
# #         #       #     #               #       #     #   #         #       #
###############################################################################
