###############################################################################
#           #       #               # #   # # #   #                           #
####### # # ### ### ##### ######### # # ### # # ### ### ########### # ### ### #
#     # # # # # #   #     #   #     #     #   #     # # #   #   #   #   #   # #
# ### ### # # ### ########### # # ####### # # ### ### ### ##### ##### #########
#   #     # #   #       #   #   #   #   #   #   #   #     #   #     #   # # # #
### ### ### ### ####### # ####### ##### ####### ### # # ### ####### ### # # # #
#   #   # #       #   #     #       # # #   # #   #   #             # # #     #
##### # # ####### # # ### ######### # # # ### ### ##### ####### # ### # ### ###
#     # #           #           #   # #   #       #   # #     # # #       # # #
############# ##### # ### ##### ### # ### ##### # ### # # ####### ######### # #
# #     #     # #   # #   #     #         #     # # #     #     #           # #
# # ### # ##### # ########### ######### ### ##### # # ### ### ########### ### #
#   #           # #     # # #   # #   # # #   #     # # #       #   #   #   # #
########### ####### ##### # ### # ### # # ####### # # # ### ##### ### # ### # #
#           #     #     # # #     #   # #   #     # #     #   #       #   #   #
# ############### ##### # # ### ##### # ### ### ### # # ##### ### ### #########
#   #           #   # # #     #   # #   #     # #     #   # # # # # #   # #   #
##### ##### ### # # # # ### # # # # ### ##### ##### ####### ### # # ##### # ###
# #   # #   #     # # #   # #   #       #     # # # # #     #   # #   #       #
# # ### # ##### ### # ### # ########### ##### # # # # # # # # ### ### ####### #
#       # #   # #   # #     #             # # #         # # #       #   # #   #
######### ### ### ### ##### ### # ####### # # ##### # ### # # ### ### ### # ###
# #   #   #               # #   # # #           #   # # # #     #   # #     # #
# ### ##### ##### ####### ####### # ########### # ##### ##### ####### # ##### #
#   # #       # # #     #   #   #   #         #             #         #     # #
# # # ######### ####### ### ### ############# ### ### ####### ### ##### ##### #
# #   # #   #   # #       #   #     #   #           #     #     #         #   #
### ### # ### # # ### ### ### ##### ### ### ### # # # ##### ### ########### ###
#     # # #   #   #   # # #             #   # # # # #   # # #               # #
##### # # # ##### ##### # ########### # ##### # # # # # # ### ### ####### ### #
# # # #     #   #               #   # # #     # # # # # #   # #   #     # #   #
# # # ####### # ####### ##### # ### # # ### ### ##### # # # # # # # ### ### ###
#         #   #     #   #     #     # # # #     #   # #   # # # #     # #     #
####### ######### ### ############# # # # ### ### ##### # ####### ####### #####
#     #               # #         # # # #     #   # # # #     #       # #     #
# # # ##### ####### ### ######### # # # ####### ### # ### ##### # ##### # # # #
# # #       #         #               #                       # #         # # #
###############################################################################
