###############################################################################
#         #   # #   # #   #         #     #     #     # #   #       #   #     #
# ### # ### ### ### # ### ####### # ### # ##### # # ### # ### ### ### # ### # #
#   # #           # # #   #     # # #   #   #     #             #     #     # #
# ### ####### ### # # ### # ### ### # ##### ##### ####### # # ### ### ### ### #
# # #   #   # # #   #       # #   # # # #   #         # # # #   # # #   #   # #
### ### ### # # ### # ##### # ### # ### ### # # ### ### # # # # # # # ##### ###
#       #   # #       #     #             #   # #     #   # # # # #       # # #
### # ### # ####### # ### # # ##### ##### # # ### ##### # ### # ### ######### #
#   # # # #         #   # # # #     #       #   #     # #   # #   #       #   #
####### # # ### ########### # # # # ####### # # # ##### ### ### ####### # # # #
#     #   # #     #         # # # # #       # # #     #   # #         # #   # #
### # ##### # # # # ##### ####### ######### ### ### ### ### ### # ####### #####
#   #       # # # #   #   # #   # # # #       #   # #     # #   # #     #     #
### ##### ######### # # # # # # # # # # ### ##### ##### # ######### ##### # # #
#   # #   #         # # # #   #   #     #       #     # # #         #   # # # #
# ### ########### ######### # ########### ### # ####### ### ### # ### # ### ###
#   #       #   #     #     # #     #       # #       #     #   #     #   #   #
# ##### ### # ########### # # ##### ### # # ### ### ### # ####### ##### # #####
# #   #   # #     #   #   # # #         # #   #   #   # #     #       # #     #
# # ####### # ### # # # ####### # ##### # ####### # # # ####### ######### #####
#   #         #     #   # #   # # #     #       # # # #   #   #         # #   #
# ##### ######### ### ### ### ##### ##### ### ### ####### # ##### # # ### # ###
#   # # #       # # #   #         # #       #   # # #   #       # # #   #     #
##### ### ##### # # ############# # ##### # # # ### # # ### ### # ########### #
# # #       #     #             # #   #   # # #   #   #   # # # #     #   #   #
# # # ####### ##### ### ####### # ##### # # # # # # ### ##### # # # ### # ### #
# #   #       #   # #     # # #         # # # # #   #     # #   # #     # #   #
# ##### ### ##### # ### # # # # ### ### # # # # ### ####### ####### # ##### ###
# #   # # # #   #   #   # #       # #   # # # # #   #     #   #   # # #   # # #
# ### # # ##### ##### # ######### # # # # # # # # ##### # ### # ### ##### # # #
#           # #       # # #       # # # # # # # #   #   # #   #         # #   #
############# # ##### # # ##### ### ##### # ####### # # ### ####### ##### #####
#   #   #       #     # #     # #       # #   #       # # #   #   #   #       #
# # # # ######### # ####### ### ##### # # ### # ### ##### # ### # ### # # #####
# #   #     # #   #   #   #   # # #   # # #   # #             # #   #   # #   #
##### ##### # # ### ##### # # # # ### ##### ######### ### # ### # ### ### # # #
#       #       #     #     #   #     #     #         #   #     #   #   #   # #
###############################################################################
