###############################################################################
#   #   #       #     #         #     #       #                     # #       #
# ### ######### # ####### # # ####### ####### # ### ######### ##### # ### # # #
#   #     #   #   # # # # # # # #       #   # #   #   #     #   # # #   # # # #
### ##### ### ### # # # ##### # ### ##### # # ### ##### # ####### ##### # # # #
# #     #     #   # #           #       # #       #   # #     #     #     # # #
# # ### ##### ### # # ########### ##### ##### ##### # # ##### # ##### ##### ###
#   # #           # #   #   # # #     #             #   #     # #     #     # #
# ### # ####### # # ### # ### # # ##### ##### # # ### # ##### # # # ### ##### #
# # #   #     # # #             # #   #     # # #   # #     # #   # #   #     #
### # ### ### # ### # # ######### # ######### ######### # ##### # # # ##### ###
#       # #         # #             #   # #   #   # #   #   #   # # # #   #   #
# ######### # ### # ####### ######### ### ##### ### ############# # ### ### # #
#     # #   # #   #   # # #     #         #   #     #   #   #   # #       # # #
##### # ##### # # # ### # ####### # ### ### ####### # # # ### # ##### ####### #
#   # #       # # #   #   # #     #   #       # #   # # #     # #             #
### # ##### ### # # # # ### ### ##### # ####### ### ### # ######### # ### #####
#   # # #   # # # # #     # #   # #   #               #     #       # #       #
# ### # # ### # # ####### # # ### # ####### ####### ### ### # ####### ### ### #
#     #   # #   # #   #       #   # #   # #   #   #       #   # # # # #     # #
# ### # ### # ##### # ######### ##### ### ####### # ########### # # # # ### ###
# # # # #         # #                     #         #   #     #       #   #   #
# # # # # # ### # # # ##### # # # ### ##### ##### # # ### # # # # ### ### #####
# #   # # # #   #   #   #   # # #   # # # #   #   #   #   # # # # #     #   # #
# ##### ####### ### ####### # ####### # # # # # # # ### ### ####### # # ### # #
# # #   #       #       #   #       #     # # # # # #   #   #       # # #     #
### ### ### # # # # ### ### ##### ### ####### # ### # # # ##### # ### # ### ###
# #   #   # # # # #   #   #     #   #     # # # #     # # #     #   # #   #   #
# # ############# ######### # ### # ##### # ##### ### ### # ####### ##### ### #
# # #     #           #     #   # #     # # #   # #     # #       #     # # # #
# # ##### # ### # ### ##### # # # # ####### # ### # ### ######### ### ### # # #
#             # #   #     # # # # # #       # # # # # #     #   #   #   # #   #
### ##### # # # ### ########### # ##### ### # # ### # # ##### ####### ### # ###
# #   # # # # #   #   #       # #         #   #   # # # #   #     #     # #   #
# # ### # # ##### # ######### # # # ### ### ##### ### # # ### # ### # # #######
#     # # #   # # #     #   # # # #   #   #       # #         #   # # #       #
# ##### ### # # ### ### ### # # ##### # # # ##### # ####### # # ####### # #####
#     #     #     #   #   #     #     # # #     #     #     # #       # #     #
###############################################################################
