###############################################################################
# #             #   #   #               #       #     #         # # #       # #
# # ######### ### # # ### # ### ####### ### ##### # ####### ##### # # ####### #
# #       #     # # # #   # #   #       # #     # #   #     #     # #         #
# # ##### # ##### # # ##### # # # ##### # # # ####### ##### ### ### ### # ### #
#     #   #   # # # # # #   # # # #   #   # # # #   #     #   #     #   #   # #
### ### # ### # # # # # ##### ####### ### # ### # # ##### # # # ##### # # # ###
# # #   # #   #   #       # # # #     # # # # # # # #   #   # # #     # # #   #
# ########### # ### ### ### # # ### # # # # # # ### ### ### # # # ### # ##### #
#             # #   # #   # #     # #   #   #   # #   #     #   # # # #   # # #
############# ### ### ### # # ######### # ##### # ### # ######### # # # ### ###
#           #     #   # #   #   #                 #               # # #   #   #
######### ### ##### ### # ############### ############# ####### ### ##### ### #
#         #   #   #   #         #           #   #   #   # # # # # #   # #   # #
# ######### # # ##### ### # ############# ##### # ### # # # # ### ### # ##### #
# #   #   # # # #   # #   #             # #   #     # #       #     #   # # # #
# # # # # # # # ### # ### ### ### # ### # # # ##### # # ####### ####### # # # #
#   # # #   # #   #   #     # # # # #     # #     #   # #       # #   # # # # #
##### # ######### ### ####### # ######### ### ##### # ### ####### # ### # # # #
#     #       #   # #     #   #   #       #   #     #     #               # # #
### # ######### ### ##### # ##### ### ### ### # ########### ### ########### # #
# # #   # # #     #     #   #     # # #     #     #         # # #   # #   # # #
# # ### # # ### # ##### ######### # ##### ### ### # ####### # # # # # # ### # #
# #   # #       #       #   #       #     #     #         #   #   # #         #
# # ############# ##### ### # # # ####### # # # ### ### # ############# #######
# #   #           #           # # #         # #   #   # # # #       #   #     #
# ### ### ####### ####### ####### ##### ##### # # ##### ### # ####### # # ### #
#   # # #   #     #       #         #   #     # #     #     #         #     # #
### # # # # ####### # # # # ####### ############# # # ######### ############# #
#   #     #   #   # # # # # #         #   #       # #   #   #     #   #     # #
# # ### ######### ### # # ### ### # # # # # # # # ####### # ### ### ### ##### #
# # # # #     #       # #   #   # # #   #   # # #   # #   #                 # #
# # # ### # ####### # ### ##### # # # # ### ### # # # # ####### # # ####### ###
# # # #   # # #   # # # #     # # # # #   # #   # #         #   # #   #   #   #
# ### ##### # # # # ### ##### ### # ### # ### ### ### # # ### ### # ##### #####
#   #         # #   #         # # #   # #   #   #   # # # # # #   #       #   #
# # ### ### ##### ### # ####### ### # ##### # ##### # # ### # ######### # ### #
# #     #         #   #       #     #     # #     # # #     #     #     #     #
###############################################################################
