###############################################################################
#           #           #   # # #     #           #   #   #       #     #   # #
# ##### ####### # ##### # ### # # # # # # # ##### ### ### ####### # ##### ### #
#     # #   #   # # #   #   #     # #   # # #   #     # # #   #   # # # #   # #
### # ##### ##### # # ##### ### ### # # # ##### # ### # # # # ### # # # ### # #
#   #         #   #         # # # # # # # #     # #   #     # #       #   #   #
############# ##### ### ##### ### ############# ### ### # ### ####### # ##### #
# #           # #   # #   # #       #     #     #   #   # #   #       #     # #
# ####### ##### # ### ### # ##### ### ####### ### ####### # ### ##### # ##### #
# #       #   # # #     #   #         #   #         #     #     #             #
# ### # # ### # # ##### ### # ####### ### # # # ### # ##### # # ### # # # ### #
# # # # #   # # #   #   #     # #   # #     # # #     #     # #   # # # #   # #
# # ####### # # ### ### # ### # ### # # ### ##### ### # ##### ### ### # # # # #
#   #       #       # # # # # #         # # #       # # #     #   #   # # # # #
### # ##### # ##### # # ### # # ### ##### # ### # # ### ### ####### # ####### #
#   #     #   #   #   # #     # # #   #     #   # # #     # #       # #       #
# # ######### # # ### # ### # ### # # ### # ##### # ####### ##### ### ##### ###
# #     #   # # #     #     #   # # # # # # #     # #       #     # # # #   # #
# ### ### # ######### # # ##### # # ### # ##### ### ### # # # # ### ### # ### #
#   #   # # # #     # # #     # # # #   # #     #     # # # # # #         #   #
##### ### # # # ### # # ### ##### ### # # # ### # ### ### # ####### ### ### # #
#         # #     # # #   # # #       # # # #   # #   #   #   # #     #     # #
##### ##### ####### ######### ##### # # # ### # ### ######### # ####### ### ###
# #     #   #   # # #           #   # #   #   #   # #         #     #   #     #
# ### ### ##### # # ####### # # # ### ####### ##### ##### # # ##### # ####### #
#   # # #   #               # #   #   #       #     #     # #   #     #       #
# # ### # ### ### ####### ####### ####### ##### ##### # # # ##### # # # #######
# #           #   #     # #           #     # # # #   # # #   #   # # #       #
# ##### ### # ### # ### # # ##### # # ### ### # # # ##### ### ##### ##### ### #
#   #   #   # # # # # # # #   # # # #   #   #     #   #   #   #     #     #   #
# # ### # ##### ### # ### ##### # # ### ### ######### # ### # # ### # # # # ###
# # #   #       #   #   # #     # #   #   # #         #   # # #   # # # # #   #
##### ########### # # ### ##### ##### # # # ### # ####### # # ### # # # ##### #
#           #     #       # #         # # # #   #       # # #   # # # # #     #
### ##### ##### ########### # ##### # # ####### ########### # ### ### # # # # #
# #   #   #     # # # #       #     # #   #     #           # #     # # # # # #
# ### # ### # ### # # ### # # # ### # ########### ### ##### ### ### ######### #
#     # #   #   #         # # #   # #     #         # #       #   #     #     #
###############################################################################
