###############################################################################
#   #         #               # # #           #             # #   #           #
### # ##### # # ##### ####### # # # ### ##### # ####### ##### # # # ###########
# #     #   # #   #       # # #   # # # # # #   # # # #   #     # #           #
# ##### ##### ### # # ### # ### ##### ### # ##### # # ### ### ########### ### #
#       #         # #   # #   # # #       #     # #       #   #             # #
##### ##### ### # ### # ##### # # ##### # # ### # ##### ##### ####### ####### #
#     #     #   # #   #       #       # #   #   #     # #         #   #   #   #
# ################# # # ### ######### ### # ##### ### # # ######### ### #######
# #     # # #       # # # #       #       # #   # # # # #         #     #   # #
# # ### # # ######### ### # ### # ####### ### ### # ### # ####### # ##### # # #
# # # #   #       #   #     # # #   #         #   # # # #       # #     # #   #
# ### ### # ### ####### ##### ##### # ####### ### # # # ### ####### ##### #####
#   #         #   #     # #           #   # # #   #       # #       #   # #   #
# # ##### # # ### # # ### ######### ##### # # # ####### # # ### ##### # # # ###
# # #   # # # # # # #       #   #   #       #   # # #   # #   #       # #     #
# ### # ### ### # ### ####### # ### ####### ### # # # ##### # # ### ##### #####
# # # #     #   #     #       #   # # # #     # #   #       # # # #   #   #   #
### # ######### ### # ### ####### # # # ### ### # ### ######### # ### # ### # #
# #   #           # #   #   #       #   # #             #   # #   # # # #   # #
# ##### ######### # # ####### # ####### # # ####### # ### # # ### # # # # ### #
# #     # #         #   #   # # #     #     #   # # #     #   #   # # #     # #
# # ### # # # ##### ####### ### ##### ######### # # ### ######### # ##### #####
#   # # #   # #   # #     # #   #   #         #     # # #     #         # #   #
##### ### ### ### ### ### # ##### # # # ### # ####### # ##### ### ####### # ###
#           # #     # #   #     # # # # #   #                   # #   #     # #
# ####### ####### # # ### ##### ### ##### ### # # # ### ### ### # # ### ##### #
# # #     #       #     #     #       #   #   # # # #     # #       # #   #   #
# # # # ### ################# ##### ### ##### ####### # ##### # ##### # ### ###
#   # #   #       #           # #   #     #       # # # #     #       #       #
##### # # ### ##### ##### ### # # # ### ######### # ########### # # ##### #####
#     # # # #   #   #       #     #   # #         #             # #     # #   #
# ### ##### ######### ####### ####### ######### # ### ######### # ####### # ###
# # #   #   # # #   # #       #                 #   # # #       #             #
# # ####### # # # ############### # # ####### ### # ### # # # # # ####### #####
# #       #       #   #         # # # #         # #   # # # # # #     # #   # #
# ####### # # ### # # # ### # # # # ####### ### # # # # ### ### # ##### ##### #
#         # # #     #   #   # #   #   #       # # # # #     #   #             #
###############################################################################
