###############################################################################
# #   #   #       #     #                       # #     #                   # #
# # ### # # # ####### ### ### ##### ####### ### # ### ####### # # # ##### # # #
#       #   #       #     # #     #   # #   #       # # #     # # #     # #   #
# ####### # # ##### ####### ### ####### ######### # # # ##### ### ##### ##### #
# #     # # # #   #   #       #   #               #             #     #   #   #
### ### ######### # # ### ### ############### ### ####### ##### # ### ####### #
#     # # #   #     # #   #     #   #         # # #         #   #   # # #     #
# ### # # ### ####### ### ##### # # # ### ##### # ####### ####### # # # ##### #
#   # #   # # # #     #     #     #     # # #       #         #   # #   # #   #
######### # # # # ### # ### # ########### # # ##### # # # # # ##### ##### # # #
# #       #   #   #     #   # #   #     # #   #     # # # # # #           # # #
# ##### ##### ######### ### ### # # # # # ### ### # ### # # ##### # ### ### # #
#   #   #   #       #   #   #   #   # # # # # # # # # # # #   #   #   #   # # #
### ### ### ### ##### ### # ### ####### # # ### ### # # ### ######### # ### # #
#   #   #   # # #     #   #   # # #     # # #   #   #     #       #   #   # # #
# ### ### ### # # ##### ##### # # ##### ### # ### ### ######### ### # # ### # #
#           #     # #       # # # #     #   # #   # #     #   # #   # #   # # #
### ####### ### ### # ####### ### ##### # # # # ### ### # ### ##### # ### # ###
#     #           #   #         #     # # #     #       #     #   # #   # #   #
### ######### ######### ########### ### ######### # ##### ### ### # ### ### # #
# #     #     #   #     #   #         #           #   # # # # #   #   # #   # #
# ##### # ####### # ### ### ######### ##### ####### # # ### ### ##### ### ### #
# #   # # # #   # # #     #     # #   #     #       #               # #   #   #
# # # # ### ### # ### ######### # ### ####### ### ### ### # ### ### ####### ###
#   #   #           # #     #   #   #           #   # # # #   # #       #     #
####### ### # ##### # ##### # # ### ####### # ### # ### # ##### ######### ### #
# #   #   # # #   #   # # #   #             # #   #     #   #   #       #   # #
# # # ### ### # # ##### # # ######### # # ### ####### ######### # ### ### # ###
# # # #   #   # #     # #   #     #   # #   # #   #       #     #   #   # #   #
# # # ####### # ##### # ######### ####### ### ### # ### ##### # ### ##### #####
#   # #     # #   #   #           #         # #   #   #   #   #       # #     #
##### # ### # ####### ########### # # # ##### # ### # ### # # # ##### # ##### #
#     # #   #   # #     #       #   # # #   # # #   # # # # # #   #   #   #   #
# ### ##### ##### # ### # ##### # # ##### # ### # # # # # ####### # ##### # ###
#   #     #         #     #       # #     #       # # # #       # # #     #   #
### ##### ### ################# # ############### ##### ##### # ### # # # ### #
#       #       #               #       #                   # #   #   # # #   #
###############################################################################
