###############################################################################
#   #     #   #       #   # #   #         # #       # #           #       #   #
### # ### ### # # ### # ### ### ####### ### ####### # ##### ##### ##### ### ###
#   # # # #   # #   #   # #   # # #   #   #   #   #     #   #       # #     # #
# ##### # ### ######### # # ### # # # # # ### ### ##### ### # ### # # # ##### #
#   # #     # #       # # #     #   #   #       #     #   # # #   # # #       #
### # ##### # ##### # # # # ####### ########### # ##### ##### # ### # # ##### #
#   #     #         #       #     # #         # #   #   #     #   # # #   # # #
# ####### ######### # ##### # ##### ####### # # ### # # # ######### # # # # # #
#   # #             #   #         # #       #   # # # #   #     # #     # #   #
# ### # # # ##### # # ### ################# ### # # ### ### # # # ##### #######
#   # # # #   # # # # # #       #           # #         #   # #           #   #
# # # # # # ### # # ### ### ##### ##### # ### ### ######### ### # ### # ### # #
# # #   # # # #   # #   #     # # #   # # #   #   #     # #   # #   # #   # # #
# # ######### ####### ####### # # ### ### ### # ####### # ### # ### ### ### ###
# # #       # #     #       # #   #       #         #         # #   # #     # #
# # ### ##### ##### ####### # ############### # # # ### ### ##### # # # ### # #
# #     # # # #   #       # #         # # # # # # #   #   #   #   #   # #     #
##### ### # # ### ####### # ### ##### # # # # # # ### # ### # ### ### #########
#   # #   # #     #           #   #         # # # #   #   # # # #   #     #   #
# ### ### # ##### # # ####### ############# # ### # # ##### ### ### # ##### # #
# #             #   # #             # # #       # # # #     # #     #     # # #
# ### ### ############### ######### # # # # ### ### # ### ### ##### ### ### # #
#   #   #       #     #   #     # # #     #   #   # # #   #     #   #     # # #
# # ### ####### # # ### ####### # # ### # ####### # ######### # # # ##### # ###
# #     #         # #   #     #   # #   #       # # #   #     # # #   # #   # #
# # ############### # # ##### ### # ### ### # # ### ### ### ### # ##### ##### #
# # #                 # #     # #   #   #   # #   #   # #     #       #       #
# # ######### ####### ####### # # # # ##### # ##### ### ##### # ### # # ### # #
# # #   #       #       #         #   #   # #   #   # #   #   # # # #   #   # #
### # ### ####### # ##### # ### ####### ### ### ### # ### ### # # # ### # # ###
# # #   # #     # # #     # #   #   #   #   #   #   #       # #   #   # # #   #
# ##### # ### # # # ### ### ### # # # ##### # # ########### ### # # # # # ### #
# #     # #   #   #   # # # #   # #     #   # # #     #         # # # # #   # #
# # # ##### # # ##### ### ##### # ##### # ### ####### # ##### # # ### ####### #
# # # #     # # #     #   #   # #     #   #   #       # #   # # # # #   #     #
# # # # # # ### # ### # # # ### ######### ##### ##### # # # # ##### # ####### #
#   #   # #   # # #     # #         #     #     #         # #       #   #     #
###############################################################################
