###############################################################################
#     #   #   # #   #               # #   #   #   # #           # #       #   #
# ### ### ### # ### ############# ### ### # # # ### # ####### ### # ##### ### #
#   #     #       # # #   #   # #   #   #   # #   #   #     # #         #     #
### # ### # ### # # # ### ### # ### # ####### ### # ### ### ##### ### ####### #
#   # #       # #     #     # #   #   #   # # # #   #     #   # # #         # #
############### ##### # ### # # ##### ### # # # # ### ####### # # # ##### #####
# #             #   # # #   #           #             #   #       #   # #   # #
# ####### ######### # ##### ########### ### ### ####### ####### ####### ##### #
#     # # #     #   #       #                 #       #     # #     # #   #   #
# ##### ### ### ### # ### # # ######### ### # # ##### # ##### ### ### # ### ###
#   #   #   # # #     #   #   #     #     # # # #         #     #           # #
# # # # # ### # # ########### ### ##### ##### ### # # # ### # ##### # ### ### #
# # # # #   # #   #   #     # #         #     #   # # #     # # #   #   # # # #
### # ####### ##### # ##### ### # # # ##### ##### # # ####### # ####### ### # #
# # #   #   #       # #         # # #     # #     # #   #   #     #   # #   # #
# # ### # ### ######### # ##### # ### ####### # ### ### # # ##### # ##### # # #
#   #       # #         #   #   # #         # # #     #   #     #   # #   #   #
# ######### # ############### ### ### ##### ### # # ### # # # ### # # # #######
#         # #     #         # #     #     # #   # #   # # # #   # #   #       #
# # ### ### # ### # ####### ### ### ### ### ### # ### # # ####### # ### # #####
# # # # #       #   #     # #     #   # #   #   # # # # #     #   #     #     #
##### # ################# # ### ####### ######### # ### ### # # ### ### # ### #
#     # #       #       #             # # #   #   #       # # # # #   # #   # #
# # ### ### # # ### ### # # # # # ### ### ### # # ####### ### ### ##### # ### #
# #         # # # #   # # # # # # #   #         # #         #     # #   # # # #
# ### ####### # # ##### # ### # ##### # ### # # ### ### ######### # # ##### # #
# # # #       #       #   #   # #     # #   # # #     #       #   #     #     #
### ### # # ### ####### # # ### ### # # ### ### # # # # ### ### # ##### #######
#     # # #   #         # # #   #   # #   # #   # # # # #   #   #     #     # #
# ########### ########### # ### ##### ####### ####### # ### ### ############# #
#   #         #       #   #   #     #     #         # # #     #               #
### # ### # ######### ### ##### ### # ### # ### ### ### ##### # ### ##### #####
# #   # # #   #     #     # #   #   #   # #   # #     #   #   # #   #         #
# ##### # ### # ########### # ### # # ### ### ### ### # # # ####### ### ##### #
#       #   # #   #         # #   # # #   # # # #   # # # #       # #   #     #
# ### # # # ### # ##### ############### ### # # ##### # ##### # ### # # ### ###
#   # #   #   # #                       #     #       # #     #   # # #   #   #
###############################################################################
