###############################################################################
#           #   # # #       #   # #     #   # # #     #     # #     #         #
# ######### ### # # ####### # ### # # ### ### # ### # ##### # # ########### ###
#     # # #     #               #   # #   #     #   # #       # # #   # # #   #
# ### # # ############### ##### # ##### ### ####### # ##### # # # ### # # ### #
#   # #   #   #           #     #       #   # #   # #     # # # # # # # #     #
### # # ##### ############# # # # ##### # ### # # # ##### # ### # # # # ##### #
#   # #     #     #   #     # #   # #       #   # #   #       #   #   # #     #
# ### ### # # ##### ####### ### ### # ### ##### # ######### ##### # ### # # ###
# #   # # # # #   #   #   # #   #   # # # #   # #       #   #   #   # # # #   #
# # ### ### # # # # # # ### # ### # # # # ### ##### ### ### # ### ### # ### ###
# # #         # #   #   #   # #   #     #       # #   #     #     #     # #   #
### ##### ##### ############# ### ##### ##### ### ####### # ##### # # ### ### #
# # #     #   #   #     #   #   #   #       # #   # #     #       # #   # #   #
# # # ### # ##### # ### # # ############# ### # # # ##### ########### ### # ###
#       # #       # # # # # # # #   # # # #   # # # # #   #     #     # #     #
######### # ######### # # # # # ### # # ### ### ### # ### ##### # ##### ### # #
# #         #   #   # #   # #         #     # #   # # #     # #     #     # # #
# ##### ##### ### ### ### # ######### ##### # # ### # # ### # ### ### ##### ###
#     #       #   #       #   #       #     # #   # # # # # #   #   #   # #   #
# ### # ##### # ##### ######### ##### # ### # ### # # ### # ### # ### ### # # #
# #       # # #     # #       # #       #       # #   #       # #     #     # #
# ##### ### ##### # # # # ####### ####### ### # # # ######### # # ##### # #####
# #       # #     # #   #     #   #       # # #     #     #   #       # #     #
# ####### # ####### ######### ##### # ##### ### ######### ### # ##### # #######
# #     # #     #             #     # # # #         #       #     # #     #   #
# ### # # ##### # ########### # # ### # # ### ### # ####### # ### # ######### #
# #   # #     #   #     #       #   # #         # #       #     #             #
# ##### # ### ### ##### # ### # ### # ### ### ########### ### ### # ###########
# #       #       #   #   #   # #   # #   #   #       #     # # # # #   #     #
####### # # # # # # # ### # ######### ########### # # ##### # # # # # ### #####
# #     # # # # #   #   # #     #       #   # #   # #         # # #   #       #
# ########### # # ##### # # ### ##### # ### # ### # # ####### # ### # # #######
#       #     # # #     # #   #   #   # #         # # #   #       # # #   #   #
# ##### ##### ### # ##### ### ### # # # # ######### ##### ### # ####### ### # #
#   #       #   # #     #   # #   # # # # #     # # # #       #     #       # #
### ####### ### # ######### ##### # # # ### # # # # # ####### ##### # ##### ###
#         #     #         #   #   # # # #   # #     #             #       #   #
###############################################################################
