###############################################################################
#   #         # #   # #               # #     #       #     # # #             #
# # # # # ### # ### # # ##### ##### ### ### ######### # ##### # # # # # # ### #
# #   # # # # # # #   # #     #   #   #     # # #     #     #   # # # # #   # #
# ##### ### ### # ### # # ####### ### ### ### # # ######### # ##### ### # ### #
# # #               #   # # #     #   #   # # #   #   #   # #       #   # #   #
# # # # ##### ### # ##### # ##### # ##### # # # # ### # ### # ########### # # #
# # # #   #     # # #   #     # # #   #   #   # # #     # # #   #     #   # # #
# # # ### ##### # # ### ### ### # ### ### # ### # # ### # # # ### # ####### # #
# # #   # # #   # #         #   #   # #   #     # # #     # # #   #   # # # # #
### ####### # ### # ##### ##### # # # # ### # ########### # # ### ##### # #####
#         # # #   #   # # #   #   # #   #   # #   #       #     #     # #     #
# ####### # ### ##### # ### # ##### ### # # ##### ### ##### ### # # # # # #####
# #     # #     #     # #   #   # #       #   #   #   # #   #   # # # # #   # #
# # # # # ### ##### ### # ### # # ######### # ### # ### # # # ##### ### # # # #
# # # #   #     # #   #   # # # #   # #     #     # # #   # #       # #   # # #
### ##### # ### # # ####### ### ### # ######### # # # # ############# ### # # #
#   #   #   #   #   #   #   #       #   # # #   # #     # # # #   #       #   #
####### # ### ### ##### ### ##### ### ### # # ### # ##### # # # # # # ####### #
#         #   # # #               #     # # # # # #           # # # #   # # # #
######### # # # # ########### # ### ### # # ### # # ### ######### # ### # # # #
# # #   # # # #   #     # # # #     # #   #     #   # #         # # # #     # #
# # ### # ##### ##### ### # ##### ### # # ##### # ### # ####### # # # ####### #
# # #     # # #     #     # #     #     # #   # #   #       # # #     #     # #
# # # # ### # ######### ### # ### # # # ### ### # ########### ##### ### ##### #
#     # # #   #             #   # # # # #       #       #   #       #   # # # #
# ####### ### # ####### ### # ######### # ### # # ######### ####### # ### # ###
#   #   #       #   #   #       #     #   # # #       #   # # # # #   # #   # #
### ### ####### # ### ##### # ##### ####### ##### ### # ### # # # # ### # ### #
# #   # #     #   #   #     #   #   #           #   #       #   # #   # #     #
# # ### # ### ######### # ####### # ####### ### # ### # ##### ### # ### ##### #
# # #   # # #       #   # #       #     #   # # # #   #     #   #     # # #   #
# # # # ### ##### # # # ########### ### ##### # ### ### # ### # ### ### # # ###
# # # # #   # #   #   # #   #   #   #         #     #   #     #         #     #
# # ### # ### ####### # # # ### ####### ##### ##### # ########### # ##### ### #
# # #     #   #       # # # #   #   # #     # # #   #         # # # #     #   #
# # ##### # ### ### ### ### # # ### # # ##### # ##### # # # ### # # # ####### #
#   #           #     #   #   #             #         # # #     # #         # #
###############################################################################
