###############################################################################
#       #     #     #   # # # #       #     #     #           #       #       #
# ########### # ### ### # # # ### ### # ######### # ####### # ### ### ### # # #
#           # #   #   # #   #       # #   #     #   # # # # #   #   #   # # # #
# ####### ### ##### ### ### ### # ####### # ####### # # # # # # ##### # # # ###
#     #   # #     # # #     # # # #   #     #     #     # # # # #     # # #   #
# # ####### ##### # # ### # # # ### # ### ####### ### ### ####### # ######### #
# # #   # #   #   #   #   #   # # # #   # # # #     #       #   # #         # #
# # # ### ### # # # ######### # # # ##### # # # ####### ### ### # ######### # #
# # # #   #     # #   #   #       # # # # # #   #     # #   #   # #       # # #
# # # # ######### ### # ##### ##### # # # # ### # ##### ####### # ### # ##### #
# # #       # #   # #   # #   # #   #       # #   # # # #       #   # # #     #
### ##### # # ### # ### # ### # # ######### # # ### # # # ##### # ##### # ### #
# #       # #     #       # # # #   # # #       # # #   # #   # # #   #   #   #
# ### ### ##### ####### ### # # # ### # ### # ### # ### # # ### # ### ##### ###
# #   #   # #       #   #   #         # # # # # #     #   # #     # #     #   #
# ####### # ### ####### # ### ##### # # # ### # ##### # ### ### ### # ####### #
# #     #   #     # #   #   #     # #   #   #   #             #   #   #     # #
# # ##### ####### # ### # ### ####### ##### ### # # # # ########### ### ##### #
# #     # #     # # # #   # #   # # #   # #   # # # # # # #   # # # #   # #   #
# ##### # # # ### # # # # # ### # # # # # ### # # # ### # ### # # # # ### # # #
# #   # # # # #       # #   # # #     # # #   # # # # # #     #   #       # # #
# # ### # # # # ### ##### # # ######### # # ### # ### ##### ### ##### ##### ###
# #   #   # # # #     #   # # #     # # #     #   #       # # #           #   #
# ### ### # # # # ### # ### # # ##### # # ##### ##### ##### # ### # ### # # ###
# #     # # # # #   #   # #   # # #     #     # #         # # # # # #   #     #
# # ### # ### # # # ##### ### # # # ### # ##### # ####### # # # # ##### # #####
#   #   # # #   # # #   #   #     #   #   #     #       # #   #   #   # # #   #
### ##### # ######### # ### # ######### ####### # ##### # # ##### # # ##### # #
# # #   #         #   #   # #   #           #   #     # # #     #   # #   # # #
# # # # ######### ##### # # ### ########### ### ### ### ### ##### # ##### # ###
# # # #   #       #   # #       # # # #   # #   # #   #     #     #           #
# # ### ####### # ### ######### # # # # # # # ### # ### ##### ######### ##### #
#   # # #   #   #               # #   # #       # # # # #           #     #   #
# ### # # ##################### # # ########### # # # ##### ##### ##### ##### #
#   #   #           #   #   #     #         #     #     #   #   #     #     # #
# ### # # ##### ### ### ### ##### ####### # ### ### ### # # ### # # # # # #####
#     #   #     #                         #           #   #     # # # # #     #
###############################################################################
