###############################################################################
# #           #     #             # #         #       #   #     #         #   #
# ### ######### # ####### ##### ### # ####### # ### ##### # ### # ########### #
# # #           #             #     #       # #   #   #   #   #       # # #   #
# # # # ####### # # ######### # # ### ########### # ### ### ########### # # ###
# # # # #     # # #     #   # # # #       #   #   #   # #   # #               #
# # # ### # # # ####### ### ####### ##### # ### ####### # ### ######### # ### #
#         # # # #         #     #   # #   # # # # #     #       # #     #   # #
### ################# ##### # ##### # ##### # # # # ### # ####### # ### #######
# #     #   # # #   #     # #     #   #     #   #     #   # # #   # #       # #
# # ##### ### # # ### ##### ####### ##### # ### # ######### # ### # ######### #
#   # #         # # #       #     #     # #   #   #   # #       #   # #     # #
# ### # ### ##### # ### # ### ### # # ####### ### # # # # ####### ### # # # # #
# #   # # # #         # #       #   #       #   #   #               #   # #   #
# ### # # ### ### ##### ### ### ### # ### ##### ##### # ### # ##### # # # # # #
# # # # # #     #     #   # #   #   # # #             # #   #   #   # # # # # #
# # # # # # ##### ### ####### ### ### # # # ####### ### # # # ##### ### # ### #
#   # # # #     #   # #     #   #   # # # #   #   #   # # # #     #     # # # #
### # # # # # # # ##### ########### ### ####### # # ##### # ### ##### # # # ###
#     #     # # # # #   #   # #   #   #   #     # # # # # # #   #     # #     #
# # # # # ######### # ### ### # ### # # # # ####### # # ### # ### ### ##### ###
# # #   # #         #           #   # # #         # #     # # #     #   # # # #
# # # ##### # ##### ### ########### ### # ### # # ### ##### ####### ##### ### #
# # # # #   #     # #   # # #     #   # #   # # #     #   # #     #           #
### # # # ### ##### # ### # ### # ##### # # ### ####### # # # ######### ##### #
#   #       # #   #             # #     # #   # #     # # #   #       # #   # #
# # # ######### ################### ####### # # # ### # # ########### ### # ###
# # #         #             #   #   #   # # # #     # # # #   #   #       #   #
# ### ######### ##### ##### ### # ### ### ### ######### # # ### ### ###########
#   # #         # # #     #     #   #       #     #     #     #           #   #
# ### # # # ##### # ### ##### ### ### ############# # ##### ### ### # # ### # #
#   # # # # #       #       #       # #             # #   #   #   # # #     # #
### # # # ### # ############### ### # # ############### ####### ########### # #
#   #   #     #               # #             #       # #     # #           # #
# # # ##### ##### ### # ####### # # ##### ##### # # # # # # ### # # ######### #
# # #     #     #   # #       # # # #   #       # # #   # #     # #   #       #
# ### # # ############### # # # # # # # ######### ####### ### ####### # #######
# #   # #             #   # # # # #   #     #               #     #   #       #
###############################################################################
