###############################################################################
# #       #     #   #     #           # # #         #                   # #   #
# # ##### ##### # ### ############# # # # ######### ####### ##### ####### # # #
#   #           # # #       #       # #   #   #   # # #       # #       # # # #
# ##### ##### ### # ####### ### ##### # ### ### # # # # ##### # ### ##### ### #
# # # #   # #   #         #   #   #   #       # #   # # #   #     #       #   #
### # # ### # ##### ##### # # ### ### ##### ##### ### ##### # ######### ### ###
# # # # # #           # # # #   #   # #   #   #   #   #     #         #       #
# # # ### ### ####### # ####### ##### # ##### # ### ####### ### # ####### #####
#   #   #   # #       #   #   #   #   # #     # # #             #   # #   #   #
# ##### ### ######### ### ### # ### # # # ### # # ##### ############# ##### ###
#           #     #   # # #   # #   #   # #   # #         # #         #     # #
####### ### ### # ### # # ### # ### ######### # ##### ##### ### # ####### ### #
#   #     #     #   #   #     #   # #     #     #   #           #   # #   # # #
# # # ######### ### ### ### # ### # ### # # # ##### ##### ### ####### # ### # #
# # #       #   #           # # # # # # #   #     #   #     #   #     # #   # #
# # ####### ### ##### ####### # # # # # ### # ##### ### ####### # ##### ### # #
# # # #     # # #   # #   #       # # # # # # #   # # #       # #   #     #   #
# ### ####### # ### ##### # ### ### # ### ### # ### # # ##### # # ### ##### ###
#         #   # #       # # #     # # #   #       #   #     # #     #   #     #
# # ### ##### ##### ### # ####### # # ### ##### ### # # ##### # # ### # # # ###
# #   # #   # #       #   #       # # # # # # #   # #       # # #     # # #   #
### ### ### # ########### # # # # # # # # # # ### # ### # # # ### ##### # ### #
#   #                 #     # # #   # # # #           # # # # # #   # # #   # #
# # ### ##### ### # # ##### ### ### # # # # ########### # # ### ### # # # # # #
# # #   #     #   # #         #   #                   # # #       #   #   # # #
# ####### # ### # ##### # ### ############# ############# # ########### #######
# #       # # # #   #   # #     #       #         #     # #   #   # # # # #   #
# # ### # # # ######### # # ######### # ### ####### ####### # # # # # ### ### #
# # #   # # #           # #       #   #             # #   # # # #   # #       #
######### ### ##### # ### ### ####### # ### ### # # # ### ##### # ### ####### #
#         #   #     # # # #   # #     # #   #   # #     #   # # #       #   # #
# ################# ### ### ### ##### ####### # # # # # # ### # ### ####### # #
#     #   # #         #     # #   #   #   # # # # # # #           #   #   #   #
### # ### # # ##### # ### # # ### ####### # ### # # # ################# ### # #
# # #   # # #   #   # # # #   # # #   # # #     # # #     # #   #           # #
# # ### # # ######### # ### # # # ### # # ##### ### ##### # # ### # ######### #
#     #   #               # # #                   # #             #     #     #
###############################################################################
