###############################################################################
#   #     #       #         #   #   #     # #       #         # #   #   #     #
### # ### # ########### ##### # # ### ### # ##### # # ##### # # # ### # # ### #
# #   # #       #     # #   # # #   # # # #     # #   # #   # #       # # #   #
# ##### ####### # # ### # ### ### ##### # # ##### # ### # ### ### # ### # #####
# #         #   # # # # # #           #   #     # # #   #   #   # # #     #   #
# # ##### # # ##### # # # # ########### # # ##### # # ##### ### ### ### ### ###
#   #     # # # #       # # #   # #   # #   #   # #   # # # # #   #   # #   # #
####### ### # # ####### # # ### # ### ##### # ### ##### # ### ####### ### ### #
#         #     #     # #   # # # #       #   #       # #   #   #   #   #     #
# ### ############### # # ### # # ### ##### ### ##### # # ### ### # ### # ### #
# #   # # #   # #   # # #     #   #   # # #     # # #   # #     # # #     # # #
# ##### # # ### # # # # ### ### ### # # # ### ### # # ### ##### # ### ### # # #
# # #     #       # # # #   #     # # #     #     #     # #     # #   # # #   #
# # ##### ####### # # # ### # ####### # # # # # ### ### # # ### # # # # # #####
#   #     # # # # # #   # #     # #     # #   # #     #     # #     # #   #   #
# ##### # # # # ### # ### # ##### # ########### ######### ### # ##### ####### #
#     # # #       # # #   # #     #   #     #           # #   # # #     #   # #
##### # ### ##### # # ### # # ##### ### ### ########### ### ##### ##### # ### #
# # # # # #   #   #   #   # #     #     #   #     #     #   # # #     # #     #
# # # # # # ######### ### # # ##### # ####### ### ### ### # # # # ### # ##### #
# #   # # #     #   # #       #     #     #     #   #     #     # # # #   #   #
# # ### # # ####### # ##### ### ########### ############# # ##### # ####### # #
# #       #   # # # # # # #               # #         # # # #     #         # #
# ####### # ### # # # # # # ####### ##### # # ######### ### # ##### ### ### # #
# #     #       #   # # #         #     #   #       #   #     #       #   # # #
# # ### # ##### ### # # # # ####### ##### ####### ##### # # ### ##### ### ### #
# #   #   # # #     #     #       #     # #   #       # # # # # #   # # # # # #
# ### ##### # ##### # # # ##### # # # ####### # ##### # # # # # ### # # # # ###
# #   #           # # # #   #   # # #     # # #   # # # # #     #   #   #   # #
# ### ### ####### # # # ####### ### # ##### # # ### # # ##### ### ### ##### # #
#     # # #           #   #     # # #     #   #   #       #       #   #   #   #
### ### # ### ##### ####### # # # # ##### # ### ### ### # # ### ####### # ### #
#   #   # #   #     #     # # #   # #   # #   #   #   # # # #   #     # #   # #
### # ### # # # ### # # ########### # ### # ### ### # ### ##### # ### # # ### #
# # #   # # # #   # # #       #   #   # # #   #   # # #     # # #   # # # # # #
# # # # ### # ### # # ### ####### # ### # # # # # ### # ##### # # ### # # # # #
#   # #     #   # #   #           #     #   #   #   # #       #   #     #   # #
###############################################################################
