###############################################################################
#           #   #       #       #   #         #     #         #       # # # # #
# ######### ### # ##### ##### # ### # ### ### # ##### # ########### ### # # # #
# #       # #     #   #   # # # #     # # # #         #   #   # #   # # # # # #
### ### # # # # ### ### ### # # ##### # ### ### ######### # ### # # # # # # # #
# #   # #     #   #     # # # #         #     # #     # # #   #   # # # # #   #
# # # # ### ####### ##### # # ########### ##### # ##### ##### ### # # # # ### #
# # # # #   # #     #   # # #     #     #   # #   #   # #   #     # #     # # #
# # # ### ### ##### ### # # ########### ### # # ### ### # # # # # ### ##### # #
# # #   # #   #   #     #       # #     # #     # #   #   # # # # # # #       #
# ####### # # ### ### # ### # ### ##### # ### ### # # ##### ##### # # # # #####
#       #   # #       #     #   # #     # #   #     #   # #   # #   #   #     #
##### # ##### # ##### ### ### ### # ### # # # ####### ### # ### # ### ####### #
#     #     # # #   # # # # #   #   # #     # #   # # # # # # # #         # # #
########### ##### # ### ### ### # ### # ##### ### # # # # # # # ##### ### # ###
#           # #   #   # # #   # # #       # #   #   #   #     #       #       #
# ########### # # # ### # ### # ##### ##### # ##### ### ##### ####### # # # ###
# #     # #   # # # #   # # #   #   #   #   #   #     #   #     #   # # # #   #
# # # # # ### # # ##### # # ### # # # ##### # # # # # ### # ### # ### ##### # #
#   # # #     # # #   #           #       #   #   # #     #   #           # # #
####### ### # # # # # ######### ############### ####### ##### ### ### # # #####
#       #   #   #   # #         #         #   # #     #       # #   # # #     #
# ####### # # ####### ##### # ######### ##### # # ### ####### # ##### ##### # #
#   # #   # #   #   # #   # # #   #         #   #   # #             #     # # #
# # # ##### # ##### ### # # # ### ### # ### # ### ### ######### ### # # # ### #
# # #   #   # #       # #   # # #     # # #         #   #   #     # # # #   # #
### # # # # # # ##### ##### # # ######### # ### ### # # # # ##### ####### ### #
#   # #   # # #   # # #     # #   #         # # #   # # # #         #   # # # #
# # ##### # ### ### ### # ### ### ### # ### # ### ####### # ####### ### # # ###
# # #     #         #   # #     #     # #   #         #   # #         #       #
# ### ########### # ##### ############### ##### ### # # ### ### ##### # # ### #
#   # #     #     # # #           #         #   #   # # #   #       # # # # # #
### # ##### ####### # # ##### # # ####### ##### ##### ####### # # ##### ### ###
# #   #       #         #   # # #   # #   # #   #   #     #   # # #   #     # #
# # ### ### ### ####### ### # # ### # # ### ### # ######### # ####### # ### # #
# # # # #   #   #   #       # #   # #         # #   # #   # #     #       #   #
# # # # ####### # ### ####### ### ############# ### # # ### ##### ####### #####
#     #         #       #     #           #       #         #       #         #
###############################################################################
