###############################################################################
#       #           # #   #   #     #         #         # #       #   # #     #
# ##### ####### ### # # # # # # ##### # # # ### ######### ##### ### # # # # ###
# # #           #       #   #     #   # # #     #   #         #     #     # # #
### ####### ##### # # # # # ##### # ### # ### ### ### ######### ### ####### # #
#   #   #   #     # # # # # #   #     # #   #   # #       #   #   # #   # # # #
### ### ##### # ### ### # # # ### ############### # ##### # # # ##### ### # # #
# # # #       # #   #   # #   #         #       #     #   # #   # # #       # #
# # # ### ####### # ######### ##### ######### # # ####### # ##### # ######### #
# # #       #     #   #         #     #       #       # #     # # # #   # # # #
# # ### ### ##### # # # # ### # ##### # ######### ### # # ### # # # # ### # # #
#   #   # #     # # # # #   # #     #     #     #   #   #   # # #   #   # #   #
# ##### # ##### ### # # # # # ### # # ##### # # ### ########### # # # ### ### #
#     #   # #     # # # # # # # # # #   #   # #   #       #     # # #     #   #
# ### ##### # ######### # # # # ##### ### ##### ### ### # # ####### ##### # ###
#   #   # #   # #   #   # # # # #             #   #   # #       #     #       #
# # ### # ##### ### # # # # ### ### ### ##### # ### # # ############# # ##### #
# #   #   #   #     # # # #   #   #   #   # # #   # # #       # #   #   # #   #
### # # ##### # # # # # # ### # # ### ### # # # ##### # # ##### ### # # # # ###
#   # #   # # # # #   # # #   # #     # #   # #     # # #     #     # #   #   #
##### # # # # ##### ### ### # ####### # ##### ##### # # ##### ##### # ####### #
#     # #       #   #   #   # #             #   #   # #   # # #   #     #   # #
# ### ####### # ##### # # ### ### ##### # ##### ##### # # # # # # # ##### ### #
# # #     #   #       # # #   #   #     #   #       # # #   #   #       #   # #
# # # # # ### ############### ####### # # ### ####### ##### ### ### # # ### # #
#   # # # #   #             #     # # # # # # #   #     #     # #   # #     # #
### ### # ##### # ### ########### # ##### # ### # # ### # ### ########### #####
# # # # #   #   # #     # #   #         #   #   # # # # # # #   # # #   # #   #
# # # # ### # ######### # # ### ####### # # # ##### # # # # ### # # # # ##### #
#   # # #   #   #   #               #   # #       #   # #   #   #   # #       #
# # # ### # ### # # ### ########### # ### ##### ####### ####### ### # #########
# #   #   # #   # # # #       # #   # #       # #   # #     #       #   #     #
### # # ##### ### # # ### # ### # # ### # ####### # # ######### ### # ### ### #
#   # # #     #   # # #   #     # # #   # #   #   # #   #   #   # #     # # # #
##### # ####### ### # ############# # ####### # ##### ### # # ### ### ### # # #
# #   #   #   # #   # #   #         #       # #   #     # # # #     # #   #   #
# # # # # ### ### # # # # # ##### ######### # # # # ##### ### # ### # # ### ###
#   # # #     #   #     #     #       #         #       #     #   #     #     #
###############################################################################
