###############################################################################
# #   # # # #         #                   # # #   # #       # #     # # #     #
# # # # # # ### ####### ####### ######### # # # ### # ####### ### ### # ##### #
#   #         #         # #   # # #     # #   #     # #         # # # #   #   #
######### # ##### ### ### ### ### ##### # ### # ##### # ##### # # # # # # ### #
# # # #   #     # #       #   #   #                   # #     # # #   # #     #
# # # # ####### # # ### ### # # ##### ####### ######### ######### # ##### # ###
# #     # #     # # #   # # #     # # #         # # #   #     #   #   # # #   #
# ####### ### ########### ##### ### ##### ### # # # # ##### ### # # ### ##### #
# #       #         #     #               #   #     #   # #     #   #     # # #
# # # ####### # ### ### # # # ##### ### ##### # # ### ### # ####### ##### # # #
#   #         # #   #   #   #   #   #   #     # #     #   #     # # #   # # # #
### # # ######### # ######### # ##### # ##### ######### ######### # # # # # # #
# # # # # # #   # # #     #   #   # # #   #     #       #   # #     # # #   # #
# # ### # # # # ### # ### # # # ### # ### # # # ##### # # # # # ### ### ### # #
#   #   #     #       #     # #     # # # # # #       #   #     # #       # # #
# # ### ### ### ####### ########### # # ##### ### ### # # ####### ### ### # # #
# # # #   #   #   #       #     #   #   #     #   # # # # #   #   #   #   # # #
# ### ### # ##### # ##### ##### # ##### # ##### ### ##### ### # # ### ##### # #
#     # # # # #   #   #       #     #   # #     # #       #   # #   # # #   # #
# ##### ### # # # ### # ##### # ####### # # ### # ### ####### ##### # # # ### #
# #       #   # #   # #   # # #   #     # # # # #   #   # #   #     #     #   #
### # ### ##### # # ##### # # ### ### # ##### ### # ##### # ####### ##### ### #
#   #   #   #   # # #     #   #     # # #     #   # # #   #   #   #     #     #
# ##### ### # ############### ### ####### ### # ### # # ##### # # # ### ##### #
# #   # # #   #       #   #     # #       # # #   # #   #   #   #   # #     # #
# # # # # ### ##### # # ### # ##### ##### # ##### # ### ### ######### ### ### #
# # # # #   # #   # #       #     # #   # #   #   #     # # # #     # #       #
# # ### # ### # ##### # ### ##### # ### # ### ######### # # # ### ### # ##### #
# # #   #   # # #   # # #     #   # #     #     #     #     #   #       #     #
# # ### # # ### # # # ### # # ####### ### # ### # ### ### ##### ####### ### ###
# #     # #     # # # #   # # #       #     #   # #   #       # #     #   #   #
# ####### ####### # ##### # ### ############### # ### ####### # # # # ### # # #
# #     #         #     # # #     #             #   #   #   # #   # #   # # # #
# # ################### ##### # ####### ##### ### ##### # # # ##### ### ### # #
#   #           #   # #   #   # #     #   #   # # # #   # #           #     # #
##### ### ####### ### ### # ### ### # ### ### # # # ### ### ##### ##### # ### #
#       #                   #     # #     #           #     #         # # #   #
###############################################################################
