###############################################################################
#       # #   #       #       #   #               #       #   #         #     #
# ####### # ##### # ####### ### # # ### ########### ##### ### ### ##### ### ###
#     #   #   #   # #     #     #     #     # #   #     # # #   #   #   #     #
##### # # ### # ######### ### # ### ##### # # # ######### # ### ### # ### ### #
#   # # #   # #     # #       # #     # # #   #     #   #   #     # #   #   # #
### # ### # # # ##### # ####### # # ### ####### ####### ### ##### # # ##### ###
#       # # # #       #     #   # # #       #     #     # # #   # # # #   #   #
# ### ##### # ##### ##### ####### ### ### ### ##### ##### # # ### ### # ### ###
# # # # #     #   # # #   #   #   #   # #           #     # #     #   # #     #
# # # # ##### # ### # # ### ######### # # ######### ##### # # ##### ### # #####
# #         #   #   # #   # # #   # #   # #   #   #     # # #       #   #     #
##### ##### # ### ### # # # # # # # # ### # ##### ### ### # ##### # # ### ### #
#     #           # #   #     # #   #   #     # #   # #   # #   # #       #   #
# # ### ####### # # ######### ##### ### ##### # ### # # ### ### ####### # # ###
# # #   #   #   # #   #         # # # # #   #       #   # #     #       # #   #
# ######### ### # # ### # # ##### # # # # ### ##### ### # ### ### ########### #
# # #       # # # # #   # #         # # # # # # # # # # # # #     #         # #
### ####### # # ### ### ####### # ### # # # ### # # # ### # # # ### # #########
# # # #           #     # #   # #         #       #   #     # #     #         #
# # # # ######### ### # # # ############### ########### ####### ############# #
#         #   #   #   #               # #     #   # #             #     #   # #
########### # ### ##### ####### ##### # # ##### # # ### ######### ### ##### # #
#   #     # #   # # #     # #   #   #   #   #   # #   #   #     # # #       # #
# # ##### ### # # # ##### # ##### ######### # ##### ##### ### # # # # ### #####
# #   # # # # #         #         #     # #   #           #   # #   #   #     #
# ##### # # ### ### # ### ##### ##### # # ### # ### ####### # # ####### # ### #
# # #       # # # # #     #   # #   # # #       # # #       # #   #     #   # #
# # ### ### # ### ####### # ##### # ### # ####### # # # ### ##### # ####### # #
# #     #             #           #     #       # #   #   #     #   #     # # #
# ######### ### # # # # # ##### ####### # ### ### # # ####### ####### ### ### #
# #       # # # # # #   #     #       #   # # #   # # # #   # #   #     #   # #
# # ##### ### ### # ### # # ######### ##### ##### ### # ### ##### ### # ### # #
# #   # #     #   # #   # #   #     #   #     #     #     #         # # #   # #
# ### # ##### ##### # # # # # ### # ##### ### # # ####### # ##### # # ### #####
#   #   # # #       # # # # #     #   #   # # # #     #   # #     # # #   #   #
# # # ### # # ### ##### ##### # ####### # # ### # ##### ##### # ##### ####### #
# #       #   #       #   #   #         #       # #           #               #
###############################################################################
