###############################################################################
#   #     #   #                 #     #     #     # #   #         #   # #   # #
# # # # ##### ##### # # # ### # # ### ### ### ### # ### ####### ### ### # # # #
# # # #   # #       # # # #   #   # # # # #     #     #     #   #   #   # # # #
# # # ### # ### # ##### # ### # ### # # # # ############### ### ### # ### ### #
# #   #         #     # # #   # #       # #     #   # #   #   # #   # # # #   #
####### ### ### ####### ####### # # ### # ### ### ### ### ### # # ### # # # ###
#   #     #   # #           #   # # #   #   # # #     # # #   #     # # # #   #
# # # ####### ### ####### # ##### # ### ### # # # ### # # # ##### # # # # ### #
# #   #   #     #   #   # #   # # # # #     #     # # # #       # #       #   #
##### # ############# ### # ### # ### ##### # ##### ### # ######### ####### ###
#     #     #       #   # # # # # # # #     #       #     #   #   #       #   #
# ##### # # ####### ### ### # # ### # ##### ##### ####### # ##### # ### # # ###
#   #   # #   # #   #   # #   #       #           # #   #   # #   # # # # #   #
####### # # ### ### # ### ####### ### ### ##### ### ### # ### # ### # ####### #
#       # #             #       # #       # # #     # #   # #               # #
# ##### # ######### ### ##### ### # ### ### # # ##### ### # # # ############# #
#   #   # #   #     #       #     # #   #     #   #     #     # #       # # # #
### # ### # ### ####### # ##### # # ##### ### ### ### ##### ##### # ##### # # #
# # # #   # # # #   # # #       # # #     #       # # #         # #   #   #   #
# ### ##### # ### ### ############### ####### ##### # # ######### ### ### ### #
#     #         #   # #     #     # #     #                 #     # #   #   # #
# ############# # # # # ### # ### # ### ##### ##### ######### ##### # ### # # #
# #   #   #   # # #     # # # #   #   # #   #   #             #   #       #   #
# ### ### ### # ##### ### # ### # # # ### # ### ##### # # ##### # ########### #
#   #   #     #       # #   # # # # #     # # # #     # # #   # #       #     #
### ### ### # ######### ### # # # ####### ### # ########### # # ##### ### ### #
#   #   # # #   # # # #   # #   #     #                     #       # # # #   #
# ### # # ##### # # # ### # ### ### # # ##### ######### # ##### ### ### # # ###
#   # #             #   # #   # # # # # #             # #   #   #   #     #   #
####### ########### # # # ### ### # # ##### ### ##### ##### ### # # ######### #
#       # # #   # # # # #   # # #   #   #   #       # #     #   # #         # #
######### # ### # # ### ### # # # # ### # ### # ### # ######### # ########### #
#     #   #   #   #   # #     # # # #   #   # #   # #       #   #     #     # #
# # ### # # # # ### # # ### ### ### ### ### ####### ##### # ########### ### # #
# # #   # # #       # #     # #     #             #   # # #       # # #   #   #
# ### ### # ######### ##### # ####### ############# # # ### # # ### # ### ### #
#     #     #                           #           # #     # #     #     #   #
###############################################################################
