###############################################################################
#             #   #   #   #         #   #   # #               #     #         #
# # ##### ### # ##### # ### # ### ##### # # # # ### ### ### ### ### # ####### #
# # # # #   # #         # # #   # #   #   #   # # #   # #   # # #     #       #
##### # ### ### ######### ##### ### # ##### ### # ##### ##### # ####### ##### #
#           #     #     #         # #     #         # # #   # #       #   # # #
# ### ##### # ##### ######### ##### # ######### ##### ### ### ### ##### ### # #
# # # #             #   # #   #     # #       #   #       #           #     # #
# # # # ####### # ### # # ### # ############# # # # ####### # ####### # ##### #
# #   # #       #     #   #       #             #   #     # # # #   # # #   # #
# ##### ### ### ####### ### ##### ### ############### ### # ### # # # ### # ###
#     # # #   #       #   #   #           # # #     #   # #     # # #     #   #
### ### # ### ### # ### ### ############# # # # # ####### # ##### ####### ### #
# #   #     # #   # # #   #       #       #   # #   #       #   #   #   #   # #
# # ### # # ##### ### ### ####### ####### # # # ##### ######### # ### # ### # #
# # # # # #   #   #   # #         #     # # # #   # #                 #   # # #
# ### # ##### # # # ### ########### # ##### # # ### ####### # # ##### ### # ###
#   # #   #   # #     # # #         #       # #   #   #   # # #     #   # # # #
### # ######### # ### # # ##### ############# ### # ### # # ############# ### #
#   #           # #   #         # #   #   #       #     #     # # # #     #   #
# ########### ### # ### ######### # # # ####### ### ##### ### # # # ### ### # #
# # #     #   #   #   # #   #       # # #     #         # #   # # #   # #   # #
# # ### # ### # ####### ### # # ##### # ### ############# # ### # # # # # ### #
#   #   # # # #   #         # # #     #   #   #     #   # #       # # #   #   #
### # # # # # # # # ######### # # # # # ##### # # ### # # ### ##### # ##### ###
# #   # #     # # #   #       # # # #           # #   # #   #     # # #     # #
# ########### ##### # # ### ### ####### ### # ##### ##### # ##### # # # ##### #
# #       #         #     # # #   # #   #   #   #   #     # #   # # # #       #
# # ### # ### # ### # ##### # ### # ##### ##### # ### ### # # ##### # ####### #
#   #   # #   # # # #     # #           # #   #     #   # #     #   #     # # #
##### ### ##### # ######### # ######### # ### # # # # # ### # # # ####### # # #
# #   # # #       #     #   #   #   #   # #     # # # # #   # #       #   #   #
# ### # # # ##### # ### ### ### # ############# ### ##### ### ####### #########
#     # # #     #     #   #   #             # # #       #   #     #   #       #
### ### # ### ### ##### ########### ######### # ##### # ### # ### # ####### # #
#     #     # # #   #         #   #       # #   # #   # # # # # # # #   # # # #
# ##### ### # # # ####### ### # # ####### # # ### # ### # # # # # ### # # # # #
#   #     #     #   #       #   # #       #       #   #   # #   #     #     # #
###############################################################################
