###############################################################################
#           #   #   #         #     # # #   #   #       #       #     #       #
# ############# # # # ####### # ### # # ### # # ### ##### # ### ### ### # ### #
#         #     # #   # #   #   #   # # #   # #   #     # # #   #   # # # # # #
### ##### # ########### # ### ### ### # # # ##### # ######### ### # # # # # # #
# #     #         #     # # # #   #     # #             #   #   # #   # # # # #
# # ### ######### # # # # # ### # # ######### ############# ### # ####### # ###
#   #     #     # # # #         #   #     #         #     #       #   # # #   #
# ######### ### # ### ##### ####### # ####### # ### # ##### ### ### # # # ### #
#   #   #     #   #     #   #       #     # # # #     #   #   #     #   #     #
### # ######### ######### ### ### ### # ### # ##### ### ### # ### ########### #
#   # #                   #   #       # #   # #   # #   #   #   #         #   #
# ### # ### ################### # # # ##### # ### ### # ### ####### ### # # ###
#   # # #   # # #         # #   # # # #   #   #       #     #     #   # # # # #
### # # ##### # ##### ### # # ####### # ### ### # ####### ### # ####### ### # #
#   # # #   #         #   #   #   #       #     #     #     # #       # #   # #
# ### # # ##### ####### # # # # ### ##### # # # ### # ##### # # ##### ### ### #
#   # #   #   # #       #   # #     #       # # #   #     #   #     #     #   #
# ### # ### ########### # # # ########### # # # ####### ### # # ##### # ##### #
# # #       #           # # # #         # # # #     #   # # # #     # #   # # #
# # # ######### ##### ##### # # ####### ##### # ##### # # # ####### ####### # #
# # # #           # # #   # # # #   #         #     # #   #       #         # #
### ### ### ####### ### # # ### # ####### # ### ##### ### ####### # ##### ### #
#         # #       #   #   #   #         # #       #   #   #   # # #         #
# # # ### # ### # ####### ##### ### # # # # ##### # ########### ### # ####### #
# # # #   #   # #         #       # # # # #     # #     #         # # # #     #
####### ############# ### # # # # # # # # # ##### # ### # ### # # ##### #######
# # #     #       #   #   # # # # # # # # # #     #   #     # # #         #   #
# # # ### ### # # # # ##### ### ##### # ##### # ### # ### ############### # ###
#   #   #   # # #   # #   #   # #     #   #   # #   # #   #   #   #     # # # #
### ### ##### # ##### # # ### ### ####### ### # ### # # # # ### # # ### ### # #
#     #   #   # #     # # #   # # #         # # #   # # #     # # #   #     # #
# ### # # ### ### ####### ##### # # ### ### # ####### # ##### # # ### # ### # #
# # # # # #     # # #   # #     # # #   #   #   #   # #     #   #   # #   # # #
# # # # # ##### # # # ### # ### ### # # # ### ### ### ##### ####### # # ##### #
# # # # #   #   #   # #     # #     # # # # #   # #   #   #     #     #     # #
# # # ##### ##### ### # ##### ####### ##### ### # # ### ####### ### ####### # #
#   #       #         # #                   #   #           #     #   #       #
###############################################################################
