###############################################################################
#     #     # # #     #                     #   #               # # # #       #
# # ### # # # # # ##### ##### ####### ### ### # # ##### ##### ### # # # ##### #
# # #   # # # # #   #   #   # #   #     # # # #   #   #     #   #   # #   #   #
# # ##### ### # ### # ##### # # # ### # ### # ####### # ######### ### ##### ###
# # #       #     #     # # #   #   # #       # #   # #     # # #       # # # #
# ### ##### ##### ####### # # ### ############# ### # ### ### # ### ##### # # #
# #   # #       #             #   #               #   # #     # # # # #   # # #
# # ### # ### # ############# ### ### ####### ### ### # ### ### # # # # ### # #
# # #     #   #         #       #   # #   #     #         #   # # #     #   # #
# ### ### ######### # # # ######### # ### # ########### ##### # # ### ### # # #
#   #   #     #   # # #   #   #     #   #   # # #   #         #     # #   #   #
# # ### ####### ### # ##### # # ### ### ##### # ### # # ####### ### # # ##### #
# #   # #     #     #   #   #   #     #   # #     # # #     # # # #   #     # #
# # ### # # ########### # ### ### ######### # ##### # ####### # # # ##### #####
# # #     # #   #       # #   #   #   #   # #       #         # #   # #   #   #
# # # ### # ### # # # # ### ##### ### ### # ### # ### ######### ##### # ##### #
# # #   # # #   # # # # #   #     #   #       # # #   # # #   #   #   # #   # #
# ##### # # # # ##### ##### ##### # ####### ### ##### # # # ##### # ### ### # #
#       # # # #   #     #   #   #   #         # #               #       #     #
########### ##### # ######### # # # # ####### # # ######### ### # ########### #
#         # #       # # # #   # # # # #           #           #   #   # #   # #
####### ##### ### ### # # ### ############# # ### ### ##### # ##### ### # # # #
#       #     #   #   # # #   #   #       # #   # #   #     #   #   #     #   #
# ##### # ### ##### ### # # ### # # # ### # ### # ### ### ### ### ##### #######
#   # # # #   #   #   # # #     #   # # #   #   #   # #   # #     # #     #   #
##### # ### ### # ### # # ######### # # ### ######### # ### # # # # ### ##### #
#     #         # #   # #   # #     # #   # #         # #     # #   #   #   # #
### # ####### ##### ### # ### ##### # ### ### # # ######### # # ####### # ### #
#   # #   #   #       #   #   # #   # #       # # #       # # #           # # #
# ### # # ##### # ### ### # # # # ####### ######### ### # # # ####### # # # # #
# # #   #       #   # #     # # #     #   #     # # #   #   #   # #   # #     #
### ##### ##### ### ### ##### # # ### # # ### ### # ##### ### ### ### ####### #
# # #       # # #   #     #       #   # #         # # #   #       # # #       #
# # # ####### ### ### # ####### # ### ############### # ### # # # # # # ### # #
# # # # #       #     #   # #   # # #   # #           # #   # # # # # #   # # #
# # # # ### # ##### ####### ### # # ### # ######### ### ### ####### ##### #####
#       #   #             #     #     #         #       #             #       #
###############################################################################
