###############################################################################
#   #     # #               #   #             #                     # #       #
# ### ### # # # ########### # ####### ####### # ########### ######### # ### # #
# #     # #   #   # #     #   # #   # #     #     # #   #     #     #   #   # #
# # # ### ######### ### # # ### ### # ### ##### ### ### # ####### ### # ##### #
#   #   #     #     #   #               # #   # #                     #   #   #
# ### ####### ### ####### # ##### # # ### ### ### # # ### ####### ### # ### ###
# # # #       #     #     #     # # # # #         # # #   #     #   # #   #   #
### # # ### ##### # # ### ### # ### # # # ##### ### ### ### # # ##### ##### ###
#   # #   #     # #     #   # #   # # #   # #   # #   #     # #     #     #   #
# # ########### ### ########### # # ##### # ##### # # # # ### ### # ######### #
# #   #             #   #     # # #     # #         # # # #     # #         # #
# ### # ######### # # # # # ##### ######### ### ### # # ### ### ### # ####### #
# # #     #     # #   #   # #   # #     #   #   #   # #   # #     # #     # # #
# # # ### ### # # ######### # ### ##### ### # ### # # # # ####### # ### # # # #
# #   #   #   #       #     #       #       # #   # # # #     #   # #   # # # #
# ##### ### ####### # ### ######### # ### # ### ####### ##### ##### # ##### # #
# #     #         # #   # #       # # #   # #       #   #   #     # #   #   # #
# # ############# ##### ######### ### # ##### # ### # # # ### ### ####### # # #
# #       # #   #     # #             #     # #   # # # #     #       #   # # #
# ######### # # ##### ############# ####### # # ### ##### ##### ### ### #######
#   #     # # # #   # #     #     #   #     # # #   #     #   #   #           #
# ####### # # # ### ### ### ### # # # # # # ### ##### # ##### ##### # #########
#   #   # # # #     #   # #     # # # # # # # # #     #     # # #   # #       #
##### ### # # # # ##### # ####### # # ####### # # # ##### # # # ######### ### #
# # #   # #   # #   #   # #   # # # # #         # #     # #     #   #   # #   #
# # ### # # ### ##### ### # # # # ############# # ### # # # # # # ### # # #####
# #   #   #   # #     # #   # # #     #       # # #   # # # # #   #   #       #
# ### # # ### # # # # # # ### # ### ####### # ### # ##### # ####### ### #######
#   # # #   # # # # #     #     #         # #   # #   #   #   #     #   #     #
# # # ##### # # ########### # ### ##### # ##### ##### # # ##### # ##### # # # #
# # #     # # #     #   #   # #   #     #       #     # # #     #   #   # # # #
### ### ### # ##### ### # ### ### # ######### ### ### # # # ####### ### ### ###
#   #           #     #   #   # # #   # #         #   # # #       # #         #
# ### ### ##### # ####### # ### # # # # ### ### # # ##### # ### ####### ##### #
# #   #   #   # # #   #   #     # # #     # #   # #     # #   # # # #       # #
# # ### # ### # ##### ### ######### ### ############# ### # # ### # ### ##### #
#   #   #     #           #         #             #     #   #       #     #   #
###############################################################################
