###############################################################################
# #     # #         # #   #   #     #   # #       #   #   #   #         # #   #
# ##### # ### ####### ### # # # ### # ### # ######### # ### ### ##### ### # # #
#     # #   #     #     # # #   #   #   # #         # # #           # #     # #
##### # ### # ##### # ### # ####### # # # # ######### # ####### ### ### # ### #
#     # # #     # # #     #   #   # # #     #   #   #       #   #   #   # #   #
##### # # # ##### # # ##### ### ### # # ##### # # ### ##### # ### ####### ### #
#             #     # #           #   #     # # # #     #   # #       # # # # #
####### # ##### # ##### ##### ### ### ##### ### # # # ####### ##### # # # # ###
#   #   #       # # #       #   # # #     #     #   #   #     #   # #   #     #
### # ### # ####### # ### ######### ####### ##### ####### # ### ######### ### #
#       # #         # # # #   # #       #   #             # #   #   # # #   # #
# # ########### # # # # ##### # # ### ### ### ####### ##### # # # # # # ### # #
# # #         # # # #         #     #   # #         # #   #   #   #         # #
# # ####### ### # ##### ### # # ### # ### # ### ######### ####### ######### # #
# #           # # #     #   #     # # #       #           #     #       #   # #
# ##### # ##### ### ### # ####### ##### # ### ### # ####### ### # ##### ### # #
# #     # #   #       # #       # #     #   # #   # #   #   #     #     #   # #
### ######### ####### # ######### # ####### ####### ### ### # # # # ##### ### #
#   #               # #       #   #       #       # # #     # # # # #     #   #
### ### ####### ### # # ######### ##### ##### # ##### ##### # # ### ### ### ###
#   #   #     # # #   #       # #     # #     #   #   #     # #   # #   # #   #
# ##### # ### # # # # # ####### ##### ### ### ##### # # ### # ##### ##### # # #
# # #   #   # #   # # # #     # #   # #     # #   # #   #   # # #         # # #
# # ##### ### # ####### # ##### # # ### # ### ### # ####### # # # ######### ###
#         #   # #   #       # #   #   # # # # #   #   #   # # #     #       # #
# # # ##### ##### # ####### # # ##### # # # ### ##### ### # ### ####### # ### #
# # #     # # #   #   #       # #   # # # # #       # #     #   #     # #     #
# # ##### # # # ### ### ##### # # ####### # # ##### # # ##### ### ### # #######
# #     # #       # #     # #   # # #         #   # # #   #   #   # # #       #
### # # # ####### ### ### # ##### # ### ##### # ######### ### # ### # ##### # #
# # # # #     #   # #   #       #     # #   #   # #       #   #   #   #     # #
# # # # # # ### ### ######### ### # # ##### ##### # ####### # ### ### # ##### #
# # # # # #   #     #     #   #   # #       #     # #   #   #   #   #   # #   #
# # # # ##### ######### # # ### ################# ### ### ### ####### ### # # #
# # # #     #     #   # #           # #     #   #   #       #       #   # # # #
# # ######### ####### ############# # ##### # # ### # ##### ######### # # ### #
#           #                     #           #   #   #         #     # #     #
###############################################################################
