###############################################################################
#     # #               #       #         #         # # #       # #       #   #
# # # # # ##### ### # ### ### ### ### # ####### ##### # # ### ### # ### # ### #
# # # #     #   #   #       #   # #   #   # #   #   #   #   # # # # #   #   # #
# ### ##### # # ### ### ####### # # ### ### # ##### ### # ##### # ### ##### # #
#   #   # # # #   # #   #     #   # #   #   #     # #   #     # #     # #     #
##### # # # ### ##### ##### # ##### # # # # ##### # # # ### ### # ##### ### ###
#     #     #   # #   # #   #   # # # # # #     # # # #       # #   #   #   # #
# # ######### ### # ### ### ### # # # ##### ### # # # ##### ### ##### # ### # #
# # #   #     # # # #       # # #   # # #   #         # # # # # # #   #       #
# # # ######### # ### ####### # # # ### ##### ######### # # # # # # # ####### #
# # # #       #   # #         # # # #   #     #           # #     # #   #   # #
# # # # # ### ### # ########### ### # ####### ### ####### # # ### # # # ### # #
# #   # # # # #   #   #   #   #   #   # #   # #   #   #   # #   #   # #   #   #
####### ### ### # # ### ### # ### # ### # ### # ### # # ### ### ######### #####
#       #   #   # #   # #   # #         # #   # # # #   # #       # # #       #
####### # ##### # ### # ##### ### ####### ####### # ### # # # ##### # ### #####
#       #       #     #   #     #   #   # #       # #   #   # #         #     #
# ########### ####### # # # ### ### # # # ##### ####### # # # # # ### ####### #
#           # #   #   # #   # #   #   #   #   #     # #   # #   # #       # # #
# ######### ### ### # ##### # ### ####### ### ### ### ########### ##### # # ###
# #       #   #     #     # #   #     #   #   #   # # #     #         # # #   #
### ##### ### # # ####### ##### ##### ### ### ### # # # # ### ##### ### ##### #
#       #   #   #     #     #   #   #   #       # # #   #   #     #   #       #
# ##### ### # ####### # ### # ### # ### # ##### # # # ##### # ### ### # #######
# # # #   # #   #   # # # # # #   #   #   #         # # #       #   # #   #   #
# # # # # # # # ### ### # # # ### ### ########### ### # ##### ### ### # ### ###
#     # # # # #     #     # #       #     # #   # #         #   # #   # # #   #
# # ### # # ####### # ##### # ########### # ### # # ##################### # # #
# # #   # #         #   #     # # #       #   # # # #               #       # #
# # # ### ####### ### # ####### # ####### ### # # # # ####### # # ### # ### ###
# # # # # #   #   #   # #       #   #         #       #       # #   # #   #   #
# ##### ### # ####### ##### ### ### # ##### ### ######### # ##### # # # #######
#   #     # #       #   # # # #     # #             # # # #   #   #   #   #   #
# # # ##### ####### # ### ### ##### # ####### # # # # # ##### ### ##### ##### #
# # #   #   #     #   # #       #     # #   # # # #         #   #     #     # #
# # ### # ### ### ##### # ### # # # ### ### ### ##### ####### # ### # ##### # #
# #   #       #       #   #   #   #   #             #     #   #   # #     #   #
###############################################################################
