###############################################################################
#   #         #     #   #     #             #   # # #   #   #       #     # # #
# ### ##### ### # ### # ##### ### ### ####### # # # # ### # ##### # # # # # # #
#     #     #   # # # #   #   #   # #     # # # # #   #   #     # #   # #   # #
##### # ### ### # # ##### # ##### # ##### # # # # # # # # ############# ### # #
#     #   # #   #       #   #   # #       #   #     # # #       #     # #   # #
# ##### ### # # ####### # ##### # ##### # # ############### # # # ### # ### # #
# #     # #   #     #   #   # # #   # # # #   # #   # #   # # # #   # # # # # #
# ####### ##### ##### ### ### # ##### ### # ### # ### ### # ### # # # # # ### #
# #     # # #       # #   # #     # # # # #     #       #   #   # # #     #   #
# # # ### # ### ##### ### # # ##### # # # ##### # # ### ### ### # # ##### # # #
# # # # #         # #     #   # #   #           # #   #     # #   # # # #   # #
##### # ######### # # # ##### # # ####### # ##### ### ####### ##### # # ##### #
# # #             #   # # #   # #     # # #     #   #       # # # #   #     # #
# # ######### ######### # # ### # ##### ### ### # # # ####### # # ### # ### ###
#   # #       #       # #     # # #           #   # # #   #   # #   # #   #   #
# # # # ########### # # ##### # # # # ##### # ########### # ### # ### ### ### #
# #     #     #   # # #   #   #     #     # # #   # #   # #   #   # #   #   # #
### # # # ##### # # # ### # ####### ##### ### ### # # ### # ### ### ### ##### #
#   # # #       # # #       #   # #     #   #           #   #   # # #         #
# ### ########### # ### ##### ### ##### ### ##### ######### ### # # ####### ###
# #   #   #   #   # #       #   #   #     #   #   #   #   #     #     #   #   #
# ####### # # # ##### ### ##### # # # ############# ##### ##### # ##### # ### #
#   #   #   #   #     #   #   #   #         # #   # # # #       #       # #   #
### # # ####### # ##### ### ##### ### # # ### ### # # # # # # ##### ####### ###
# # # # # #   #   #     #         # # # #   # #     # # # # #   #         #   #
# ##### # ### # # ##### ### # # # # # ####### # # ### # ####### # # # ##### ###
#       #   #   # #       # # # #   #         # #     #     # #   # #   # # # #
##### # ### ##### ####### # ### # ############### ##### # ### # ####### # # # #
#     #   #   # # # #       #   # #         # #       # #   #   #       # #   #
######### ### # # # ##### ### # # # ### ### # # # ### ### ##### # ##### # # ###
# # #   #       # #   # # #   # #   # #   # # # # #     #   #   #     # #   # #
# # # # # ##### ##### # ### ### ##### ####### # ### ### # ### ##### ##### ### #
#   # #   #           # #   #   #   # #   #     #   #     #     # #   #     # #
### ####### # ####### # ##### # # ### ### # ##### ### ##### ##### ########### #
#           # #       #       #   #   #   # #   #   #   #         #   #     # #
### ##### ### ##### # ### ######### # # # # # ### # ### # # ####### # # ### # #
#     #   #   #     #               #   #     #   #   #   #         #   #     #
###############################################################################
