###############################################################################
#     # #     #     #         #       #   #   # #     # #     #     #         #
# ### # # ### ##### # ### ##### # ### # ##### # # ### # ### # ##### ####### # #
# # # #   #   #   #   #       # # #     #       #   # # #   # # #         # # #
# # # ### # ##### ##### ##### # # ##### ####### ##### # # # ### # # ####### ###
# #   # # # #   #     # #     # #   # #   #       # # #   # #   # #     #     #
# ### # # # # # ### # ### ### # # # # ### # ### ### # # ### # # ##### ### #####
# #   #   # # #   # # #     # # # #   #   # # #         #   # #     #   #   # #
# # ####### # # ### # ##### ### # ### # # # # ######### # ####### ##### ### # #
# #       #   #     #     # #   # # # # #   # #         #     # # #   # # #   #
# ####### ##### # # # ### # ####### # # ### # ############# # # # # ### # ### #
#   #   #     # # # # #   #       #   #   # #   #           #   # # # #     # #
##### # # # ####### # ### ####### ########### # ####### # ##### # # # # ##### #
#   # # # #       # #   #           #     # # #         #     # #       #   # #
# # ### # ####### # # ####### # ##### ### # # ####### ### # # # ### ##### # # #
# # # #   # #     # #   #     # #   #   #         # # #   # # #       # # # # #
# # # # ### # # ##### # ####### ### # # ####### ### # ### # ######### # # ### #
# #   #   #   # #     #   #     #   # #   #     #   # #   #   # #           # #
# # ##### # ### ####### # ### ### # # ##### # # # ####### ### # ##### ####### #
# #   #   # #   #       # #     # #   #   # # # #         #   #           #   #
# # ########### # ############# ####### # ### ############# ########### ### ###
# #       #       #           #         # #   #       #   #   #     # # #   # #
# ##### # ### ##### ##### ### # ### ##### ##### # ##### # ######### # # ### # #
#   #   #   # #   #   # # #     #     #   #   # #   #   #     # #     # #     #
### # ######### # ### # ### ######### ### # # ##### # # ### ### # ### # ##### #
# # # #   #     #   # #     #       # #     #         #   # #     #   #     # #
# # # # ### ### ### ### # ### ##### # ### # ##### ####### ### ##### # # ### # #
#   # # # #   #   # # # #   # #       #   #     # # # #     # # #   #   #   # #
##### # # # # ### # # ####### # ############### ### # ##### ### # ####### # # #
#           # # # # # #   #   # #   #     #     # # #       #   # #       #   #
# ######### # # # # # # ##### # ### # ### # ##### # ##### ### ### # ####### # #
#     #     # #   # # #     # #     # #   # #     # #     #   #   #   #     # #
######### # ##### # # # ### # ########### # # ### # ##### # ################# #
# #     # #     # #       #     # #     #   #   #     #     #                 #
# # ### # ### # ### ########### # ##### ### # ### ####### ### # # # ####### # #
#     #   #   #   # #       # #   #   # #   # #   # #     # # # # # #       # #
##### ##### ##### # # ##### # ### # ### # ##### ### # ### # ### ############# #
#         #     # #   #     #     #       #           #         #             #
###############################################################################
