###############################################################################
#     #     #           # # #     #       #     #         # #     # #   #     #
##### # ####### ### ### # # # # ### # ##### # ##### ##### # # ### # ### ### ###
#   #     # #   #   #       # #   # #     # #     # #   # #   #     #   #     #
### ##### # ### # ####### # # ### # ##### # ####### # ### # ### ### # ### ### #
# #   # #     # # #   #   #   # #       #       # #     # #   #   # # # # #   #
# ### # ##### ### # ##### ##### ########### # # # # ### ######### ### # # # # #
#       #   #   # #   #   #               # # #     # #       #   #   #   # # #
####### # ##### # ### # ### ########### ##### ### ### ########### # ####### ###
#     #   #       #   #     #   #   # #   #   #       # #     #   #   #     # #
# ### # # # ######### # ### # ### ### ############# ### # ### ### # ### ### # #
#   # # #     #     # # # #     # # #   #   # #   #   # # #     #       # # # #
# # # # # ####### # # ### # # ### # # # # ### # # ### # ### # ##### ##### ### #
# # # # # #       #         #     #   # # #     # #   #     #             #   #
# # # ########### ### ####### # ### ### # # # # ### ### ##### ####### # ### ###
# # #   # #         #   #     #       #     # #   #     #   #       # # #   # #
# # ### # ######### ####### # ### # ### # ### ##### ##### # ### ####### ### # #
# # #           #   # # #   # #   #   # #   #     #   #   #   #   #   # #   # #
# ####### ########### # ##### ### # # ########### ##### ##### ### ### # # ### #
#       #       #     #   #     # # # #   #     #     # #   # #   #       #   #
# # ####### # # # ##### # # # # ### ### ### # # ### ### # # ####### ####### ###
# # #     # # #   #     #   # #   # #     # # #   #       # #   #     #     # #
### ### ######### # ####### ### ####### ##### ### ##### # ### # ####### ##### #
#   #           # # #       #             #     # #   # # #   #       #   #   #
# ### ####### # # ##### ### ### ##### ##### ####### # # ### ### ##### ### # # #
# #   #       #     #   #   #       #       #       # #   # # #   # #     # # #
# ### # # ### ##### ######### # ####### # ### ####### ### # # ### # ### ### # #
# #   # # # # # #             #     #   #   #     #   #   #   #   #   #     # #
# ######### # # # ### ####### ########### # # # ### ### ####### ### # ### #####
#   #   #     #   # #   #           #     # # #   #   #     #       #   # # # #
# # # # # # ##### # # ##### # # ### ##### ### # # ########### # # ######### # #
# # # #   # #     #     #   # # #     #       # #             # # #     #   # #
# ### ##### # ##### # ##### ### # ##### ### ### ####### ####### ### ####### # #
# # # # #   #   #   #     # #   #     # #   #   #     #   #     #     #     # #
# # ### # ### # # ####### ### # ### ### ######### ####### # ##### ######### # #
#     #   # # # # #       #   #   #   #     #   #         #     #   #   #   # #
######### # ### # ####### ### # # ######### # # ####### # ##### # # ### # # # #
#         #     #       # #   # #         #   #       # #     #   #       #   #
###############################################################################
