###############################################################################
#                   #   # #       #               #     #   # #   #     # # # #
########### # # ##### # # # # ##### ############# ### ### # # ### ### ### # # #
#     #   # # #   #   # #   #         # #     # # #     # #     # #       #   #
# ##### # ####### # ### ############### # ### # # ##### # ##### # # ### ##### #
# #     # #     # # # #     #       #   #   # # #       #   #     #   #   #   #
# # ### # # ### # # # ####### ##### # ### ### # ####### ####### ### # # ### # #
#   #   #     # # #   #     # #   # #   # # # #     #   #     #     # #     # #
############### # # ### ### ##### # ### ### # ##### # ### ### # ### ##### # # #
#             # # # #   # # # #   #   # # # # #       #   # #   # # #     # # #
# ##### ##### # # # # ### ### ### ### # # # # ### # ### ### ##### # ####### ###
#     # #         #     #       #   # #     #     # # # #   #   #   # # #   # #
######### # ##### ##### ### ### ### # ### # ##### ### ### # # ### # # # # ### #
#       # #     #     # #   #   #         #   #       #   #   #   #   # #   # #
# # # # ####### ##### # ####### ####### ####### ########### ### ####### ### # #
# # # # #   # #   # # # #     #     # #     #   #   #   #       #     #   #   #
##### ### ### ### # # # # ### ##### # ### ### ### # # ######### # ### # #######
#       #       # #       #           #   # # # # #   # #   #   # # #         #
# ##### ### ####### ##### # ##### ####### # # # # ##### # ### ### # # ### #####
# #   #       #     # #   # #         #   # #   # # #     #   #     # # #     #
# # # # ####### # ### # # # # ####### ### # # ### # ### ### # # ##### # # ### #
#   # #   #   # #     # # # # # #   #       #   #   # #     #     #     #   # #
######### ### # ##### # ##### # ### ####### # ##### # # # ####### ### ### # ###
#   #         # #     #   #   #       #   # #     #   # #   # # #   #   # #   #
# # # ##### ### # ##### ### ##### ### ### # # ##### # ##### # # ##### # ##### #
# # # #         #   # # #   # #   #     #           #   #         # # #     # #
# # ### ### ####### # ####### # # # # ####### # ##### # # ######### # ##### # #
# # #   # # #     # #       #   # # #   #     #   #   #           #       # # #
# ### ### # # # ########### ####### ### # ### ### # ####### ### ######### #####
#       #     # # #   #   #         # #   #     # #   # #     #     #   #     #
##### # ######### ### # ### ### ### # ### ##### ### ### ### ######### # ### # #
# #   #       #       #       # #   # #   #     #     # # #       #   # #   # #
# ############# ##### ####### ### # # # ### ##### # ### # ##### ##### # # #####
#   #   #         # #         #   # # #   # #     #       #   #       # # #   #
# ### # # ######### # ########### ### ### # # ### ####### # # ####### # # ### #
#   # #   #   #     #     #     # #     # # # #         #   #   # #   # # #   #
# ##### ##### # ##### # # ### ### ##### # ##### ######### ####### ### # ### ###
#               #     # #   #       #     #         #               # #       #
###############################################################################
