###############################################################################
#     #         #               #   #         #   #           #   #     #     #
# ### ##### ### # ### # ### ####### ##### # # # ##### ##### # # ####### # ### #
# #   #   # # #   #   #   #       #       # #     #       # # # # #   #   # # #
### # ### ### # # # ##### ##### # ### ### # ##### ### ### ##### # # ### ### ###
#   #   #       # #   #   #   # #   #   # # #       # #   # #   # #   #   #   #
# ##### # ### ####### # ### # ##### # # # ### ##### ### # # # ### ### ### ### #
# #       #   #   #   #   # # #     # # # #     # #     #   #   #             #
# # ########### # ### ##### # # ### # ### ### ### # ##### # # ##### ##### #####
# # #       #   #       #   # #   #   #     #   #       # #         #   #     #
# ##### ### # # # ### ##### ##### ### ####### ####### # ####### ##### ### ### #
# #       # # # # # # #             # #     #   #   # #   #     #           # #
##### ### # ### # # ### ### ######### # ### # # # # ### # ####### ### # # # ###
#   # #   #     #     # # #     #       #   # # # #     #   #     #   # # #   #
# # ### ### ############# # ### ######### ### ##### # # # ####### ### # # # ###
# #       #       #         # # #   #     #   #     # # #       # # # # # #   #
# ############### ##### # ### ### # # # ############# # ### # ### # ### ##### #
# #         #   # # #   # # #     #   # #   #         #   # # #       # #     #
### ### # ### # ### ##### # ####### ##### ##### ### ### # # # ####### # ### # #
# # # # #     # #       #   #       #       #     # #   # # #     #   # #   # #
# # # # ####### ##### ### # ##### ### ##### ##### # # ### # ##### # ### ##### #
# # # #     # #         # #     # #     # #     # # #   # # #   # # #   #     #
# # # ##### # ####### # # # ### # ### ### # ### # ############# ##### ### # # #
#     #     #   #     # # # #   # #   #   # #   #   #         #       # # # # #
# ### # # ##### # ##### ### ### ### ### # # ### ### ####### # ####### # ### # #
# # # # #     #   #   #   #   # #     # #   #   # # #       # # #       #   # #
# # # # ##### # # # ##### ### # # ##### # ### ### # ######### # # ### ### # # #
# #   # #   # # # #     #     # # #     #   #     # #   #   #       # #   # # #
# # ##### # # ####### # ### ### # ######### ##### # # ### # # ####### # ### ###
# #     # #   # # #   #     #   #     #       #       #   #   #       # #     #
# ##### # # ### # # # ####### ######### ##### # ##### ##### ### ########### ###
#     # # # # #     #     #           # #     # # #   #     # #       #   # # #
##### # # # # # ### # # # ####### ### # ### ### # # ##### ### # ####### # # # #
#     # # #   # #   # # #       # #   #   # #   #     # # #   #   #   # # #   #
##### # ##### # # ### ### ##### ### ##### ### ######### # ### ### # # # # #####
#   # #   #   # # #   #   #   # #   #       #   #       #   #   #   #   #     #
# ### ##### ######### # ##### ####### ######### # ##### # # ### ############# #
#       #     #       #     #                 #   #     # #           #       #
###############################################################################
