###############################################################################
#   #     # #         #                 #         #           #   #   #       #
### # # ### ##### # # # ######### # # # ##### ### # ##### # # # # ### ### #####
# #   #       #   # # #         # # # # #     # #   #   # # # # #   # # #     #
# ### ### ### ##### # # # ##### ##### # # ##### # ##### ### # ### ### # ##### #
# # # # # #   #     #   #     # # #   #   # #   #   #   #   # # #   # #       #
# # ### ### # ### # # # # ####### ### ### # # # # ### ######### ### # ### ### #
# #     #   #     # # # #         # # # #   # #   #     # #   #     # # #   # #
# ### # # # ### # ### ############# ### ####### ### ### # # # ##### # # ##### #
#   # #   # #   #   #         #   #       # # # #   #   #   #     #   # # #   #
# ####### ### # # # ########### # # ####### # ### ### ########### # ### # # ###
# #       #   # # # #   #       #                   #             #           #
# ##### # # # ### # # # ### # ####### ##### ##### # # ######### ##### #########
#   #   # # # #   #   # #   # #     #   #       # # # # #     #       #       #
# ############# # # ##### ####### # ### # ####### # ### ### # # ### ######### #
# #       #     # #           #   #   # #     # # #   #   # #   #   #       # #
# ### ### # ### # ##### ##### # ####### # # ### ######### # # ####### ### # # #
# #   # # # #   # #     # #           # # #               # #         #   # # #
# # # # ### ######### ### ### ######### ######### ####### ### # ##### # ##### #
#   #         #       # # #       #   #   #     # #   #   # # #     # #       #
##### ### ### ##### ### # ##### # # # ##### ### # # # # ### # ##### # ### ### #
#   # #     # #       #   # #   # # # #   #   # #   # # #   # #     # #     # #
# # # # ### # # ##### # ### ####### # # ####### ##### ### ##### ##### ### ### #
# #   # #   # # #     #   #   #   # #   #       #   # # # #   # #     #   #   #
##### ### # # ####### ### # ### ### ##### ##### # ### # # # # # ########### ###
#     #   # #   # #             #   #   #     #     #   #   # # #         # # #
##### ### ##### # # ####### ##### # # ### ##### ### ######### ### ##### # ### #
#       #     # #       #         # #   # #   # #     #     # # # # #   #     #
# # ### ### ####### ### # ####### # # ##### # ### ### # ##### # ### # # ##### #
# # #     #   #     #   #       # #   #     # #   #     # #     #     #   # # #
# ### ##### # # ### # ### ##### # ##### # ### ##### ##### # ### # ####### # # #
#   # #     # # # # #   #   #   # #     #   #             # #   #   #     #   #
### ##### ##### # # ### ### ####### ##### ############# ##### # ##### # # # ###
#       # # # # # # #     #       # # # #         #   #   #   #       # # # # #
# ######### # ### ####### ##### # # # # ########### ####### ########### ##### #
# #     #         #   #   #   # # #   #   #     #         #   #       # #     #
# # ##### ####### # # # ##### ##### ### # # ### ### ### # # # ### # # ### ### #
#       #   #       #                   #   #         # #   #     # #     #   #
###############################################################################
