###############################################################################
#       # #             #                 #   #   #       #       #     #     #
# # ##### # ##### ### # # ##### ############# ### ### ##### ##### ### ### # # #
# #       # # # # # # #   #   #       # #     #   # # # # #   #   # #     # # #
# ####### ### # ### ######### # ####### # ### ### # # # # # # ##### ### ### # #
# #   #   #   #   # # #     # # #     # # #     #   # # #   #   #     # #   # #
# # ### ### # # # # # # ### # # ##### # ### ##### ### # ##### # # ### # # ### #
# # #   #   #   #       # #   #   #   #   #           # #   # #   # # # #   # #
# # ### ##### ######### # # ##### # ### ### ########### ### # # ### # # ### # #
#   # #     # #       # #         # #   # #   #     # # #     #     #   #   # #
##### ##### # # ### ##### ##### # # # ### ### ##### # # # # # ############# ###
#   #   #   # #   # # #   # #   #   # #   #   #       #   # #     #     # # # #
# # # # # ### ### # # # ### ####### # ### # ##### ### ### ### # # # ### # ### #
# #   # #     #   # #   #     # # #   #   # #   #   #   # # # # # # # # # #   #
# ### # ### ### ##### ##### ### # ### # ### ### # ##### # # ##### ### # # # # #
#   # #     #   #   # #   #         # # #   #         #   #       #   #   # # #
### # ##### ### # # ##### ####### # # # # ### ##################### ### # ### #
#   # # #   #     #   #   #   #   # #       #     #   # #   #       #   #   # #
# ### # # ### # ### ### # # ####### ### # ### ##### ### # ### ### ### ####### #
#   # # # # # #   #     # #   #   #     #       #       # #   #   #       #   #
# # ### ### ########### ### ### ##### ### ##### ##### ### # ##### # # ### # # #
# # #   #         # #     #     #     #       #       # #       # # # #     # #
# # ### ##### # ### # ### ##### ### # ### # ####### ### # ####### # ### # #####
# #     # #   #   #     #           # #   #       # #       #       #   # #   #
### # ### ### ### # # # ##### ####### ##### ##### ### ##### ##### # # ####### #
# # # #         # # # # # #   #       #   # #   #       # #     # # # #       #
# ### ### ### # # # # ### ##### # # # ### # # ### ### ### # ##### ####### ### #
#       #   # # #   #   #       # # # # #       #   #   #       # #     # #   #
########### # # ### ##### # ######### # # # ######### # ####### # # ### # # ###
#   #     # # # #   #     # #   #   #   # #         # # # # # # # #   # # # # #
# ####### # ##### # ##### ##### # ### ### # ##### ####### # # # # ### # # # # #
# #     #   #     #   #   #     #       # #   #             # # #     #   #   #
# # # ############### ##### ### ##### ### ### ##### # ####### # ############# #
# # #   #         # # #       #       #   # #   # # #     #   #   # #       # #
# # # ##### # ### # # # ####### # ##### ### # # # # # ### # ##### # # # ##### #
# # #   #   # #   #   # #       #     # #   # # #   #   #   #     # # # #     #
# # ### # # ### # ##### # ### # ##### ### ### # ########### # ##### # # # #####
#     #   # #   #       # #   #     #   #     #           # #   #     #       #
###############################################################################
