###############################################################################
# #   #   #     #           #     #   # #       # #         #   #           # #
# ### ### ##### ### ##### ####### ### # ### ### # ##### # ### ##### ####### # #
#   #   # #   #   #   #     #         #       #   # # # #   #     # #     # # #
### # ### # ### ### ##### # ### ##### # ### ####### # # ##### # ### # ### # # #
#   #     # #       #     # #   #   # # # # #         #   # # # #   #   # #   #
# ####### # # ####### ##### # ### # ##### # # ### # ### # # # ### ### ### ### #
# #     #   #   #   #   #       # #       # # #   #     # #   # #   #   #   # #
# # ##### # ### ### # ######### # ####### # # ############# ### # # # # ### ###
# #   #   #       #   #   #   # #     # #       #   #       #   # #   # # # # #
# ### ########### # ### ### ### ####### ##### ##### # ### ### # ####### # # # #
#     #       # # # # #       #     #           #       # #   # #       # #   #
### ### ##### # ### # ####### ### # ######### ### ### # ### ##### ####### ### #
#   #   # #   #     #           # # #   # #   #     # #   #     #       #     #
# ### ### # ### ##### ### # # # # ##### # ### # # ### ### # ### # ##### #######
# #   # #     # #     #   # # #       # # # #   #   # # # #   #   #   #   #   #
# # ### # ### # # ##### ####### # ### # # # # ######### ### ### ### # ### ### #
# #   # #   # # # #   # #     # # # #                   #     #   # #   #     #
# ##### ### # ##### ### ##### # ### ### ### ############# ######### ### #######
# # #   #   #     # #   #   #     # #   #           #     #     #   #       # #
# # # ### ### ##### ##### # ####### # ####### ##### # # ### # ### ########### #
# # #   # #         #     # #           #       #   # #     #   # #   #       #
# # ### # # ##### ####### # # # ### ##### ### ### # # ########### # # # ### ###
# #   #   # #   #   #     #   #   # #     #   #   #                 #   #     #
# ### ##### # # # # # # ####### ########### # # ##### # # ######### ######### #
# # #       # #   #   #   # #   # # #       # #   #   # #     # # # # #   # # #
# # # ### ### ######### ### ### # # ##### # # ### # ### # # ### # ### # ### # #
# # #   # #   #         #   #   #         # # #   # #   # #     #       # #   #
# # ### # ######### # ### ########### # ### # # # # ##### # ### # ### ### # ###
#   #   #   # #     # # #           # # #   # # # #   # # #   # #   #   # #   #
# # # ### # # # ##### # ##### ########### # ### ####### # ### ### # ##### # ###
# #   #   #   # # #   # #   #     #       #   #     #       #     #     # # # #
####### ##### # # # ### # # ##### # # ##### ############### ######### ### ### #
#     # #   # # #       # #   #     #     #   # #       #           #       # #
# ### ### ### # ##### ##### # # ####### # ### # ### ### # # # # ### # ####### #
# #       #   #     # #     #     #     #   # #   # # #   # # #   # # #       #
# ################# ##### # ####### ####### # # ### # ### ######### ##### ### #
#                   #     # #         #     #     # #             #         # #
###############################################################################
