###############################################################################
#     # #         #         #           #         #       #   #         #     #
# # ### ### ##### # # # ####### ####### # ########### ##### # # ####### ##### #
# # #   #       # # # #   #   # #     #     #   # #   #     # # #   #   #     #
# # # ### ########### ### ### # ### ####### ### # # ### ##### # # # # ### ### #
# # #     #   #   #   # #   # #     # #   # #   #   #   #   # #   # #     # # #
# ### # # # ##### # ### # # # # ##### # ### # # # ### ### # ####### # ##### # #
#     # #   #     # #   # #   # #     # #   # # #     #   #   #     #   # #   #
# ######### # ##### # # ########### # # ### # ### ##### ### # # ####### # # ###
# #     #           # # # #     #   #     #       #     # # # # #     # #   # #
# # ### # # ### ####### # # ############# # ######### ### ### # ##### # ### # #
# # #   # # # #   #   #   # # #   #     #   # # # # # #       #   # # # # #   #
### ### # # # # # ### ### # # ### # ####### # # # # # ### ##### # # # # # ### #
# # #     # #   # # #             # # #   # # #   # # #   #     #   # #   # # #
# # ### # # ##### # ### ########### # # # # # # # # # ##### ####### # ##### # #
# # # # # # #     # #     #       #     #   #   # # # # #   #     #   #   # # #
# ### # ######### # # ##### ### # ####### ####### # # # # ####### ##### # # ###
#     # # #       #   #     # # #   #         # # #   # # #     #     # #   # #
##### # # ### ### ### # ##### # ### # ### ##### # # ### # # ##### ### # ##### #
# #     #     #   #   #     #   #   # # #     #       #     #   # # # # #   # #
# ### ####### ### # # # # ####### # # # ##### ### # ### ####### # # # # ### # #
# # # #   #   # #   #   #     #   # #     #   #   # #             # # #       #
# # ### ##### # ######### ############### ##### ##### ######### ### ### # ### #
# #   #   #     #     #     # # #   # #         #     #     # # # #     #   # #
# ### # ### ### ##### # ##### # ### # ### # ### # ### # ##### ### ##### ### # #
#   #         # #   #   #         #   # # # #     #   #       #         #   # #
### ### ####### ### ### ### ######### # # ################# ### ### ### # #####
# #   # #       #       # # #   #     #     # #     # #           #   # #     #
# ### # ######### # # # # # # ####### # ##### ### ### # ### ##### ##### # ### #
#     # #         # # #   # #     # # # # #   #     # #   #     #     # # #   #
##### ######### ##### ### # # ##### # # # ### # ##### # ##### ### ##### ### ###
# #     #         #   #     # # # # # # #   #       #   #     #     #     # # #
# ##### # ##### # ##### ##### # # # # # ### ### ##### ##### ######### # # ### #
#         #   # # # #           #   #         #     #   # #   #     # # # # # #
### ####### ####### # ##### ### # ##### # ######### ### # ### # ##### ##### # #
#         #     #   # #       #         #   #     #     # #     #     #     # #
# ############# ### ####### ### ########### ### ### # ### ####### ### ##### # #
#               #           #         #             #         #     #         #
###############################################################################
