###############################################################################
# #         #         #       #       # # #       #         #     #         # #
# # # ### ### # ####### ####### # # # # # # ##### ### ####### ##### ####### # #
# # #   #     # # # #   #       # # # #     # #             # #       #       #
# ############# # # # # ######### ########### ############# # ##### # #########
#   #     #   #   #   # #     #   # # #   # #       #       #   #   #         #
# # # ### ### ### # ##### ##### # # # ### # ##### # ### ####### # # ### #######
# # # #   #   # #   # #   #   # #   #     #   #   #   #         # #   # #     #
# ### # ### # # ### # # ### ### # ####### ### ####### # ####### # ####### #####
#     # #   #   # #   #   # #   #         #   #     #       #             #   #
# ##### # ##### # # ##### # ########### # # ####### ####### ##### # ####### ###
# #   #   #       #   #   # # # # # # # #   # #     #     # # #   #   #     # #
# # # ### # ### ##### ### # # # # # # # ### # ### # ##### # # # ### ### ##### #
# # # #   # #   #   #         # # # # # #         #   # #     # #   # # #     #
# # ### ### ####### ####### # # # # # # # ### # ### ### ######### # # # # # ###
# #     # # #     #       # # # #   #   #   # #   #         # #   #   #   # # #
# ####### # # ### ##### # # ### # ####### ####### ### ##### # ##### ####### # #
#       #       #       #   #               # #   #   #   # #     # #   # #   #
##################### ### ### ##### ##### # # ####### # ##### ##### ### # ### #
#                   # # # # # #     #     # #     # #     # #         # # # # #
# ######### ####### # # # # # ############### ### # # ##### ####### # # # # # #
# #       # # #     # # #     #   #     #     # # #       # #     # #       # #
# # ### ### # # # # # # # ##### # # # ### ### # ### ##### # ### ##### ####### #
# #   # #   # # # #   #   #     # # # # #   # # # #     # # # #   #   #       #
# ##### # ### # # ### # ####### ##### # ##### # # ####### # # # ### # # #######
# #     #   #   #   # #   #     # #   # #         # #         #     # #       #
# # ######### ################# # # ### # ######### ### ##### ### ### # #######
#   #     #   #       #           #     #   #           #   # # # #   #   # # #
# ### ########### ### ########### ##### ### ##### # ### # ##### ### ##### # # #
# # # #           # #   #     #   #   #   # #     # # #     # #               #
# # # # ### ##### # ### ##### ### # ### ### ### ### # # ##### ############### #
# # #     #   #   #     #   #     # # #     #   #     #           #     #     #
### ######### ########### # # ##### # # ################# # # ##### ##### #####
#   # #   #     # #       # #     #   # #     #   #   #   # #   # # #   # #   #
# # # ### ##### # ##### ##### ### # # # # ####### ### ### # ##### # # ### ### #
# # #     #             #   #   #   #       #       #     #   #     #   #     #
# ####### ######### ### ### ### ####### ### # ##### # ### ##### ### # ##### ###
#                     #           #     #     #       #         #             #
###############################################################################
