###############################################################################
#   #   # #           #   #             #   #   # #       #   #               #
### ### # ### ########### # # ####### # ### # ### # # ### # ### ###############
#       # #     #     # #   #   #     #       #   # # #   # #           #     #
# ##### # # ##### ##### ### ####### ### ####### # ### ### # # ####### # # #####
#     #       # #   #     # #   #     # # #     #       #     #   #   # #   # #
######### # ### # # # ##### # # ####### # # # # ### ### ##### ### # ### ### # #
#   #     # # # # #         # #       # #   # #   #   # #   #   #   # #       #
# ######### # # # ######### # # ### # ### ####### # ##### # ### ##### # ##### #
# #                       #   # #   #       #     #       # #       # # #   # #
# ##### # ### ### ##### ####### ### ####### ############### ####### # # # # # #
#   #   #   #   # #   # #     #   # #         #     #     #   #   #   # # # # #
# # ### # # ### ### ### # ##### ##### # ####### ### # ####### # ##### ### ### #
# # #   # #   #   # #     #   # # # # #         #   # #   # # # #   #     #   #
# # ########### # # # # ### ### # # # ### ########### # ### # # # ### ##### ###
# # #         # #   # # #     # # # # #   #   #             # #   #   #     # #
# ### ### # ### # ##### # ####### # # ##### # # ##### # # # # # ##### # ##### #
#       # #     #     # #   #   #   #       # # #     # # # #   #     #       #
### ####### # # ######### ### ### ##### ##### # ### # ### # ##### ##### ##### #
# #     #   # #                     #   #     # #   # #   #   #   #   #     # #
# # ##### ##### # # # ### # ######### ### ##### ##### ##### # ##### # ##### ###
#       # #     # # #   # #     # #   # #       #   #     # # #     # #       #
# ######### ### # ### # # ### ### # ### ### ### # ### ### ##### ### # # ### ###
# #     # # #   #   # # # #   #   # # # #   #   # #   #   #     # # # #   #   #
### ### # ### ######### # # ### ### # # # ####### ##### ######### # ##### # # #
# #   #       #         # #       #   # # # #     #   #           # #   # # # #
# # ######### # # ####### ####### ##### # # # # ### ### ##### ##### # # # ### #
#         #   # #   #           #   #   #   # # #   #   #   #       # # # #   #
# # # ### # ### ### # ##### # # # # # ####### # # ### ##### ####### # # # # ###
# # # # # #   # #   #   # # # # # #   #       # #     #     #     #   # # #   #
####### # # ##### ####### # ### # ##### # ############# ##### ########### ### #
#         #   #   #         #   #   #   #           #   #   #     #     # #   #
# ### ##### ### ### ######### # # ### # ########### # ##### # ### # ### # # ###
# #   #   # #   # #     #   # # # #   #   #         #     #   # #   #   # #   #
### ### # ### ### ### ### ##### ##### ##### # ### ### ### ### # # ### ### ### #
#       # #       # # #   #         #   #   # # #   #   #   # # # # # #   #   #
### ####### ##### # ### ### # ######### # ##### ### ### ####### # # # # ### ###
#         #     #   #       #           #     #                 #   #   #     #
###############################################################################
