###############################################################################
#       #     #     # #     #         # #         #   #   #     # # #     # # #
# ##### ##### # ### # ### # # ### ### # ### ### # ### ### # ##### # # # ### # #
#     # #     #   # #   # # # #   # #     # # # #   #       #   #   # #   # # #
# ### # # ####### # # # ### ### ### ##### ### # # # ##### ##### # ### # # # # #
# # # #   #       #   #   #   # #       #   #   # #   #     #   #   # # # #   #
### # ####### # # ### ### ### ######### ### ####### ####### # ### # # # ##### #
#   # #       # #   #   #   #     #     # #         #   #   #   # # # # #   # #
# ### # ####### ####### ### ##### # # ### ######### ### # # # ### ### # # ### #
#     # #   # # #   # #   # # #     # #           #       #       # # #     # #
### ### ### # # # # # # ### # # # ########### ### ####### ### ##### # ### ### #
# #   #       # # # #   #       #     #       #           #         #   #   # #
# ### # # ##### ### ########### ##### ### ########### # ####### # ##### ### # #
#       #   #   # # #         #   #       # #   # #   #       # #       #   # #
# ########### ### # # ##### ##### ##### ### # # # ####### ### ### ### ### ### #
# #   #     # # #   #   # #       #       # # # # #     # # #   # # # #     # #
# # # ##### ### ### ### # ##### # # ### ### # # # # ##### # ### # # # # ##### #
#   #   #   # #           #   # # # #   #     #   #     # #     # #   #   #   #
##### # # ### ##### # ### # ### ##### ##### ### ####### ##### # ### ### # # ###
#   # #   #   # #   #   # #   # # # # #     #   #     # # # # #   # #   #     #
# ### ####### # # ##### # ### ### # # ######### ### ### # # # ### ######### # #
# #   #   #   #       # #     #   #   #   #         #       #   # #       # # #
# # ### # # ######### ######### ####### ### ### ### # # # ### ### ####### # # #
#   # # #     # #     # #   #       # #     #   #     # #       # # # #     # #
# ### # ##### # # ##### # # # ### ### ####### # # # # # ##### ### # # # #######
# # #   #     #   #   # # # # #           #   # # # # #   # # #     #       # #
# # # ### ##### ### # # # ### ########### # # ### ### # # # ####### ####### # #
#   #   # #   #   # #         # #   # #   # #   #   # # # #       #       # # #
### ### # # # # ### ### # ##### # ### # # ##### ### ### ##### ### # # ####### #
# # #   # # # # #     # #   # #     #   #         # # # #       # # #         #
# # ##### # # # ##### ####### ### ####### # ### ### # # # ######### ##### ### #
#       # # #   #     #     #   #     # # # #   #     #           #     # # # #
##### ### ####### ##### # ### ####### # # # ############### # ### ####### # # #
#     #         #   #   #     #   #   # # #   #   #       # #   # #       #   #
# ##### ####### # # # # ##### ### # ### ##### # # # ### ####### # ##### ### # #
# #   #   #     # # # # #     #     #         # #     #     # # # # #   #   # #
# ### ### ##### # ### ### ######### # ##### # # ### ####### # # ### # ### ### #
#   #         #   #     #             #     #     #       #   #   #   #     # #
###############################################################################
