###############################################################################
#     #       #     # #         #     #       #           #             #     #
### # ##### # # ### # # # # # ### ### ### ### # ### ############### # # # # ###
#   #       # #   # #   # # # #   #   # # #   # #   #   #   #     # # #   # # #
# ####### ### ##### ##### # ####### ### # # ### # ### # ### ### ##### ### ### #
# #     #   # #     # #   # #   # #   # # #     #   # #   #   # #     # #     #
##### # # # ### ### # ### # # ### # # # ####### ##### ##### # # # ##### ### ###
# # # # # #   # #   # #   # # # #   # # #   #     #       # # #     #   #   # #
# # # ### ### # # ### # ##### # # ### # ### # ### # ### ##### ### ### ##### # #
# #     #   # # # # #     #   # # # #   #     # # # #   #   #   #   #   # # # #
# ##### ### # # # # ##### # # # # # # ### ##### # # ####### # # # ##### # ### #
# #   #     #   # # #       # # #   # # #       #   #     # # # #   #   # #   #
# # # ### # ####### # # ####### ### ### ### ########### # # # ##### # ### # ###
#   #   # #     #   # # #   #   #         # # #         # # #   #     # #   # #
# ##### # ####### ### # # # ### # # ##### # # ########### # # ### ##### # ### #
# #     #             #   #   #   # #     #     #     # # # #   #   #   #   # #
### # ######### ######### ### ####### # # ### # ##### # # # ### # # # # # # # #
#   # #     #   #     # #   #         # #     #   # #   #         #   #   # # #
# ##### ### # # # ### # ######### ############### # # ### ############# ### # #
#       #     # # #   #     #     #   # #   #     # #     #         #   #     #
# ########### # # # ### ### ##### # ### # # # ### # ##### ### #################
# #   # # #   # # #   #   # #   # #     # #   #   # # #   # #   #     #   #   #
# ### # # # # ### ### ### ##### # ##### # ####### # # ### # ### ### # ### ### #
#     # # # #   #   # # #   #   #   # # #   # # # # #   #     # # # #       # #
# ### # # ##### ### # # ### # # ### # # ### # # ### # ##### ### # # ####### # #
# #   #   #   # #   #   #   # #     #         #         # #       #       # # #
# # ### # # # # ### # ##### # ####### ##### # ### # ### # ### # ######### # # #
# #     # # #   # # # # # #   #     #   #   #     # # # # #   #   #     # #   #
# ### ### # ##### ### # # ### ### ######### ### ### # ### # ######### ### #####
#   #   # # #   #   #   #     #   #   #   # # # # #     #         # #       # #
### ### # ### # # # # ####### ### # ##### ### ### ### ####### ### # # ####### #
# #   # # #   # # # #   #   # # # #   # # # # #   #         #   #         #   #
# ### ### # ### # # ### # # ### # ### # # # # ### # # ####### ####### ####### #
#   #   # #   # # # #     #           # #       #   # # #       # #     # #   #
# # # # # ##### ### # ### ### ####### # # # ### ##### # # ####### # ### # # ###
# #   # #     # # # # # # #   #       #   # #     #               #   #       #
# ####### ### # # # ### # ##### ##### ########### ### ########### ##### ##### #
#     #     #   #         #         #                       #         #     # #
###############################################################################
