###############################################################################
#   # #             #     #     #   #         # #   #   # # #     #           #
# # # ### ##### ### # # # # ### # # # ##### ### ### # # # # ### ##### # ##### #
# #       #     # #   # #   #   # #   #         # # # # #   #         # #     #
# ##### ####### # # ####### # ### ##### ##### ### # # ### ### ######### # ### #
#   #   #     # #   #       # #     #   #       #   #   #       #   #   # #   #
### ##### ### ### ##### # # # # # ##### ##### # # ### ### ##### # # ##### ### #
#   #   #   #         # # # #   #   #   #     #         # #   #   #   #     # #
# ### ##### # ##### # ### # ### # ##### ##### ##### # ##### # # ##### #########
# #   #     #     # #   # #   # #     #   #     # # #   #   #   #   #   #     #
# # ########### ########### ### ### ### ######### # ##### # # ### # ### # ### #
# #           # #   #         # #     # #     #           # #   # # # #   #   #
##### # # ### # # # # ####### # # ### ##### ####### # ##### ##### # # # # # ###
#     # #   #     # # #       # #   #   #     #   # #     #   #   #   # # # # #
# ### # ### ####### ### ### ### # ##### # ### # # # # # # ##### ######### # # #
#   # # #   #       #   #   # # #   #   #   #   #   # # #       # #       # # #
### # ##### ##### ### ### ### ### # # ##### ### ##### ########### # ##### # # #
# # # #     #     # # #     # #   # #     # #     #       #   #     # #   #   #
# ### # ##### ### # ####### # # ### ### ### ####### # ### # # ####### # ### # #
#     #   #   #     #       #   #   #   # #   #     #   #   #   #       # # # #
# ### # ### ##### ####### # ### # ####### ### ########### ####### # # # # # # #
#   # #   # #   #     #   #   # # #               # #   #       # # # #   # # #
# ####### ### ####### # ##### ##### ### # # ##### # # # ######### # ##### # # #
#       #   # #       # #     #       # # #   #   #   # #       # #     # # # #
# ### ####### # ### ### ######### ####### ### # ### # # # # ########### ### # #
#   #       #   #   #     # #         #     # #     # #   #         # #   # # #
# ######### # ######### # # ####### ####### ##### # # ############# # ### ### #
#     #     #     #     #   #   # #   #   # #   # # #   #           #     #   #
# ### ##### ##### # ### ### # # # # ### # # ### ### ##### ############# ##### #
#   #     # #   # # #     # # #   #   # #     #   #   #       #         #   # #
# ##### # # # ### ### ### # ##### ##### ### ### # ### ##### # ##### ##### # ###
# #     # #   #   #   #   # #     #   #   #   # # #     #   # #   #   #   #   #
# ##### # ######### ### ##### ### # ### ### ### # # ### # # # ### ### # ##### #
# #   # # #         #         #   # # #   #   # # #   # # # #   # #   #     # #
# # # # # # ####### ### # ##### ### # ### ### # ### # # # ### ### # ### ### # #
#   # # # #     #   # # #   #       #   #   #   #   # # #   #     # #   #   # #
### ### # ####### ### # ### ####### # ################# ####### ### ### # ### #
#   #   #   #       #     #       # #                     #       #     # #   #
###############################################################################
