###############################################################################
#       #                   #                 # #   # #   #     # #     #   # #
# ##### # ############### ### # # ##### ### # # # ### # ### # ### ##### # # # #
# #     # #   #       #   #   # # #       # # # #       #   #   #   #     # # #
# # ####### ### # ### # ### ### ### ######### # ##### ##### ### ### # ##### # #
# # #     #     #   # #   # # # #     #   # # #           #   #     # #       #
### # ####### ####### ### ### # # ##### # # # ### ####### # # ##### # ####### #
#   #         #     #     #   # #       #   # #       #   # #   # # # #   #   #
# ### ######### ### ##### # ### ############# # ### ##### ##### # ### ### # ###
#   # #         #   #       #   #         #     # # #   #     #     #   # #   #
# # # # ######### ### ### ####### ####### # # ### ### # ##### ##### ##### ### #
# #   # # # # # # # #   #   #       # #   # #     # # #   #   #   #   # # # # #
# ### ### # # # # # ### # ### # # # # # ### ####### ##### # # # ### # # # # # #
# # #   #     #   # #   #     # # # #   #   #     #         #     # #   # #   #
# # ##### ### # ### # ######### # # ### ##### ### ############### # ##### ### #
# #     # # #   #         #     # #   # # #   # # #   #   # # # #     #   #   #
# ##### # # ##### ### ########### ##### # ### # # # ### # # # # # # ##### ### #
# #     #         #   #   #           # # #   #     #   #       # #     #     #
### # ### # # ####### # ### ### ### # # # # ### # # ########### # ### ### ### #
# # #     # #   #     #     # #   # # #   #   # # #     #         #     # # # #
# ######### ### ### ####### # ####### # # # # ### ##### ######### ##### # # # #
#   # #     # # # # #         #       # #   # # # #   #           #         # #
### # # # ### ### ### # ####### ### ##### ### # ##### ### ##### # ##### # ### #
# # #   #       # #   #     #   #   #   #   # #     #     #   # # #     #   # #
# # # # ##### ### # # # ### # ### # # ### # # # ### # # ##### # ### # # # # # #
# #   #   # #     # # # #   # #   #   #   # # #   #   # #   #     # # # # # # #
# ####### # ##### ### ##### # ############### # # ##### ### ####### ##### ### #
#       # #         #     # #   #       #     # #     #   #         #     # # #
### ##### ############### # ### ##### # ### ####### # ####### # ### # ### # # #
#   #             #   #   #   #     # #   # # # #   # #       # #   #   #   # #
# ### # ##### ### # ### ### # ##### ##### # # # # ### ##### ### # # ####### # #
# # # #     #   #   # # # # # #   #   #     #   # #     #   # # # # #       # #
# # ####### ####### # # # ### # ### ######### ### ##### # # # # ##### ### ### #
#         #     #   #   #   # #   #   #   #         #   # # #   #   # #   #   #
# ####### ##### # ##### # ####### ### # # ##### # ### ####### ### # ### ### ###
#     #         # #   # #       #     # #   #   #   #   #   #   # # #   # #   #
####### ### ####### # ######### ########### # ##### ####### ### ### # # # #####
#       #           #                     #       #     #         #   #       #
###############################################################################
