###############################################################################
#     #   #     #       #   # # # #           #   #       #             #   # #
### ### # ### # ####### # # # # # ### ### # # # ####### ### # ### ####### # # #
#       #     #         # #   #     # #   # #   # # #   #   # # # #       # # #
# ##### ################# ##### ##### ##### ##### # # ####### # ### ####### # #
#     # #           #   #     #   #   # #       #   #   # #   #     #   #     #
##### # # ##### ### ### ##### ### # # # # ####### # # ### ### ######### # #####
#     #   #   #   #   #     # #   # # # # #     # # # #         # #     #     #
# ######### # ### ####### ### # # ### # # ##### # # # ### ### ### # ##### #####
# #   # #   # #   #     #   #   # #   #       # # #   #   # #   #   #       # #
# # # # ### # # # ##### ### ##### # ##### ##### # # # ##### ### # # # ### # # #
# # # #     # # #     # # # #   # #   # #       # # # #   #       #   #   #   #
# # # ##### ### # # # # # # # # # ##### # ####### ####### ### #################
# # # # # #     # # # # # #   # #   # #     # #   # #   #       #             #
# # # # # # ##### # ### # ##### ### # ##### # # ### ### ####### # ######### ###
# # # #       # # #       #   #   # #       #           #         #     # #   #
# # # # ####### ####### ### ### ### ##### ### ######### # ######### ### # ### #
# # # #         #     #     #   #   #     # #   #     #     #     # # # #     #
# ### ### ######### ### # ##### # ####### # ### ##### # ##### ### # # ##### ###
#     # # #     #       # #   #         # #   #   # # # #   # #       #   # # #
##### # # # ### # ####### # ####### # ### ### ##### # # ### # ######### # # # #
#   #   # #   # # #     # #   # #   #           # #     # # # # #       # #   #
# ####### # # # # # ##### # ### # ############# # ### ### # # # # ########### #
#         # # #     #             #         #     # # #           #   #   #   #
### # ####### ####### ##################### # ##### # # # ####### # ### ### ###
#   # # #     # #   # # #       #     #   #   #   # #   #   #   # #     #     #
# ##### # ##### # # # # # ### # # ### # # # # # # # ####### # # ### ###########
# # #   #     #   #     #   # # # # # # # # # # # #       #   #     # # # #   #
# # # # # # ### ############# ### # # ### ### ### # # ####### # ##### # # # ###
# #   # # #   # #   #   #     #   # # #   # #   # # #   # #   #     #   # # # #
# ##### ### ####### ### # ### # # # # # ### ### # ##### # # ####### ### # # # #
# #   #     #     #   # # # #   #   #           #         #   #     #         #
# ### ########### # # # ### ####### ### ####### ### ### ### # ### ### # # # # #
#   #     #       # # # #   #         # #   #       # #     # # #     # # # # #
### # ####### ### # ### # ####### ##### # # # # # ### # ### # # ####### ##### #
#     #     #   #   # # # # #     # #   # #   # # #     #   #     # #   #   # #
# ######### ### # # # # # # # ##### # ### # ####### ### ### # # # # ### # # # #
#         #     # #           #       #   # #       #     # # # #     # # #   #
###############################################################################
