###############################################################################
#     # # #           #       #     #   #       #       #     # #             #
# # # # # # ######### ### ### # ### ### # ##### # ##### ### ### # ########### #
# # #   # # #       #     # #     #   # #     #   #     #       #   #     #   #
# # ### # # ##### ####### # ######### # ##### # ### ##### ### # # # # ####### #
# # #     #     #     #   # #         # #   # # #   # #   # # # # #   #     # #
# # ### # # # ### # ### ### # ####### # # # # # ### # # ### ### # ##### ### ###
# # #   #   #   # #         #   #         # # #   #   # # #     # #   # #   # #
# ### ### ##### # ### # ####### # ####### # ##### ####### # ### # # # # # ### #
# #   #   #   # # # # #     # # #   #     #     #   #     # #   #   #   #     #
# # ### ### # # # # ### ### # # ##### ######### ### ##### # ### # ########### #
# # #   #   #   # #   # #   #       #   #   # #     # # #     # #       #   # #
### # ### # ##### # ##### ######### ####### # ##### # # ##### ### ##### ### # #
#   # # # # #   # # #   # #         #     # # #     # # #   # # #     # #     #
# ##### ### # # # # # # # # # ####### # ### # # # # # # # ### # ### # # ##### #
# # #   #     # #   # #   # #     #   # #       # # #           # # # # # #   #
### ### # ##### ################# ##### # ##### ######### # # # # ### ### #####
#         #   # #   #             #     # #     #   #   # # # #     #   #     #
# ### ##### # ### ### ##### # ##### ### ### ### # ### ### ############# ##### #
# # # #     #   # #     #   # #   # # # # # #         # #         #       #   #
# # # # ####### # ########### ### # # # # ####### ##### ### ##### # # ### # ###
# # # # #     #   #   #   #   #     # #   # #         #   #   # # # # #       #
### ### # # ### # # # ### ########### ### # ######### # # # ### # # ###########
#       # # #   #   # #   #     #                       #       #   # #     # #
# ####### # # # ##### # ##### ########### ### ### ### # # # ### ##### ##### # #
#   #     #   #   #     #   #     # #     #   #     # # # #   # # #         # #
################# # ####### ##### # ######### # # ##### # ### ### # # ####### #
#   #       # #   #       # #   #   #         # # #   # #   # #     #         #
# ### ##### # # ######### # ### # ############# ### # # # ####### ####### #####
#     #   # #   #   # #   #   #         #       #   #   #     #   #     #     #
# ##### ### ##### # # # ### ### ####### ##### ### ### ### ### # ### # # #######
#   #         #   #   #   #       #   #         #   #   #   # #     # #   #   #
### ######### # ##### ### # ######### ########### ##### ### ### ##### ##### # #
# #   #     # # #   #   # # #   #   # #           #     # #       #       # # #
# ### # ### # # ### ##### # # # # ### # ### # ########### ### # ### ### ##### #
# #   #   #   #     #   # #   # # #     # # #   #     #     # #   #   #       #
# # ##### ######### # # # ### # # ##### # ### # # ### # # # # ### ### ####### #
#       #             #       #   #         # #     # # # #   #     #   #     #
###############################################################################
