###############################################################################
#     # #         # #   #             # #       # #     #   #       #         #
##### # # ####### # # # ##### ####### # ### ### # ### ### ### # ############# #
#   #     #     #     #   # # # #   # #   # # # #   #   #     #   # # #     # #
# # ##### ### # ####### # # ### # ### ### # # # # # ### ######### # # # ### # #
# # #   #   # #   #   # #       # #       # #     # #     # # #   # # #   # # #
### ### ### ### ### # # ####### # ##### # ##### ### # ##### # # # # # # # # # #
# #           #   # # # #       # #     #   # #   # # #         # #     # # # #
# ### ##### # # # ### # # # # # # # ##### ### # ### # # # ######### ##### ### #
#   # # #   # # #   #   # # # #     #     #     # #   # #   #     # #   #     #
### ### ### # ### ##### ##### ############# ##### # ### # ####### # # # ##### #
#       #   # #   #     #             #     #     #     # #     # # # #     # #
# ### ##### # # # ####### ##### # ### # ##### # ### ### ### ### # # ##### #####
# #         #   #   #     #     #   #   #     # #     # # # #   #       #     #
# ############# ##### ####### # ######### # # # ##### ### # # # # ##### ### # #
#       #       #     #   #   # #   #   # # # #   #   # #   # # # #     #   # #
##### ##### # ### ### ### # ### ### # # ### ### # # ### # ##### # ### ####### #
#     #     # # #   # #   # #     #   #   # #   #   #     #       #     #     #
# ##### ##### # ### ##### # # ##### # ### # ####### ######### ####### ### #####
#     # #   # #   # #   # # #   # # # # #   #       #   #       #   # #   #   #
### ### # ### # # # # ### # ### # # ### ########### ### ####### ### ##### ### #
#   #   #   # # # #   #   # #   #     #           #       #   #   #     #   # #
# # # ##### ### ####### ### ####### # # ######### # # ##### ##### ##### # # # #
# # #         #             # # #   # #     #       # # #     #   #       #   #
# ##### ##### ##### ##### ### # # # # ##### ##### ### # ### ### ### ### ##### #
# #   #   # # # #   #   #   # # # # #   #   #     # #     # #     # #       # #
### ####### # # # # ### ### # # ### # # # ######### ##### # ##### # # ##### ###
#         #   # # #     #   # # #   # # # #   #   # # #       # #   #   #     #
# ##### # ### # # ### ### ### # ########### ##### # # # ##### # # ##### ### ###
# #   # #   #   # #   #   # # #   #       # #     # #   # #           #   #   #
### # # ### # ### # ####### # # ######### # ##### # ##### ##### # #############
#   #   #   # # # #   # #   #     #     #   #       #   #       # #         # #
# # ##### ##### ####### # ### # ### ### # ### ### ##### ####### ### ####### # #
# #     #       #   #   #     # #   # # #   # # #         #         # #     # #
####### ########### ### # ####### ### # ### ### ######### ### # ##### ### ### #
#     # #                 #       #   #   # #   #   #         #     # # #   # #
# ##### # # ############# ### ### ### # # # # # # # # ############# # # ### # #
#         #   #                 # #     #     #   #               #       #   #
###############################################################################
