###############################################################################
# #   #   #     # # #   # #   #           #                           #       #
# # # ### ### # # # ### # # ### # ##### # # # ######### # ### # ############# #
#   #       # # # #   # # #   # #   # # #   #         # #   # # # #       #   #
# ######### ### # ### # # # # # ### # ############# # # ### ##### # ####### ###
# #       #     #       # # #     # #     # #   # # # # # #             # #   #
# ### ### ### ### ##### # # ##### ### # # # # ### ### ### # ############# # ###
#   #   #     #     # # # # # #     # # # # # #       #   #       #   #   #   #
### # ####### ####### # # # # ##### # # ### # ####### # # ### ##### # # ##### #
# # #   #     #   #   #         #     #   #         # # #   #       #   #     #
# ### ##### # ### # # ##### ####### ### # ### ### # ### # ########### ### #####
#   # # #   #       #         #   # # # # #   #   #   # #       #     #   #   #
# # # # ############### # ### ### # # ### ##### ##### # ##### ### ### # ### # #
# # #   #         # #   # #     # # #               #       #   #   #     # # #
### ##### # ##### # ### # # # ### # # ##### ##### ######### ##### ######### # #
#   #     # #           # # #   #   #   # #     #     # #   # #     #     # # #
# ########### ### ### ##### # ######### # ### # ### # # ##### # ####### # ### #
#               # # # #     #       #   #     # #   #     #   #         # #   #
########### ### ### ### ### ########### # ####### ### ##### # # ### ##### # ###
#       #   # #   # #   #         #     #       # #   #     # # #   #   # #   #
####### # # # ### # ### ### ##### # # ####### ### # # # ####### ####### # ### #
#       # # #   # #     # #   #   # #     #   #   # #     # #         # # #   #
# ### # # # ### # # ### # ##### ### # # ####### # ### ### # ####### # # # # ###
# #   #   #   #   # #   #       # # # # # #     # #   #   # # #     # # #   # #
# # # ### ### ### # ##### # ##### # # # # # # ##### ### ### # ####### # ### # #
# # # # #   # #   # # #   #   #   # # # # # #     #   #     #       # #     # #
####### ##### ### ### # # # ### ##### ### ##### ##### # ##### # ### # ####### #
#       #     #   # #   # #       #   #     #   #     #   #   #   #           #
# ##### ### # # ### ##### ##### ### ### ### # ########### # ### ############# #
# #   #   # # # #         # #   # #       # #     #   #   # #       #   #     #
##### # ### # ### # # ##### # # # ####### # ##### # # # ### # ######### # #####
#     #   # # #   # # #   #   #       #   #   #     # # # # #   #       # #   #
# ##### ### # # ##### ### ### ### # ##### ### ####### # # # ##### ### ### # # #
# #         # #   #   #       #   # #   #   # #     # # #     #   # # #   # # #
# ######### ### # ######### ####### # ##### # # ####### ######### # # # ##### #
#   #   #     # # #       # #     #       # #   #     #   #   # # # # # #     #
# # # # ##### ### # ### # # # # # ####### ##### # ### ### # # # # # # ##### # #
# #   #         # #   # #     # #   #       #       #   #   #     #         # #
###############################################################################
