###############################################################################
# #   #             #             #   #   #   #     #   #     #     #   # #   #
# ### # ### ######### ### ### # # # # ### ### ### ##### # ####### ### # # ### #
# # #     #       #   #   #   # # # #                         # #     # #   # #
# # ##### ####### # ### # ##### # ####### # ### ##### ####### # ### ### ### # #
# #   #   #         # # # #     #   #     #   #   #   # #   # #     #   # #   #
# # # ##### ######### # ### ####### # ### ####### ### # # ### ##### # # # ### #
#   #       #     #     #   #     #   #     #     #   #         #   # #     # #
########### ### # # # # # ##### # # ####### ####### ##### # # # ### ##### ### #
#   #           # # # # # #     #   #   #   #       #   # # # #   #   #   # # #
### # ######### ####### # # ####### ### # # # ### ### ### # ### ##### ##### # #
#     #     #   #       # #   #     #     # # #   #   #   # #         # #   # #
# ##### ######### ### ### ### # ############### ### # # ########### ### # ### #
# #     #           # #   #   # #   # #         #   #   #         #       #   #
# ### ### ################# ### ### # ### ####### ##### ### ##### ##### ##### #
#   #     #           #   # # # # # #       # # # #   #   # #         #   #   #
### ### ### ### ##### # # # # # # # ### ### # # # # ### # # ### ##### # ### ###
# #   #   #   #     #   #   # #   #     #   # # # #   # # # #   # #     #     #
# ### # ##################### ### # ######### # ### # ##### ##### ### # # ### #
#   # # #     #         #     #   # #       #   #   #     #   # #     #     # #
### # # # ### ##### # ##### ### ### ### ### ### ### # # ##### # # # ### #######
#     # #   #   #   #     #     #     #   #   #     # #     #   # # # # #   # #
# ####### # ############# # ### ######### ### ####### ##### ######### # # ### #
#   # #   #         #     #   # #       #   #   #     # #   #       #   # #   #
### # ####### ### ##### # ####### ##### ### # ### ##### # ####### ### # # ### #
#   #       # #   #     #   # #       #     #   #   #   # #     #     # # # # #
# ### ### # # # ### # # ### # ####### ### # # # ### ### # ##### ### ### # # # #
# # # #   #   #     # # #   # #     # #   # # #   #   #   #       #   #       #
### # # # ##### ##### # ### # ### # ### # # # ### ####### ### ### # ##### # ###
# #   # # #   # #     #   #   # # #     # # # #         #     #     #     #   #
# # ### # # ##### ##### ####### ##### ### # ######### ####### ####### # # ### #
#   #   # # #       # # #   # #         # # #   #             # #     # #   # #
# ####### # # ####### # # # # ### ### # # ### # ########### ### # # # # # ### #
#   #       # #       #   # #     #   # #   # #     #     # #     # # # # #   #
############# # ### ### # ### ##### # # # ######### # ### # ##### # # ### # ###
# #     #   # # #     # #   # # #   # # # #         #   # #     # # # #   #   #
# # # ### # # ####### ##### ### ### # ######### ####### # ### # ### # ####### #
#   #     #         #               #         #         #     #   # #   #     #
###############################################################################
