###############################################################################
#       #       #       # #   #   # #   #       # #       # #   #       #     #
# ### ### ####### ##### # # ##### # ### ### ### # # ### # # # # # ##### # ### #
# # #     #     # #       #     # #   #     #   # # #   #     # #     #     # #
# # # # ### ### # ########### ### ### ##### ##### ### ######### ####### ##### #
# # # #     #   #   #       # # #   #   #             #       #     #     #   #
# # ##### ### ##### # ##### # # # ##### ##### ####### # ############# ### #####
# # #   # #   #     # #       #       #     #     #       #   # #     #   #   #
### # ### # ##### # ### ##### ##### ##### ##### ##### ### ### # # ########### #
#     #   #     # # #   #           #       #   #   #   # #   #     #         #
# ############# ### # ### ####### ### ##### ### # # ####### # ##### # #########
# #   # #     # #   # # #   # # #   # #   #       # #   #   # #   # # #       #
# ### # # # ### # ##### ##### # # ####### ######### # # # ### ### # # # #######
#       # # #               # # #   #     # #   #   # #   # #     # # #   # # #
# # ##### # ############# ### # ### # ### # ### # ### ##### ##### # # ### # # #
# # # #   # #     #   #       #       # # # #   # #     #     # # # #   #     #
# # # # ### # ### # ######### ##### # # ### # ### # ### ##### # ### ### # #####
# # # # #   #   #         #     #   # #     #     #   #   #   #           #   #
# # # # # # ### ######### ### # ### ##### ### ####### # ### ### ##### ##### ###
# #   # # # # #   # # # #   # #   #   #   #   # # #   #           # #     # # #
### ##### ### ##### # # # # # # ##### ### # ### # ### ########### # # ### # # #
#   #   # # # #     # #   # # #       #   #     #   # #     #   # #   # #   # #
# ##### # # # ##### # ### ######### ##### # ### ### # # # ### # # # ### # ### #
#   #   #   #   #       # #   #     # #     #   #       #     # # #     #     #
### # # # # # ######### # # ### ##### # ####### # # ######### # ####### # ### #
# #   #   # #   #     #   # #         #       #   #     #   # # #       #   # #
# ####### # # # ##### ### # # ########### ########### ### ####### # ##### ### #
#       # #   # #         #       # # # # #     #   # # # #     # # # #   #   #
### ##### ### ##### ### ##### ### # # # # ##### # # # # # # ##### ### # ### ###
#     #   # #   #     # #     # # # # # #     #   # #   #     #   #   # #   # #
### # ### # ### ### ### ### ### # # # # ##### ### ####### ####### # # ### # # #
# # # # # # # #     #   #   # #       #     # #             #     # #     #   #
# ### # # # # ####### # ##### # ##### ### # # ####### ##### # ######### ##### #
# #   #   # #     #   #   #       #   # # #     #       #   #     #   #   #   #
# # ####### ### # # ##### ######### ### ##### ### # ### ######### # # # ### # #
# # #           # # #       #       #   # #   #   #   #       #   # # #   # # #
# # # # ####### # ####### # ### # ##### # # ### ########### # ####### ####### #
#     # #       #         #     #                         # #             #   #
###############################################################################
