###############################################################################
#   #   #     #   #             #   #     #     #     #   #           #       #
### # # # # ### # ##### ########### ### # ##### # ### # # # # # ##### ####### #
#   # #   #     #         #       #   # # # #   # #   # #   # #     #         #
# ### ### ############### ####### ### ### # # ##### ### ######### # ###########
#   #   # # #       #   #   #     #       #   #   #   # #         # #   #     #
### # ### # # # ####### # # ### ######### # ### # # # # # ######### # # # # # #
#   # #   # # #       # # #   #       #   #     # # # # # # # # # #   # # # # #
# ### # ### ######### # ### ### ### ### ##### ### ### # ### # # # # ##### # # #
#     #   #     #   #       #   #   #     # # #       #     #   # #       # # #
### ##### ##### # ####### # # ##### # ##### ##### # # # ##### ### ########### #
#   #           # #     # #   #   #         #     # # # #       #         #   #
# ### ########### ##### # ### # # ####### # ####### ### # # ####### ##### #####
# # #         #   #       #   # # #   #   # #   #   # # # #     #     # #     #
### # ######### # # ############# # # # ### # # # ### # ### ##### ### # ### ###
#   #   #   #   #   # #           # #     #   # #         #   # #   # #       #
### ### ### ####### # # ####### ########### # ##### # ####### # ### ####### ###
#   #   #   #   #   #   #     # #       #   # #   # # # # #   # #   #   #   # #
# # # ### ##### # ####### # # # ##### ### # # ### # ### # ### # # ### ####### #
# # # # #           #     # # #     # #   # #     #   #     #   # #         # #
# # ### ####### ### ####### # ##### # ### ####### # ### ### # ### # ####### # #
# #   #         # # # # #   # #     #     #   #     #     #   #   # #   #   # #
# ########### ### # # # ##### # # ########### ### # # # ####### ### ### # ### #
#     #     #   #     #     #   #   #         # # #   # #             #       #
### # ### ##### ######### # # ##### # # ### ### # # # # # ##### ##### #########
# # # # # #     #         # # #   # # # #         # # #   # # # # # # #       #
# ### # # ### ### ######### ### ### ##### ####### # ### ### # ### # # # ### # #
#   #   #     # #   # #   #   #   #     #   #     #   #     # # # # # # #   # #
### ### ####### ### # # # # ##### ##### ######### # # # ##### # # # # # # # # #
#   # #   #     #   #   # # #   # # #             # # #       #     # # # # # #
# ### ### # ##### ### ### # # # # # ########### # # # # # ### # ####### # # # #
#   #   #         #     # # # #         #     # # # # # # # # # #       # # # #
# # # # ########### ##### # # ######### # ### ##### ### ### # # # ### ### # ###
# # # #   #       # #     #     #         #   #     #   # # #       #   # # # #
# # # ### ##### ### # ######### # ### ### ### ######### # # # ######### # ### #
# # #   # #   #   # #   #     # # #   #   # #   #   # # # #     #   #   #     #
# # ### # # # ### ##### # ### ####### ### # ### # # # ### # ##### ##### #######
# #     #   #               #           #   #     #             #             #
###############################################################################
