###############################################################################
# #         #         # #               #       #   #   #     #   # #         #
# # # ##### # # ##### # ##### # # ######### ### # ##### # ### ### # ### ### ###
#   # #     # # # #           # #     #   # #     # #   # #     # #   #   #   #
# ### ####### ### # ############### # # ### # ##### # ### # ##### ### ####### #
#   #   #       #   #     #   #   # #     # #   #         #       #         # #
# ##### # ##### ##### ##### # ### # ##### # ##### ### ######### ### # # ### # #
# #   # #     #     # # #   #   #   #   #         # # # #     #     # #   # # #
##### # ##### ##### # # # ##### ####### # ######### # # # # # ####### ####### #
#     # #     # #   #         #   #   #   #     #   # # # # #     # #     #   #
# ### # ##### # # ######### # ### # # # ### ### # ### # # ####### # ### ### ###
#   # #       # # #       # # # #   # #     #   #     # # # #         # #   # #
### ### ####### ####### ### ### ##### ################# # # ##### ### # # ### #
# # #   # #       #     #       # # # #                     #   #   # # #   # #
# # # ### ### ### ### # ### ##### # # ##### # # ### ######### # ####### ### # #
#     #   # # # # # # #   #         #       # # #     #       #   #   #       #
### ##### # ### # # ### ### # ################### ### # ####### # # ######### #
#   #         #       #     #   #       #   #   #   #   #   #   # # #     # # #
# ### ####### ### ####### ####### ### # # ### # ##### ### # # ### # ##### # # #
# #   #     #   # # # #   # #       # #       #     # #   # #   #   #   #     #
# ######### # ### # # # # # ####### ############# # # # ### ### ### ### #######
#   #       #   # #   # #     #       #       # # # #   # #   # #         #   #
### ### # ### ### # ### ####### # ####### ##### # ####### ### ### # ######### #
# # #   #   #   #     #         #     #   #     # #     #     #   #     #     #
# # # ##### ### # ####### ####### ### # ### ##### # ##### ### ######### # ### #
#   # # #             #   # #       #         #   #     # #       #     # #   #
### # # ##### ####### ### # ### ######### ### # # ### # # # ### # ### ### #####
#   #   #     #           #   #   # #   # #   # #   # #   #   # #   # #       #
# ################# ### ### ####### # ### # ####### ##### ### # ########### ###
#     # #         #   #       #   # #     #     #       # #   #             # #
### # # ##### ### ### ##### ### ### ####### # # ### ### ############### ##### #
#   #   #     # #     # #                 # # #   # # #             #         #
# # ### # # ### # ### # ### # ### ########### # ##### ####### ##### # ### # ###
# # # #   # # # # #       # #   #     #     # #       #   #   #     # # # #   #
# ### # ##### # # ### ### ######### ##### ### ### ##### ##### # ####### ### # #
# #   # #   # # # #   # #       #     #   # #   #     #     # #       # # # # #
### # # ### # # ### ### # ### ##### ### ### ######### ##### ##### ##### # # ###
#   #     #         #       #     #           #             #           #     #
###############################################################################
