###############################################################################
# #     # #     #       #     #   #     # #       # # #   # #     #           #
# # ### # # # ### ### # # # ### ##### ### ### ##### # # # # # ### # ### #######
#   #   # # #   #   # # # #     # #     # #       # #   # # #   #   #   #     #
##### ### ##### ### # # ##### ### ##### # ####### # # ##### # ### ### ### #####
#     #       # #   # #   #   # #       #     #   #           #     #     #   #
# # ### ####### ### # # # ### # ####### ### ##### # # ### ### # ### # ##### # #
# # #     # #   #   # # # # #             # #   # # #   #   # #   # #       # #
# # # ##### # ### ####### # ### ######### # # ### # ######### ########### # ###
# # #         # # #     #         #       # #           #     #     #     #   #
# ##### ### # # ### ### # # # # ### ####### ### ### ##### # # # ### # ### ### #
#     # #   #         # # # # # #       #   #     #   #   # # # #   #   # #   #
### ### # ### ##### ##### ### # ##### ### # ### # # ####### # # ####### ### ###
#   #   #   # # # #   #   #   #   #       #   # # #     #   #     # #   #     #
# ### # ### # # # ### # ### ######### # ##### ##### # ### ### # ### # ####### #
#     # #   # #     #   #   # #       # #       #   #   # #   #     #     #   #
##### ### ### # # ##### # ### # ####### ####### # # # ####### ### ####### #####
#   #   # #   # # #     # # #     #     # # #     # # #   #     #     #       #
# ##### # # ### ### ####### ######### ### # # ##### ### ##### ### # # # ##### #
# #     # # #   # # #       #     #   # # #   #       # # #   #   # # # #     #
# # ### # # # ### # # ####### # # ##### # ### ### ### # # ### ### # ##### ### #
#   #   # #   #     #   #     # #   #     #     # #         # #   # # #   # # #
# ########### ######### # # ### # # ##### ### # # # ##### ##### ##### # # # # #
#       #     #     # # # #   # # #     #     # # # #     #   #   #   # # #   #
####### # ##### ### # # # # ### ##### # ### ####### # # ### ######### ### #####
# #     #   #   #     #   # #   #     #     #   # # # #             #   #   # #
# ### ########### ######### # ######### # ### # # # # # ##### ### ### ##### # #
#   #     #           # #   # #   # #   #     # #   # #     # #   #   #       #
# # ##### # ####### # # # ### ### # # # ### ######### # ### # # ### ### #######
# #       #   # #   # #   # # #       # #       #     #   # # #       #   #   #
# ##### # ##### # # # ##### ########### ####### # # ### # ### # # # # ### ### #
#     # # #       # #     #   # # #       # #   # #   # # #   # # # #   #     #
##### ### # ### ####### # ### # # # ####### # ##### # # # ##### # ### ####### #
# #   #   #   #   #     #       # #   # #   # #   # # # #   #   #   #       # #
# # ### ####### ### # # ####### # ### # # # # ### # ### ############# # ### ###
# # # #     #   #   # # # #       #       # # # #   # #           #   # # #   #
# ### # ### # ### ### ### # ######### ####### # # ### ####### ##### ### # ### #
#       #   # #     #   #                 #   #             #     #   # #     #
###############################################################################
