###############################################################################
# #   #         #     #     #     #         # #   #       #         # #   # # #
# # # ### ##### # ##### ##### ##### ##### # # ### ##### # ### ### ### # ### # #
#   # #     # # # #     #       #   #     #     # #     #   #   #     #     # #
# # # ### ### ### # # ### ##### # ### ######### # # ##### ####### ### # # ### #
# # #   # #     # # #       #   #   # #               # # #   # #   # # #   # #
# # ### # # ##### # # ####### ######### # ##### ##### # # ### # ### ### ##### #
# #   #         # # # # #   #       #   #   #     # # #       #     #   #     #
# # # ### # ##### # # # ### ####### # ### ### ##### ### ### ##### ### ####### #
# # # #   #         # #       #   # # # # #   #     # # #   #   # # #       # #
# ### ### ### ####### ####### # # ### # # # # # # ### # # # # # # # ### ### # #
# #   # #   #     #     #       #   #   # # # # #   #   # #   #   #   # # # # #
# ### # # ############### # ##### # ### # ##### ##### ### ####### ### # # # # #
#   #   # #     # #   #   # #   # # #   #       #     #   #     # #     #   # #
### # # # # ### # # # # ### # ##### # # ############### ### ##### # ##### ### #
#   # # #     #     # # #     #     # #               # #   #   #   #         #
# ##### ##### # ####### ############# # # ##### ######### # # # ### ###########
#     #     # #     #                 # #     # #   #     #   # # #       #   #
##### # # # ######### ############# # # ####### # # # # ##### # # ### # ### ###
#     # # #     #     #     #       # #   #   # # #   #   # # # #     # #     #
### # # # # ##### ### # ### # ### ### ### ### # # # ##### # ### ### ##### ### #
#   # # # #   # # #     #   #   #   #   #   #     # # #   #       # #   # #   #
### ##### # # # ### # ##### ### ### ### ### ##### # # ### # # ### ### # ### # #
# # #     # #       #     #   #   #   #   # #     # #     # # # #   # #   # # #
# # ### ### ####### ####### # # ##### ### ### # ### ####### ### ### # ##### # #
# # #     #     # # #   #   # #     #   #   # # #       #   #   # #   # #   # #
# # ####### # # # # # # # # # ##### ### ####### ######### ### ### # ### # #####
# # #       # #   # # # # # #   # #   #       #     #         #     #   #     #
# ######### ### ### # # # # ### # ### # ##### ####### ######### ##### # # ### #
#     #     # # # # # # # #   #   #   #   #     #       # # # #       # # #   #
# ### # # ### ### ##### # ### ### # ########### ####### # # # ### # ### ### # #
#   # # #               #   #   # #         #   #   #     # #     # # #   # # #
### # # # ######### ####### # # ########### # ### # ##### # ##### ### ### # ###
#   # # # # #       #       # # #       # # # #   # #   #   #         # # #   #
# # ### ### # ### ### ### ##### # # ### # # # # ### # # ### ########### # ### #
# #     #   # # # #     # #     # #   #   # # #   # # #   # #         # #     #
# ####### # # # # ### ### # ##### ######### # ### # # ##### ##### ### # ##### #
#         # #   #   #   # #       #         #     #   #           #     #     #
###############################################################################
