###############################################################################
# #   #   #     # #           # #     #           #               #   # #     #
# ### # # # ### # ######### ### # ##### ##### # ### # ##### ### ### ### # ### #
#   # # #   #   #   #       #   #     #   # # #   # #   # #   # #   #   # #   #
# # # # ##### # ### ##### ### ### ######### # ### # ### # ####### ### ### # ###
# #   #     # # # #       #             #     #   #   #     # #   #   #   # # #
##### # ### ### # ####### # # ### ############# # ### # ### # # ### ### ### # #
#     # # # #   #   #   #   # # #       #       # #   #   #   # #       #     #
# ##### # ### # ### # ### ### # ####### # ##### ### # ######### # ########### #
# #     # #   #   # #   # #       #   # #     #   # # #   #     # # #     #   #
# ####### # # ### # # ##### ####### # ####### ##### # # ### ##### # ##### #####
#     #     # # # #     #   #   #   #   #   #       # # # #       #   #     # #
# ### # ##### # ####### # # # # # ##### # ### ######### # # ### # ### # # ### #
# # #   #   #   #         #   # #     #   #       #       #   # # #     #   # #
# # ##### # # # ### ### # # # ####### ### # ##### # ########### # ### ##### # #
#     # # # # #     # # # # #     # #   # # #     #             #     #   #   #
### ### ### ####### # # ### # ##### ### # # # ######### ##### # ######### ### #
#   #     #         # # # # #           #   #       #   #   # # #   #   #   # #
# ####### ####### # # ### # # ##################### # ### ### # # # # # # # # #
# #   #         # #     # # #     #   #     #     #   #     # #   # # # # #   #
# # # # # ### # # ### ### ### ##### # # ### # ##### ### ### ##### # # # # ### #
# # #   # #   #   # #   #   # #     #   #     #   #     # #     # # # # # #   #
### ##### # # ##### # ##### # ### ####### ##### ######### ##### ####### # # ###
#     #   # # #     #       #   #   # #       #   #     #     #   #     # #   #
# ##### # ######### # ### ##### ### # ####### ### # ### ### ##### # ### ##### #
#   #   # #     #       # #   #   #     # #   #   # # #         #   #     #   #
####### ##### ### # ### # ### ##### ### # # ### # # # ######### ##### ##### ###
#       #         #   # # #     #   #   # # #   # #     #     #     #     #   #
##### ##### ######### ##### ######### ### # # ######### # ####### ### ####### #
# #   #   # #   #     #       #     #   #   #                   # # #   # # # #
# # # ### ##### # ##### ##### # ####### ### ####### ##### ######### ### # # # #
#   #   # # #             #       # #   #       #   #     #       # #   # # # #
# # ##### # # ### # ####### # ##### # ### # ### # ### # ### ####### # ### # # #
# # #   #     #   #       # #   #   #   # #   #   #   #     #       #   # # # #
# ### # ####### # ##### # ##### # # ### ##### ##### ######### ########### # # #
#   # # #   #   #     # # #     # #     #   #     #   #           #       # # #
### ### # # ####### ##### ### ### ####### # ##### ### ### ##### ### ####### # #
#     #   #         #       #             #     #   #         #             # #
###############################################################################
