###############################################################################
# #     #   #   #         #   #                 #     #           #       #   #
# # # # ### # ### ##### ### # # ### ##### ######### # ######### ### ### ### # #
# # # #   # # #   # #   #   # #   # #   #         # #     #   # #   #   #   # #
# ### # ### # ##### # ####### ### ### # ### ########### # # ### # ### ### ### #
#   # #       # #     # #   #   # #   #   #         # # #     # # # #     #   #
# # # ####### # # ##### ### # ### # ######### ### ### # ### ### # # ####### ###
# # # # # #           #   # #       # #   # #   # #     #   #           #   # #
# # # # # ##### ##### ### # ##### # # # ### ### # ### ### ### ########### ### #
# # # # # #     #   # #   # # #   #       # # # #   # #   #     #         # # #
# ### # # ####### ### ### # # # # ##### ### # # ### ### ######### ######### # #
#     #             # #   # #   #   # #     # # # # #           #   #   #   # #
####### ##### # ##### ### # # ##### # # ### # # # ### ######### # # # # # ### #
#         #   #   #     #       #   # # # #   #       #     #   # # # # #     #
# ####### ####### # ### # # ######### ### ######### ##### ### ##### # ##### ###
# #   #   #   # #   #     # #         #   #     #   #   # #     #     #     # #
# ### ##### # # ####### # ### ######### ##### ##### # ### ####### ### # ### # #
#   #       # #         #     #         #   #   # #     #       # # #   # # # #
# ### ##### ####### # ### # ### ######### # # ### ########### # ### ##### # # #
#   # #   #         #   # #     #         #     # #   #     # #     #   #     #
### # # ######### ##### # ### ### ##### # # ### # ### # ### # # ##### ### # # #
# # #       # #     #   #   # #       # # # # #   #   #   #   #       #   # # #
# # # ### ### # ### ### # ### ### # # # # # # # ### ##### ############# # #####
#   #   # #     #   # # # # #     # # # # #   # #                   #   #     #
# # ##### ### # # ### ### # # ### ########### ### ################# ##### ### #
# # #     #   # # #   #   #     # #       #     # #   #   #   # #   #   #   # #
# ### ####### ##### ### ### # # ### ### # ####### ### # ### # # ##### # ### # #
#   # #   #   #     #   #   # #     # # #   #       # #     # #     # #     # #
### # # # # # # ### ### # ##### ##### # ### ####### # ##### # ##### ####### ###
#   # # # # # # #       #     # #   # #   #   #   # #   #   # #   # #     #   #
# ### ### # ######### # ##### ##### # ##### # # # # # ### ### # ### ### # # # #
# # #   # # # # #   # #     # # # #   #   # # # #         #   #   #   # # # # #
# # # # # ### # # # ##### ##### # # ### ### # # # ######### ### ### ##### # ###
#   # #   #   # # # #   #           #   #   #   #       #     #   # #     #   #
# ### ##### # # ### # # ##### # ### ### # ######### # # ######### # # ##### ###
# # # #     # #   #   #       #   #   # #   #   #   # # #   #   #         #   #
# # # # ### # # ############# ##### # # ### # # # ### ### # # ####### ### # # #
# #     #   #   #             #     #     #   # #   #     #           #     # #
###############################################################################
