###############################################################################
#   # #       #     #   #         # #   #       #       #   #   #   #   # #   #
# # # # ### ##### # # # # ##### ### ### # ####### # ### # ### # # # # # # # ###
# #   #   #   #   # # #   #     # #   #   #   #   # #   # #   #   #   #   # # #
# ### ### # # # ##### ### ### ### # # ### ### # ##### ### # ####### ##### # # #
#   #   # # #   #       # # #   # # # #     # # #   #     # #           # # # #
# # ##### # ########### ### ##### # ### ##### # # ##### # # ########### ### # #
# # # # # # #   #       # #       #     #       #       # # #   #     #     # #
### # # ### # # # ##### # # ####### ##### ####### ######### # ### ### ####### #
# #   #   #   #   #   # # #       # #       #     #     #   #   # # #     #   #
# ### # ### # ##### ##### ### ### # # ##### ####### ### # ##### ### ##### # # #
#       # # # #   # #   #     # # #   # # #           #   #             #   # #
### # ### # ##### # # ######### # # ### # ### ####### ##### # ##### # # # ### #
# # # # #   #       #   #           #       # #   #         #     # # # # # # #
# # ### # ######### ### ######### ##### # # ### ################### ##### # # #
#       #     #       #           # #   # #     #       #       #       #   # #
# ##### ##### # ##### # ### ####### # ### ### ### # # ######### # ######### # #
# #   #   #       #   # #   #       #   # #       # #   #   #   #         # # #
### # ### ##### ### ### ####### ####### ########### ### # ### # ##### ### ### #
#   #           # # # # #   #       #   #     #   #   #       #   # # #     # #
# ############### # # # ### # ### # # # # ### ### ##### # # # ### # # ##### # #
#   # #   #       #       # # # # # # #   # #   #   # # # # #   #   #   # # # #
### # # # ### ### ####### # # # ### # # ### # # # # # # # # ####### ### # # # #
#     # #     #     #     #       # # # #     #   #   # # #     #   #   #     #
# ##### ### ### # # # # ### # # # ### # # ### # ####### # ### # # ##### ##### #
#     # #     # # #   #     # # # #   # #   # # #       #   # # # #   #   #   #
##### ### # # # ######### ### ### # # # # # # ### ####### ### ### # # ### # ###
#     #   # # # # #       # #   #   # # # # #   #       #   #   #   # # # # # #
####### ### # # # ### # ### # ### ##### ####### ##### ######### ##### # # # # #
#     # # # # # #     #     #   #   #         #   #         # #   #   #   #   #
# # ### # ######### # ####### ######### ########### ##### ### ### ########### #
# #     #         # #       # #   #         #     #   # #   #   # #     #     #
# # ############# # ### # ### ### ########### # # ##### # ### # # # ### # #####
# # #       #   #   #   #   #   #   # #       # #     # #   # # # #   # # #   #
# # # ##### ### ##### ##### ### ### # # ##### # ##### # ### # # ### # # ##### #
# # # #     #     # # #       #   # # #   # # # #   #   #     # #   # #   #   #
# ##### ### # # ### ##### ### # ### # ### # ##### ##### # ##### ##### # ### # #
#     #   #   #             # #                   #     #     #       #     # #
###############################################################################
