###############################################################################
# #   # # #     # #       #   #   #             #   # #         #     #   #   #
# ### # # # # # # ##### # # ##### # ####### ### # ### ### ### ### ### ### # # #
#     #   # # # #       #   #           # # # # # #   # # # #     # # # # # # #
##### # ### ### # ##### # ##### ####### # ### ### # ### # # ##### # # # # # # #
# #     #   #   #     # # # #   #   #   # #       # #         #   #   #     # #
# ##### ##### ##### # # ### # ##### ##### ### ### # ### ##### ##### ##### ### #
# #     #       # # # # #           #   #   #   #     #     # # # # #     # # #
# # ### # # ##### # ### # ########### # ### # ##### # # ##### # # # ### ### # #
#     #   #           #   #   #       #       #   # # #   #   # # # #       # #
# ############# ### # # ### # # ############### # ### # # # ### # # # ####### #
#   # # #   #   # # # #     #         #         #   # # # #   # # # # #       #
### # # ### ### # # ##### ####### ### ### ### ### # # # # ### # # # # # #######
#   # #         # # # # # #     # # #   # #   #   # #   #   # # #     # #     #
##### ##### ### # ### # ### ### # # ### ### ##### ### ##### ### ##### ### ### #
#     #   # #           #   #   #     #         # #       #     #   # #   #   #
### ### ##### # # ### # # ####### ### ######### ### ##### # ##### # # # # ### #
#   # # #     # #   # #     #     # #         #   #   # # #       # #   # #   #
# ### # # ### ##### ### # ### ##### ##### ### ### ##### # ### ##### ### # # ###
# #   #   # # # #     # #   #   #   #   # # #   # #         #   #     # # # # #
# # # ### # # # # ### ##### ### ### # ### # ### # # ##### ##### # # ##### # # #
#   #       # # # # # #   #   # #   #     # #   # # #   #     # # #     # #   #
### ### ####### ### # ### # ##### ##### ### # ### # # ######### # ##### # #####
#   #       #       #     # #   #     #   # # # # # #   #   # # #     # #     #
##### ##### ##### # ##### ### ### ### ##### ### # ##### ### # # ##### ####### #
#         #       #     #         # # #     #   #     #       #   # # #       #
# ####### # ### ######### ##### # # # # ##### ####### ####### ### # # # #######
#   #   # #   # #     #   #   # # #           # #     # #   # #   #   #   #   #
### ### # ### # # ### # ##### ### ######### ### # ##### # # # # # # ####### ###
# #     # #   # # #   # #     #   #       # #   #   #     # #   # # #         #
# ####### ### ### # ### # ### # # # ##### ### # ### # ##### ####### ##### ### #
#     # #   #   # # # #     # # #   #   #     # # #   # # # #     # #   #   # #
# ##### # # ### # # # ### # # ### ### ### ### ### ### # # # # ### # # # ##### #
#   #     #   #   #   #   # #   #   # #     #   # #   # #   #   #   # # #   # #
# # # ##### ### # ### ####### # ### # # ##### # # # ### ### ### # ### # # # # #
# #   # # #   # #   # #     # # #   # #   # # # #   # # # #   # #   # # # #   #
# ### # # # # ##### # ### # ### ##### # ### # ####### # # # ######### # # ### #
#   #     # #   #   #     # #       #   #               #             #   #   #
###############################################################################
