###############################################################################
#   #     #       #     #       #     #     #         # # #     #       #   # #
# ### # ### ##### # ### # ### # ### # # ### # ####### # # # ### ### # # # # # #
# #   # #       # # # # # #   #     #   # #   #   #   #   #   #   # # #   #   #
# ##### # ### ### # # # ### ############# ### # # # ### ##### ### ### ####### #
#   #   # #   #   # # # #   #       #       #   # #     # #   # #   #   #     #
# ### ### # ### ### # ### ######### # ####### ####### # # # # # ##### ##### ###
# #     # # # # # #   #   #       #   # # # # #     # #   # # # #     #   #   #
# ##### # # # ### ### ### # ##### ### # # # # # ##### # # # ### ### # ### ### #
#   #   # # #     #     #   #   #   # # # #   #       # #   #       #   # # # #
### # ### ####### ##### # ##### ##### # # ########### # ### ### ######### # # #
#   #     # #   # #     #     # # #   #     # #       # # #   #         # #   #
# ##### ### # # # # ######### # # # ####### # ########### # ##### ##### # # ###
# #   # #     #               # #   # #       # #   #   # # #         #   # # #
# # ### ##### ####### ######### # # # # ####### # # ### # # # ### ######### # #
# #   #     #   #     #       # # # # #   # # #   #   #   # # #   #       # # #
# # # # # # ####### ##### ### # # ### ### # # # ### ### ######### ####### ### #
# # #   # #       #       # #   #         # # # # # #   #   #   # #   # # #   #
# ####### ### ### ### ### # # ### ##### ### # ### # ### # # # ### # # # # ### #
#         #   #   #     #   #   #   #     #   # # #   #   # #       #   # #   #
############### # # ########### ### ##### ### # # ### # # # # ### ### ### ### #
# #   # #   #   # # # #         # # #       # # # # #   # # # # # # #   #     #
# # # # ### # # # # # ### ### # # ### ##### # # # # ##### ##### # # ####### ###
#   # #     # # #   # #   # # # #   # # #   # # #   #   #           #     #   #
##### ##### ### ##### # ### # # ### # # ##### # ### ### # ########### # ##### #
#   # #   #   # #     #   # # #   # # #   #   #           #   #   #   #       #
# ### ### # ##### # ##### # ##### # # ### ### ####### ### ### ### # ### ### ###
#   #     #     # #       # #       #   # #             # # #   #   #   #     #
# # ##### ##### ##### # ### # ######### # ####### # ### ### ### # #############
# #     #     # #     # #       #         # #   # # # # #   # # # # #       # #
# # ### ##### # ############### ####### ### ### # ### ##### # # # # # # ### # #
# #   # #     #   #                 #   #     #   #       #   #     # #   #   #
# ### # # ### ### # ######### ##### ### # # # # ######### # # ### ### # #######
# # # #   # #     # #   #   # #     #     # #           #   #   #     #       #
# # ### # # # ### # # ##### ##### # # ##### ##### # ####### ### ### ###########
#   #   #   #   #   #       #     #   # #   #   # #   #   #   # #             #
### ##### ##### # ######### # ### ### # ##### # ### ### # # ##### ########### #
#       #     # #         #   #     # #       #         #                   # #
###############################################################################
