###############################################################################
# #         # #               #             #   #   #   # #   # # #           #
# # ##### # # # ####### # ######### ##### # ### # # # # # ### # # ### ####### #
#   #     #   # # #     #     #   # #   # #   # # #   #   #   #   # #     #   #
##### ##### ### # ### ### ####### ### # ### # # ######### # # ### # # ### #####
#     #     #       #   #   #       # #   # # #         # # #     # # #       #
# # ######### ####### # ### ### ### ##### ### ### ##### # # # ##### ### ##### #
# # #       # #       #   #     #     #   #     #     # #   #   #   #       # #
# # ####### ### ########### ### ####### ### ### ##### ### ####### ### #########
# #       #       #   #   #   # #           # #   # #   #       # #     # #   #
# ############### # # # ##### # ############# # # # ### # ##### # # ### # # # #
# #         # # #   # # #   # #   # #   # #   # # #     #     # #     #   # # #
# # ####### # # ####### ### # ### # # # # ### ### # ####### ### ### ######### #
# #   # #     #         #   #   #     #           # #   # #   #   # #   #     #
# ### # # ####### ##### # ################# ### # # # ### # # ### # # # # #####
#       #       # #   # #   #   #   # #     #   # # # # #   # # #   # # # #   #
########### # ### # # # # ##### # ### ####### ##### # # # # ### ### ### # ### #
#   #   # # # #     # # # # #   # # # # #   #   #   # # # # #     # #     # # #
# ### # # ### # # # ### # # ### # # # # ### # ##### # # # ### ##### # ##### # #
#   # # #   #   # # #   #     #       #   #   #     #       # #   #   #     # #
### # # ### # ### ########### ####### ### ### ##### # ### ### # # ##### ##### #
#     #   #   # #       #   #     #   #   #     #   #   #     # # #     #     #
# ##### # ##### ### ### # # ### # ### # ### ### ### # ##### ### # # ### # ### #
# # #   #   #   # # # #   #     #           # #     # #         #   #   # #   #
# # # ### ### ### ### ##### # ####### ####### # ### # # ##### # # ##### # # ###
#   # #       #       #     #   # #   #   #   # #     #     # # #   # # # #   #
##### # ##### # # ### ######### # ### # # # ### ##### ####### # ##### ##### # #
#     #   #   # # #   # #       # #   # #     #   #       #   #   #         # #
# ##### # ##### # ##### # ####### ##### ### # ##### ##### # ##### # ######### #
#   # # #   #   #       # #   #   #       # #   #   #     # # #         #   # #
##### # # # # # ##### ### # ##### ########### # # # ### ### # # ####### # # # #
#     # # #   # #       #   #   #       #     #   #   # #   #   #     #   # # #
# ##### ### ####### ######### # ##### ### ####### ### ##### ####### ### ##### #
# #     #   # # # # #   #     #   # #     #     #   #   # #     #   #   # #   #
# # ######### # # # # # ####### # # ##### # ####### ### # ####### ### ### # ###
#   #       #       # # #       #     #   #   #       #   # #     # # #   #   #
# ##### ### ####### ### # # ### # ### # # ### ### ### ##### ##### # # # ##### #
#       #   #             # #   #   #   #       # #                 #       # #
###############################################################################
