###############################################################################
#   #       #               #   #   #         #   # #         #   #     #     #
# # ### ### # ######### ### ### # # # ####### # # # ######### # # # ######### #
# #     #   # # #   #     # #   # # #   #   #   #   #     #   # # #       #   #
# ########### # # # # ### # # ### # # # # ############### # ### ####### # # # #
#   #           # #   #   #   #   #   #     #   #     # # #       #   # # # # #
### # ########### ### # ##### ############# # # # # # # # ####### # ##### # ###
# #   #   # #       # # #   # #   #     #   # #   # # #         # # #     #   #
# # ### # # # ######### ### # # # ##### # ####### ### ##### ### # # ### ##### #
# #   # # #   #       #   #   # # #   #   #     #   # #   # # # #       #     #
# ### # # ##### ##### ### ### # # # # # ### ####### ### # # # # ##### ##### # #
#   # # # #   # #       #   # # #   # # #           #   #   #   #   #       # #
# ### ### # # # # ### # ### ### # ### # ##### ####### ####### ##### # ####### #
#         # #   # #   #   #     # # # #   # #     #   #     # #   # #     #   #
# ######### ############# ####### # ### ### ##### # # ##### ##### # # #########
# #       # # #   #     #   # #   #   # #   # # #   #   #   #                 #
# ##### # # # ### # ##### # # # # ### # # ### # ####### # ################### #
# #     #     #   # #     # # # # # #     #   #       #       #     #     # # #
# ########### # ### ### ### # # ### # ####### ##### ######### # ### ##### # # #
# # #       # #   # # # #   #   #     #     # #   # #     # # #   #   # # # # #
# # # ### # ##### # # # ##### ### ##### ##### ### # # ##### # ### ##### # # # #
# #   #   #     # #   # #   # #   #               # # # # #   #         #   # #
# ### # ##### ### # ### # # # # # # # ####### ##### # # # # ### ### ##### ### #
# # # # #   # #   #   #   #     #   #   # #   #     # #   # #   #   #     #   #
# # ### # ##### ### ############### ### # # ### ##### # # # # ### ##### ### ###
#     #         #   #     #         #   # # # # # # #   # #   #   #       #   #
##### ######### # ### ### # ########### # ### # # # ##### # # # ### ### ##### #
#   #   #     # #       # # #   # #   #   #   # # #     #   # # #     #     # #
# # # ### ### # ####### # ### # # # # ### ### # # ### # ####### # ########### #
# # # #   #       #   # #   # #     # # # #       #   # # # #   # #           #
# ### # ######### ### ### ### ### ### # # ####### ### ### # # ### # ######### #
#     # # #       #     #     #   #           #     # #       #   # #       # #
### ##### # ### ### ######################### # ### # # ##### # ### # ##### # #
# #   #       #     #   #           #     #     #   #   # #     #     #   # # #
# ##### ##### ##### # # # ######### # ### # ####### ### # # ##### ### # # ### #
#       # #   #   #   #   #   # #     #   # #   #   #   #       # # #   # #   #
# ####### # ### # ####### # # # ####### ### ### # # # # ####### # # ##### # ###
#         #     #       #   # #               #   #   #     #         #   #   #
###############################################################################
