###############################################################################
#         # #   #     #     #   #           #           #     #       #       #
# ### ### # # # ##### # ### # # ### ##### ### ######### # # ### ############# #
# #   # #   # #     # # #   # # #   #   #     #   #   # # #     #   #     #   #
### ### ### ####### # # # ### # # ##### ######### # # # # ####### # # ##### # #
#   #         #     # # #     #   #   # #     # # # #     #     # # #     # # #
# ############# # # # # ##### ##### # # ##### # # # # ### # ### # ##### ### ###
#               # #     #   # #     #   #       # # #   #   # # #   #   #   # #
# ############# # ##### # # # ##### ######### # # ##### # ### # ### # ### ### #
# #   #     # # #   #   # #       #     #     # #   #   # # # #     # #   #   #
# ### # # # # # ######### ############# ### # # # ##### ### # ####### # ##### #
# #     # # # #   #   # #   #     # #       # # #     #     #     #   #     # #
# # ### # # # ### # # # # ##### ### ### # ##### # ### # ######### ### # ### # #
# #   # # #   #   # #   #     #   # #   #   # #   #   # #     #     #   #     #
# # # # ##### # ### ### # # # ### # ### ### # # # # # # # # # ##### ### # #####
# # # #   # # #   #   # # # # #   #   #   #   # # # # #   # #   #   #   #     #
# # # ##### ##### ### ### ##### ### ##### # # ##### ### # # ### # # # ####### #
#   #   #   # #   # #         # #   #   # # # #         # # #     #   #       #
### ### ### # # ### ##### ### # # # # # ### ######### # # ######### ###########
#     #   #   #   #     # #   # # #   #   #   #   # # # #         #           #
# ##### ### # ### ### # ####### ####### ##### ### # # ########### # ####### # #
# #   #     # #       #   #   #   #   # # # #   #       #   #   # # #   # # # #
# # ######### # ########### # ### # # # # # # # ##### # # ### # ### # # # # # #
#     #       # #     #   # #       #   #     # #     #     # #   #   # # # # #
##### # ######### ##### # # ######### ########### ### # # ### # # ##### # ### #
#     #           #     # #   #       #   #   #   #   # #     # #   # # # #   #
# ################# ####### ### ##### ### # # # # # # # ### ##### # # ### #####
# #     #         #   #     #   #     # #   #   # # # # # # #     # # # # #   #
# ### # # # ####### # ####### ### ### # ####### ### # ### # ##### # # # # # # #
# #   # # # #       # #     #   # # #           #   #     #     # # #   # # # #
### ### # # # ####### ### # ### # # ############# ##### # ##### ### ### # ### #
#   #     # #   #   #     #   # # #     #         #   # # #     # #     #     #
# ### ####### ### # ### # ##### # ### ### # ##### # ### # ### ### ##### ##### #
#   # #       # # #     #   #   # #   # # #   #     #   # #   #       #     # #
# # ########### # ######### ##### ### # ##### # ### ####### ######### ##### # #
# #   # #   #   #     #     #   #   #   # #   #   #     # # #           #   # #
# ##### # # # ### ### # ####### # # ### # ####### ##### # # ### ######### ### #
#         #       #   #           #     #         #       #   #               #
###############################################################################
