###############################################################################
#   #             #   #     #       #           #       #         #           #
# ### ### ##### ### # # ### ### ### # ### ####### ##### # ####### ##### ### # #
#   # # #   # # #   # #   #   #   #   #   #         #   # # #   #     #   # # #
# ##### ### # # # ### ##### # # ####### # ##### # # ####### # # ##### ### #####
# # #       #   #   # #   # #   #       # #     # #         # #   # #     #   #
# # ########### ### ### # ### ######### # # ######### ####### ### # ##### # # #
#         # #   #     # #       #   # # # # #   #     # #     #   # #     # # #
# ######### # # ##### # ####### # # # ### # # ######### # ##### ### # ##### ###
# #   # # # # # #     #   # # #   #     # #   #       # #     # #   #         #
# # ### # # ### # ### ### # # ######### ### ### ### ### ##### # # ####### # # #
# # #     #   #     # #   # #     #   #     #     #   #   #   #         # # # #
# # # ####### ##### ### ### ### # ### ### ### ####### # # # ######### # ### ###
# # #       # #   #           # #       # # #       # # # #       #   #       #
# # ####### # # ##### ### ### # ##### # ### # ####### # # # ##### # ### #######
#   # #       #   #     #   # # # #   #     # # # #     # # #     #   #   #   #
# ### # ### ### ########### ##### # ### # ### # # # ####### # ############# # #
#       # #   # #       # # #     # # # # #     # #         # #   #         # #
# ####### ### # ####### # # ##### # # ####### ### ######### # ### # ####### # #
# # #     #   #   # #     #     #   #   #     #           # # #     #       # #
# # ### # # ##### # # ##### ####### # ### ### ##### # ##### # # # ### # ### # #
#       # # # # # # # #       #     #       #     # #     # #   # #   # #   # #
### # ### ### # # # # # ########### # ##### # ##### ##### # ##### # ### # ### #
#   #   #   #   #   #               # # #   #       # #   #   # # #   # # #   #
### # ####### ### ##### # ### # ### # # # ##### # ### ### ### # ####### ### ###
#   #     #     #       #   # #   #   #   #   # #       # # #     # # #   #   #
# # # ##### ### ####### # # # ### ##### ##### ############# ##### # # ### ### #
# # #   # # #     #   # # # # # #   #         #   #   #   #   #   #     # #   #
# ### ### ### ##### # # ####### ### # ####### # ### # # # # # # ##### # # # ###
#   #       # #     #   #       # # #   # #   #     #   # # #   #   # # # #   #
### ####### # # ######### ####### # # # # # ##### ######### # # # ### ### # # #
#   # # #   #     #   # # #   #   # # # # #   #   #       # # #         # # # #
# ### # # # ### ##### # # # ##### ### # # # ### ######### ### ######### ### # #
#   # #   #     #   # #             # #   #   # # #   #   # # #         #   # #
# # # # ##### ### ### # ### ##### ### ######### # # # # # # ### ############# #
# #   # #           #     # #     #     # # #   # # #   #   #   #     #     # #
# ############# # ##### ### ####### ### # # # # # # ####### # ### ### # ### # #
#   #           #         # #         #       #         #   #     #   #   #   #
###############################################################################
