###############################################################################
#     #     #           #   # #         #       # # # #   #       #     #     #
# ### ### ############# # # # ### ### ### # ### # # # ### ##### ##### # # ### #
# #     #   #     #       # # #   #     # # #       # #       #       # #   # #
# ##### ### ### ### ######### # ####### ##### ####### # ########### ####### ###
#   #         # # #   #   #     #   #   # #   # #         #     #     #   # # #
### ########### # ### # ##### ##### # ### ### # # ####### ### ####### ### # # #
# #       #     #   #   #   # # #   #     # #   #     # # # # #   # #         #
# ####### # ####### ### # # ### ### # # ### # # ##### # # # # # ### # # # #####
# #     # #       #     # # #         # #   # #   # # #     #   #     # #     #
# # ##### ####### # # ### # # ##### ##### ####### # ##### ### ### # ### # ### #
# #   #     #   # # #     #   #   # #   # # #   #   #       # #   # # # # #   #
# ### # ### ### # # # # ####### # # # # # # ### # # ### ### # ##### # ####### #
#   # # # #   # # # # # # #   # #   # #       #   #     #                   # #
# # # # # ### # # # # ### ### # # ### # # ### ### # # # ##### # # # ###########
# # #   # #   # #   #   #     # #     # # #       # # #     # # # #           #
### ### # # ### # ### # # ##### # # ### # ### # ### # # ### # ##### ######### #
#         # #   # #   # #       # # #   #   # #   # # # # # # #             # #
# ##### ##### ### ##### ######### ### ##### ### ####### # # ### # ### # ##### #
#   # #   #   # # #   #     #   #   # #   # # # #       # # #   # #   # # #   #
### # # # # ### # # # # ### ### # ### # ### # # ######### ### ### ##### # ### #
# #   # # #     # # # #   # #   # #   #   # #   #     #   #     #     #     # #
# # ### # ### ### # # ### ### ######### ############# # ##### ### # ### #######
# # #   #   # #   # #     #   #     #   # #   #   #   #     # #   # #     #   #
# # # ##### # ############# ### ### # ### ### # # # ####### # # ######### ### #
# # # #   #       #   #         #   #       # # # # #     # # #   #     #     #
# # # ### ##### ### # # ######### ####### ### # # # ### # # # ### ### ##### # #
# # #   # #   # #   # # # #       #     #       #       #       #         # # #
# # ### # ### ### ### # # # # ####### ####### ####### ######### ### # ####### #
# # # #     #     # #   # # # #   #   # #       #       #         # # #   #   #
# # # ##### ### ### # ### # ### # # ### ####### # ### # # ####### ##### ### ###
# #   #   #     # #   #   #   # # #         # # # #   # # #   # #       # # # #
# ### # ### # ### ##### ##### # # ######### # ############# # # ##### ### ### #
#   # #   # # # # #             # #       # #       #     # # #     # #       #
### # ### ##### # # ############# # ### ### ### ### # ### ### # ##### ##### # #
#   # # #   #     #   #   #       # #     # #   #   # #   # # #             # #
# ### # ### # # ##### # # # ####### ##### # # # # # # # # # # # ##### ### #####
#         #   #       # #               #     # # #   # #       #     #       #
###############################################################################
