###############################################################################
#   # #       #             #     #               #       #   #   #       #   #
# ### # ##### ### # ####### ### ### ##### ####### # ### # # # ### # ####### # #
# #   # #     #   #     # #     # # # # # #     #   # # #   # #   # #       # #
# # ### # ####### ### # # ##### # # # # ### # ####### # ##### # ### # # ##### #
#   # # # #     # # # #   #     # #   # #   # #       # #   #   #     #   #   #
### # # # # # # ### # ### # # ### ##### # ### # ### ### # # ##### ### ### # ###
#   # # #   # #     # #   # # #   #   # #   #   # # #     # # #   #   #   # # #
# ### # ####### ####### ### ### # ### # ####### # ### ####### # # # ##### ### #
# #   #     # #   #     #   #   #   # #   # #   # # #         # # #     #     #
# # # ### ### ### # ##### # ####### # ### # ### # # # ### ##### ####### # #####
# # # #   #       # #     #   #   # #           # #     #     #   # #   # #   #
# # # # ######### # # ####### # # # ####### ### # # ### ### # # # # ######### #
# # #     #         #   #       #       #     # # # # # #   #   #   #       # #
# # ####### ######### # ####### ####### # ##### # # # # ### # ##### # ####### #
#   #     # #     # # # # #   # #     # #   #     # # # #   # # #   #   #     #
# ### ### # ##### # # ### ### # ### # # ### # ##### # # # # # # # ##### # # # #
#   #   #       #   # # #   #   # # #     # #     #   # # # # #   #   #   # # #
############### ### # # ### # ### ##### # # ##### ### # ########### # # # # # #
#     #     # #   #   #   # #     # #   # #     #     #       #     #   # # # #
# ### # # # # ######### # # ### ### ##### # ######### ##### ### ##### # ### # #
#   #   # #   #         # #   # #               #       # # #       # #   # # #
# # ####### ### ##### # ##### ### ##### ####### # ##### # # # ########### # ###
# #   #       #     # #     #     #         #   #   # # # # #       #     #   #
##### ######### ### # ##### # # # # ### # # # # ##### # # # # ### # ######### #
#     #         #   #     #   # # # #   # # # #   #   # #     #   #   #     # #
# ##### ######### ##### # ####### ### ### # ### ##### ### ### ####### ##### ###
#     # #   #     #   # # # #     #   #   # # # #     # # #       # # # #   # #
##### # # # # ##### # ### # # ### ##### ### # # ### ### # # ### ### # # # ### #
#   #   # #   #     # # # #   #   # #   #     #   # # # # #   #     #   # #   #
# # ############### # # ### ####### # ##### ##### # # # # ### ##### ##### # ###
# #       #       # # #   # # #   #     # #     #   #     # #     #     #     #
# ####### # ##### ### ### ### # # # ### # # # ####### ### # ##### ##### ##### #
# #   #   #     #   # #         #   #     # #   #   # #     #     #           #
# ### # # # ##### ### ######### ######### ######### # ######### ##### # #######
#     # # # #     #   #   # #   #   #     #         #   #   #   #   # # #   # #
##### # ### # ##### # # # # # # # # ######### ### ##### ### ### # # ### ### # #
#     #     #       #   #     #   #       #     #       #       # #           #
###############################################################################
