###############################################################################
#   # #       #       #       #       #   #                 #             #   #
# # # # ####### ### # ##### # ####### ### # ############### # ##### ##### ### #
# # #   # #   # #   #     # #           #     #             # #   # #   # #   #
# # # ### # # # # # ### # # # ######### ##### ### ############# ### # # # # ###
# # #       #   # # #   #   #   #     #     #   #               #   # #   #   #
### # ### ####### ### # # ##### # ### # ### ### ################# ### ### # # #
#     #     #   #   # # # #   # #   # # #     # #   #       #   #   #   # # # #
# ##### ### # # ##### ##### # # # # ### ####### ### # ##### # # ### ##### ### #
# #   #   #   # #         # #     #   #         # # #   # #   # #   #     #   #
# # # ### # ##### ### ##### ### ### ########### # # ### # # ##### ########### #
# # #   # # # # # #   #   # #   # #   #   #     #   #     # #     #   #     # #
# ### # # # # # ######### ####### ##### ### ####### # ##### # ####### # ##### #
#   # #   #   #             #         # #   #     # #     #   #     # # #   # #
# # ############### ##### # # ####### # # # # # ### ### # ##### # # # # ### # #
# #   # # #   #   # # #   # #   #   # #   #   # # #     #     # # #   #     # #
### ### # # # ### # # # ####### # ### ######### # ### ##### ##### # ##### ### #
# # #   #   #   #   #   # # #   #   #   #   #   # #   #   # #     # #   #   # #
# # ### ### ######### ### # # ##### ####### ##### # ##### # # ####### # # # # #
# # #     #   #     #     # # # # #   #   #   #   #       #   #     # # # #   #
# # ##### ### # ### # ##### # # # # ### ### ### ### ####### # # ### ### # ### #
# #     #   #   # #     #         #     #   #       #   #   # # #       # #   #
# # # ##### # ### ### ### ### ######### # ### # ##### # ####### ### ##### # ###
# # # #   #     # #   #     # #           #   #     # # # #     #     #   #   #
# # ##### ### ### ######### # # ######### # ### # # ### # # ##### ### # ##### #
#     # #     #   #         # #     #     # #   # #     #       # # #   #   # #
##### # ### ### ### ##### ### # ##### ##### ### ######### # ### ### ##### # ###
#     # #         # # #     # #     #     #   #   #       # #   #         #   #
# ##### ### ##### ### ####### ### # ##### ####### # ######### ### ##### # ### #
# # #   #   #   #   #   #         #     #     # # #   #   #   #   #     #   # #
# # ### # ### # ####### # # ##### # ### # ### # # ### # ### ### ### # ####### #
# # # # #     # #     # # #     # # #   # # #     #   #   #   #   # # #   #   #
# # # # # ##### # # ### # ### ### # # ### # # ##### ##### ### ### # # # # # # #
#     #     #     # #     # # #   # # #   # #       #   #   #     # # # #   # #
##### ### ####### # ### # # ### ### # ### # ######### ##### ######### # ### # #
#     # #     # # # #   #     # # # #   # #         # #     # #       # #   # #
# ### # # # # # # ### ### # ##### ########### ####### # ##### # ########### # #
#   #     # #   #       # #                           #         #           # #
###############################################################################
