###############################################################################
# #         #           #       # #       # #       #       #   #   #         #
# ### ############### ######### # # # # ### # # ### ### ##### # # ### ####### #
#     #       #                 # # # #   #   #   # #   #     #   #   #     # #
# ######### ### ##### ##### ##### # # # # ##### # ### ######### ##### ##### # #
# #             #   # #         # # # # #   #   #   # #       #   # #     # # #
# # ####### ### # # ### ####### # ### ############# # # ##### ### # ##### # # #
#   #   #   #     # #   #       #         # #       #     #     # #       #   #
### # # ##### ######### # ############# # # # ##### # ### ####### # ##### #####
#   # #     # # #     # #         #   # #   #   # # # # # #         #   #     #
##### # ##### # # ############### # # # # ### ### # # # # # ######### # ##### #
#   # #       #     #       #   #   # # #   # #   # # #   # #   #   # # #   # #
### # ####### ##### # # ### # ######### ### # # # # # ##### # # # # # # # # # #
#   # #     #     #   #   #   #   #     # #   # # #   #     # # # #   # # # # #
# # # # # ####### # ### ####### # # ##### ##### # ##### ##### ### ##### ### # #
# # # # # # #   # # #     #   # # #       #     # #     #   # # #   # #   #   #
# # ##### # # ### # ##### # # # # ####### ### # # # ### ### # # # ### ### #####
# #   #   # #   # #     # # #   # # # # #     # #   #   #     # # #   #   # # #
# # ##### # # ### # ### ### # ##### # # ##### # # ### ### ##### # # # ### # # #
# # # # #   #   #   #     # #       # # # #   # # #     #     #   # #   #     #
# # # # ### ### # ### # ##### ##### # # # ####### ####### ##### ####### ##### #
# # # #           #   #         #   # # #       #   #         #       #   #   #
# ### ####### ##### ################# # # ##### ### # ####### # # ####### # ###
#   #       #     #       #       # # #   #   #     # #         # #       #   #
### ####### # ######### # # ####### # # ### ####### ### # ####### # # ####### #
#     #             #   #     #       # #       # #     #   #     # # #   #   #
### # ##### ### # ####### ##### # ##### # ##### # ########### ##### ### # #####
#   #         # #       #     # # # #   # #   #     #   #   # #   # #   #     #
# ### ######### # ##### ### # ### # # # # ### # ### # # # ##### # # # ####### #
# #   #     #   # #   #   # #         #       #   # # # #     # #   #   #   # #
# ##### ### # ### ### # ####### ####### # ####### # # # ##### ##### ####### # #
#   #     #   # #     #       #   #     #   #   # #   #       #     #       # #
# # # ######### # # ### # ### ### # ########### # ######### # # ##### ####### #
# # # #           #   # #   # #   #     #       #       #   #   #   # #     # #
# # ##### # ### ##### # ##### ### ####### ############### ######### # # ### # #
# # #     # #   #     # #   # # #     #           #     # #       # # #   #   #
### ######### ### ##### # # # # # ### # ######### # # ### # # ##### # ### ### #
#         #     #   #   # #   #   #   #         #   #       #             #   #
###############################################################################
