###############################################################################
#   #         #   #           #     #       # # #     #     # # #       #     #
# # # ### ### ### # # ### ##### # ### ##### # # # ### ### # # # ####### # #####
# #   # #   #   #   #   #       #   #     #       #   # # #     #   #   # #   #
# ##### # ##### ##### # ########### # ### ######### ### # ######### # ### ### #
#     #   #   #   #   #   # #     # # # #   #   # # #     #     #   # # #   # #
### # ##### # ### ####### # # ##### ### # # ### # # # # ### ####### # # ### # #
# # # #     #   #   #       # #       #   # # #   #   # # #   # # # # #       #
# # # # ####### ### # ####### ##### # ####### ### ### ### ### # # # # ### #####
#   #   # # #   #   #   #   # #   # # #   #               # #     # # #       #
# # ##### # # # # ##### # # # ### ### # # # ############# # # ##### # ####### #
# # #     #   # #       # # #   #   #   # #   # #   #   # # #             # # #
### # ################### # ### ### # ####### # ### ### # # ### ######### # # #
#   #       #             # # #   #   # #     #     #   # #         #   #   # #
# ####### ### # ##### ### # # ### # ### ####### ### # ### ##### ### # ##### # #
# # #     #   # # #   #   # # # #       #   #     # #     #   #   # #   #     #
# # # ### # # # # ##### ### # # ### ####### # ##### # # ##### # ####### # ### #
# # # #   # # # #     # # #     #   #     #   # #   # #     #         #   # # #
# # # ####### ##### # # # ##### # ##### ##### # # # ##### # # # ##### ##### # #
# # #   #   # #     # # # #   # #   # #     # #   #       # # #     #   #   # #
# # ### # # # # ####### # # # # ### # ##### ##### ##### ### ### # # # ### # # #
# #       #   #   # #   #   #   #           # #   #   #   # #   # # #   # # # #
# # ##### ####### # ##### # # ######### ### # # ##### ##### # ##### ### # ### #
# # #   #   #   #   # #   # #   #       # # #   #   #         #   #   # #     #
# # # ### # # # ### # # # # ### # ####### # ##### # ### # # # # # # ######### #
# # #     #   #   # # # # #   #   #       # #     # # # # # #   # #   #       #
# # # ########### # # # ### # ##### # ### # # ##### # ##### # ##### ######### #
# # # #   #       #     #   # # # # #   # # # #             #     # #   #   # #
# # # # # ### # ##### # # ##### # # # ### # # ##### ### ### # ### # ### # # # #
# # #   # #   # #   # # #   # # #   # #   # #   #   #   #   #   # #     # #   #
# ####### # ### # # # ##### # # # ### ### # # ####### ### ##### ############# #
#   #   # # #   # # # #     # #   #   # #       #       #   # #     #   #   # #
### ### ##### ### ### # # ### ##### ### ### # ######### ##### # ##### ##### ###
# # #   #   #     #   # # # #   #   #     # #         # # #   # #         #   #
# # # # # # # ##### ### # # ### ### # # ### # ### ##### # # ##### ####### ### #
#   # # # # # #   #   # #   #     # # #     #   #   # #         #       #   # #
##### ### # # # # ### # ##### ### ### # ### ### ### # ######### ####### # # # #
#         #   # #     #   #     #     # #   #     #     #               # #   #
###############################################################################
