###############################################################################
#       #   #     #       #   #           #       #       #   #   #           #
# ### # # ### # ### ##### # ######### ### # ##### ### ##### # ### # # #########
#   # # #   # #     #   # #   #     #   # # # # # #         #     # #         #
##### ##### # ##### ### ##### # ####### ### # # # # ##### ##### ############# #
#     #   #   #   #   #     #   #   # #   # # #       #     # #   # #         #
### ##### ##### ##### # ####### # ### # ### # # ####### ##### # # # # ####### #
#   #     #   #     # #     # #     #   #     #     # #     #   #   # #   # # #
# ### ##### # ### ### ##### # # ### # # # ### ##### # # ### # ### ### # # # # #
#     #   # #     #     #     # #     # # #   #   # # #   # # #     # # # #   #
# # ##### # ##### # ### ### # # ####### # # # # ### # ### ### # ### # # # #####
# #       # #   #     #   # #   #     #   # #     #     #   # # #   # # #     #
# ####### # # # ####### # # # ####### ### # ### ####### ### ##### ### # ##### #
# # #     #   # #       # # # #     #   # #   #   #   #   # #   #   # #   #   #
### # ######### ##### ##### ### ### ### # # ######### ### ### # # # # ### ### #
#   #   #     #   #       #     # #   #   #           #   #   #   #     #   # #
# # ### # ### ### ### ### ####### # # ### # ##### ##### ### ####### # ##### ###
# #   #   #   #   #   #             #   # # #   # #   #   #     #   # #   #   #
# # ####### # # ### ##### # ### ##### # # # ### ### ### # ### # ####### # # ###
# # #   # # # # #   #     #   #   #   # # # #   # # # # # # # #         # #   #
# # # # # # # # ### ######### ### ######### # ### # # # ### ####### ### # ### #
# # # # #   #   #     #     # # #   #       #     # #     #       # #   #     #
# # # # ### ##### ### ### ### # ### ##### ### ##### # ### ##### ### ######### #
# #   # #   #     #     #   #   #   #   #         # # #       # #   #   #   # #
# ##### ##### ######### ### # ##### # # # ######### ### ####### # ### # ### # #
# #         #   #     #   # #   #   # # #   #     #   #   #     # #   #   # # #
# # ### ### ### # ####### # ##### ##### # ##### ##### ### ##### # # ##### # # #
# # #   #   #   #           #       #     #   #     # # # #   # # #     # #   #
# ####### ### ####### ### ### ######### ##### ### ### # # # # # # ##### # #####
# #   #   #   # #     # #   # #   #     # # #     #   #     # # # #   # #     #
### # # # # ### # # ### ### ### ##### ### # # ##### ### ##### # # # # # ##### #
#   #   # #     # #   #   # #                 # #   #       #   #   # #     # #
# ####### ### # ##### # ########### ### ##### # # # ####### ######### ####### #
# # #   # #   # #   # #   #           #   #   #   #       # #   #   # # #   # #
# # # # # # ##### # # ### ######### ##### ##### ##### ##### # # ### # # # # # #
# #   # #   # # # # # # #       #     # # #     #   # #     # #   #       #   #
# ##### ##### # # # # # ### # # # ##### # # # ### # ### # # ### # # # #########
#             #   #     #   # #       #     # #   #     # #     # # #         #
###############################################################################
