###############################################################################
#       #     #     # #   # #             # #     # #       # #           #   #
# # ### # ####### # # ### # # ########### # ### # # # ##### # ##### ##### # ###
# # #     #     # # # #   #           # # # #   #     #   # #     # # # #   # #
### ##### # ### # ### # # # # ### # ### # # ######### # ##### ##### # # ### # #
#   #   # #   # #     # # # #   # #     #           #       #         #     # #
# ### # # # # # ##### # ### # ### ################# ####### ##### ##### ##### #
#     # # # # #     # #   # # #   #       #   # #     #   #   #   #   #       #
####### # # # ### ### ### # # # ### ### # # # # # ##### # # ##### # ###########
#   # # # # #   # #         # #   # #   # # # # #       #   #   # # #   #   # #
# ### # # # # ### # ######### ####### ### # # # ####### ##### ### # ### # # # #
# #   # # # # #     #     #         #   #   # #     #   #       #   # # # # # #
# # ### ### ### ####### # # # ##### # # ##### ##### # ######### # ### # # ### #
# #         #   #     # #   # #     # #   #         #   # # #   # #         # #
# ######### # ### ### # ####### # ####### # ##### # # ### # ### # # ######### #
#       #   # #   #   # #   #   # #     # #   # # #       #                   #
# ########### ##### # # ### ##### ### # # # # # # # # ########### ######### # #
#   #   #     #   # #   #   #     # # # # # # #   # #   #     #     #     # # #
### # # # ##### ######### # # ##### ### ##### ### # ### ### ### ### # #########
#   # #   #   #   #     # #   #       #   #   # # # #         #   # # #     # #
# ### ### ### ### ##### # ### # ####### # ### # # # # ########### ### # ##### #
#   # #   # # #   #   #     # # #     # #     # # # # #     #     #     #     #
### ####### # # ### # # ### ### # ### ######### # ### # ### # ######### ##### #
#       # # # # #   #   # #     # # #     #   #   #       #   #             # #
# # ##### # # # # ##### # ####### # # # ##### ##### # # # ##### ####### ### # #
# # #       # #       # #       # # # # # #   # #   # # # # #         # #   # #
# ### ##### # # # # # ##### ### # # # # # # ### # ### # # # # ### # ##### ### #
# #   # #   #   # # # #     # #   #   # #     # #   # # # #   # # #     #     #
# # ### # ####### # ### ##### ### ##### # # ### ### # ### # ### ####### #######
#       # #       # # # #       #   #     #         # #     #       #     #   #
######### # # ##### # # ### # # ##### # ########### # # ####### ######### ### #
#         # #   #   # #   # # #   #   #   #     #   # #   #     # #   # #   # #
# ######### # # # ### ### # # ########### ##### ####### # # ### # # ### ##### #
#       #   # # #   # #   # #   #     #   #   #         #     #     #   #     #
# ##### ##### ####### # # # ### # # # ### ### # ####### ### # ### # # ### # ###
# #   # #     #     # # # #   # # # #   #   #   #         # #   # # #   # #   #
# # # # # # # # ##### ### ##### ### ### ######### # ####### ########### # #####
#   # #   # #       #         #     #             # #                         #
###############################################################################
