###############################################################################
#       #     # #         # #   # #     # #   #       # #       #         #   #
# ### ##### ### ### ####### # # # # ### # ### ##### # # # ### # ##### ##### # #
# #   #   #   #     #   #   # # #   #     #       # #   #   # #   #   #     # #
# ####### # ####### ### # ### ####### ### # ####### ####### # ### ### # ##### #
# #       #     # # #     #   # #   #   # #         # #     #   # #       #   #
# ##### ### ##### # ##### ### # # ### # ### ######### ##### ### # # # ### ### #
#         #       #     #   #         # #                   # # #   #   #   # #
####### ### # # # ##### # # ### ####### # ################# # ####### ##### # #
#   # #   # # # #     #   #         #   #     #     # #     # #   #   # # # # #
# ### # # ##### ####### ##### ### ######### # ### ### ### ### ### # ### # ### #
# #   # # # #   #     # #   #   #     #   # #   # #     #   #   #   # # #   # #
# # # # ### # ### # # # # ##### ### ### ### ### # ##### ### ### ##### # ### # #
#   #             # #   #         #     #     #   #   #   #   #   #   # #   # #
### ####### # ### ####### ####### ####### ########### ### ### # # # ### # # # #
#   #   #   #   #     # #   #     #     #       #   #       # # # #       #   #
# ### ### # ### ##### # ### # ##### ### # ##### # # # ####### # # # ##### #####
#     #   # #   #     #     #         # # #       # # #     # # # # #     #   #
### ######### ### ### ######### # ##### ### # ####### ### # ### # ### ##### # #
#   #       # # #   #     #   # # # # #     #   #         # #   #   #   #   # #
### # # ### # # # # ####### ##### # # ######### # ######### ####### ### # ### #
# # # # # #   # # #     #   #     # #     # #   # #   #   #         # #   #   #
# # # # # ##### ### # ### ### # ### # # # # # ### # # # ######### ### ##### ###
# # # #   #     #   #     #   # #   # # # # # # #   # #   #   #   #       #   #
# # # ### # # ### # ########### # # # ##### ### ##### ### # # ### ##### ##### #
#   #   # # #     # # #       # # #   #       #         #   #   #     # #     #
### # ### # ####### # # ### # ### ##### ##### # ############### ##### # # #####
#   # #   # #       #   # # #   #   # # #   #     #     #   #   #     # #     #
# ### # ##### ### # # ### ##### # ### # # ####### # ##### ### ### ##### ##### #
#   # #     #   # # #     #   #   #     # #       # #     #   # #   #     # # #
# ######### ######### ### ### ##### # ### # ####### # ##### # # # ##### ### # #
# #           #       #   #   #   # # #     #   #   #     # #   #   #       # #
### # ##### ##### ##### ### # # # ### # ####### # ##### # # # # ##### ### ### #
#   #   #       #   #     # #   # #   # #   #   #   #   # # # # #     #   # # #
# ##### # ####### ############### # # # # # # # # # # ##### ##### ##### ### # #
#     # #   #     #   # #     #   # # # # # # # # #   #         # #   #   #   #
##### # ### # ##### # # # ### # # # # # # # # # ### ### # ####### # # ### # ###
#     #   #         #     #     #   # #   #   #         #           #   # #   #
###############################################################################
