###############################################################################
#             #     #   #   #         #   #   #     #                   #     #
# ############# ##### # # # # ####### ### # ####### # ##### # ##### ### # #####
# #       #       #   #   # # #   #     #       #     #     #   # # #     #   #
# # ### # ####### # ####### # ### # ######### ### # ####### ### # ### ##### # #
# # #   # #       #   #     # # #   #   # #       # #   #   # #     #       # #
# # # ### # ######### ####### # ### # # # ### # ### ### ### # # ############# #
#   #   #           #         #     # #       # # #   #   #   #   #     #   # #
################# ####### # ####### # # # ####### # # ### ######### ### # # # #
#         #     # #       #   # # # # # # #     #   # #       #     # # # #   #
# ### ####### ### # ####### ### # # # # ##### ##### # # ########### # ### #####
#   #   #       #   #     # #   # #   # #         # # #   #       #   #   # # #
##### # # ##### ####### # # # # # ##### ##### ### # # # ##### # ##### ##### # #
#   # #   #           # # # # # #     #   # # # # # #   #     # #   # #     # #
### # ##### ########### ### # ##### # ##### ### # # ##### ######### # ### ### #
# # #   #   #   #       #   #   #   # #     #   #       #   # #     # #       #
# # ### # ### # ####### ##### ### # ### ### # ### ##### # # # ### ### # #######
#     # #     #       #         # #   #   # # # #     # # #   # #     #   #   #
# ### # ######### ### # # ##### # # ####### # # # # # # # # ### # ##### ### # #
# # #   #   #     # # # # #     # # # #   # #   # # # #   # #     #     #   # #
# # ### ### # ##### # # ### ### ### # # ### ### # ######### # ### # # # # #####
# #   #     #     # # #   # #   #   # # #     # #   #   #       # # # #   #   #
# # # ######### # # ####### ##### # # # ##### # ### # # ######### # # ### ### #
# # # #       # #         #       # #         # # #   #   #   # #   #   #   # #
# # # # ##### ### ####### ####### ####### # # # # # ### ##### # ### ### ### # #
#   # #   #     #     #   #       #   #   # #   #   #   #         #   # # #   #
##### ### ########### ########### ### ### ####### ### ### ### ##### # # # ### #
# #     #         #   # #   #       #               # #     # #   # # # #     #
# # ######### ### # ### # # ### ### # ##### ##### ### ### ### # # ### ##### ###
#   #       #   # #   # # #     # #       #   #     #       #   #   #     # # #
# ### ######### # ### # # ####### ### ######### ####################### # # # #
#   #           #   #     # #               #           #     #   #     # # # #
# ################# ####### ### # ##### ### # ### # ##### ### ### # ####### # #
#   #         #     # #         # #   #   # # #   #     #   #     #     # #   #
### ### # ##### # ### ####### ### # ####### ### # ##### # ##### ### ### # ### #
#     # # #   # #   #           #   #   #   # # #     #   #     #     #   #   #
# ### # # # ### ########### # # ##### ### # # # ########### ##### ####### # ###
# #     # #                 # #       #   #   #       #     #     #       #   #
###############################################################################
