###############################################################################
# #     #           #   #     #           #                 #       #         #
# # ##### ##### # ### # # ### ####### # ### # ############# # ######### ##### #
#         # # # # #   # # # #       # #     #   # #     #     #       #     # #
# ######### # # # ##### # # ####### ########### # # ### ####### ############# #
# #   #   # #   # #     # #       #   #   # #     # #           #   #       # #
### # # # # ### # # ##### ##### ######### # # ### ####### # ##### # ### ### # #
#   # # #   #   # #   #   #       #       #     # #       #       #   # #     #
# ### # # ### ##### # # # # # ### ### ########### # ### ##### ####### # #######
# #     # # #       #   # # #   #       #     #     #       #   #     #     # #
# ######### ### ####### ######### ### ### ### # ########### ### ### ####### # #
#       #     # #       #       #   #   # #   # #   #   # # #   #   #     # # #
##### # # # ### ### # ######### ### # ### ##### ### # # # ####### ####### # # #
#   # #   #   # # # # #       #     # # #   #       # # #       #     #   #   #
# # # ######### # ### ##### ### ####### ### ##### # # # # ########### # ##### #
# #     #   # #     #         #       #     # #   #   # #           # #     # #
# # ### # ### ######### ##### ####### # ##### # ##### # ######### ### ### # # #
# #   #   #   #             #   #   # # # #         # #   # #   #   # #   #   #
### # # # # # ################# # ### # # # # ##### ####### ### # # # # ##### #
#   # # #   #       #     # #   # # #     # # #   #   #         # #   #     # #
# # # # ##### ####### # ### ### # # ### ##### # ### # ######### ### ####### ###
# # # #     #     #   # # #   # #           #   #   #     #   # #   #       # #
# # ####### ####### ##### ### # ### ### # # ### ### ### # # ### # ##### # ### #
# #     #     #       #     #     #   # # # #   # # #   #   #     #     # #   #
# ### # # # # ### # # # # ### # ##### ### ### ### ################# ####### # #
# #   # # # #   # # # # #     #         #   # #   #       # #     #     #   # #
######### # ##### # ####### # ##### ####### # # # # ##### # # ####### ### ### #
# #       # #   # # #     # #     #     # #   # #       # # #   # #         # #
# # ####### ### # # ### ####### # ####### ### ######### # # ### # # ####### # #
# # #   #   #     #     #       #   # #   # # #   #   # #     #         #   # #
# ##### # ### ##################### # # ### ### # # ######### ########### ### #
#     # # #     #                   # #         # # # #     #   # #   #     # #
# ### # # # ##### ##### ########### # # ######### # # # ### ### # ### # ### # #
# #                   #     # #   # #           # #       #     # #       # # #
# ### ######### ##### ### # # # # # # # # # ##### ####### ####### ####### ### #
# #   #     #   #       # # #   #     # # # #   #   #     #       #     # #   #
# # ### ### # # # ####### # ### ### ##### ### # ### # ### # ### # # ### # # ###
# #       # # # #       # #   # #       #     #   #   #       # #   #     #   #
###############################################################################
