###############################################################################
#       #                   #       #   #     #     #                   #   # #
### # ### # ########### # ### ##### # # # # ### ### # ### ######### ### # # # #
#   # # # # # #     #   # #   #     # # # #   # #   # # # # # #       # # #   #
# ### # # ### # # # # ##### ### # ##### ##### ### # ### # # # # ### # # # # # #
# #   # # #   # # #   #     #   #     #     #   # # #   # # #   #   # #   # # #
# ##### ### # # # # ### ##### ####### # # ##### # # # ### # # # ##### ##### # #
# #   #   # #   # #         # # #     # #     # # # # # # # # #     # #     # #
# # # ### # # ########### ### # # # # ##### ### # ### # ### ######### ### ### #
#   #   #   #   #         #   #   # #       #               # #       #   #   #
####### ######### # ####### ### ### ##### ### # ##### # ### # # ####### ### ###
#         #       #     #     #   #     #     # # #   # # # #         #   # # #
# ##################### # ### ### ### ##### ##### # ##### # # # ##### ### # # #
#       #         # #   # # #   # # # #   #       #       # # #     #   # # # #
####### # ####### # # ### # ### # # ### # # # ######### ### # # ##### ### # # #
#       #     #   # #   # #     #   # # #   # #         #     #     # #   # # #
# ##### ##### # ### # # ### # # ##### # ##### ########### # ### ####### ### # #
# #     #     #   # # # #   # # #   #   #         #     # #   # #         #   #
# # ##### ####### # # ######### ### # # # ##### ##### ### # # # # ######### ###
# #     #   #       #   #   #       # # #   #   # # # #   # # # #     #     # #
# ######### ########### # # ########### ##### ### # # ####### # ######### ### #
#     # #       #     #   #   # #   #   #     # #   #         #     #   # #   #
##### # # ##### ### # ### # # # ### ##### ### # # ################# ### # # # #
#     #   #   #     #   # # # #   #     # # # # #               #   #   #   # #
### ####### # ##### ### # ##### ##### # # # # # ############# # ##### ### #####
#   #       # #   # #   # #   # #     # #   # #   # #       # #   #   #   #   #
# ### ####### # # # # # # # ### # ##### ######### # ##### # # ### # # # # ### #
#   #   #   # # # # # #   #       #   #     #     #       # # # #   #   #     #
# # ### # ### # # # ####### # ##### # ##### # # ########### # # ##### # ##### #
# #     #     # # # #       # #     # #     # # #     #   # # # #     # # #   #
# ### ######### ### # ##### # ##### # # ##### # # # # # ### # # # ##### # # ###
# #   #   #   #     #   # # #     # # #     # # # # # #   #   #     #     #   #
# # ### # ### # # ####### ####### # ####### # ### ### # ########### # ####### #
# # #   #   #   #       #         #     #   #   # # #   #       #   # #       #
### # ##### # ######### ##### # ##### ### ### # # # # ### ##### # ### #########
#   # #   # # #     #   #   # #       #   #   #   #   #     #   #   #         #
# ##### ### ### ### # ### # ####### ### ########### ######### ############# # #
#                 #       #     #     #                                     # #
###############################################################################
