###############################################################################
#   # # #             #     # # #     #   #     # # #       #     #       #   #
# ### # ### ### # ### # ### # # # ##### # ### ### # # # ####### # ####### # # #
# #   #   #   # # #     # #     # # #   #   # #   #   #   #     #       # # # #
# # ##### ### ### ####### ##### # # ##### # # ### ### ### ##### ######### # # #
# #       # # #     #     # #   # #   # # #     #     # #     # #   # #     # #
# ####### # # ##### ##### # # ### # # # ####### ### ### ### ### # ### ####### #
# # #   # #   # # #   # #   # #     # # #     #   # # #   # # #   #         # #
# # # # # ### # # ### # # # # # ### # # # # # ### # # ### # # # ##### # ##### #
# # # # #     #   # # #   #   # # # # #   # # # #   #   #   # # #   # # #     #
# # # # ######### # ##### ### ### ### ##### # # # ### ####### # # ##### # #####
# #   #   #     # #       # #   # # #   #   # #   #     #     # #     #       #
# ####### ##### # ##### ### ### # # ### # ### ### # ##### # ### # # ######### #
#       #   #   # #   # #     # #     #   # #           # # #   # # #         #
# ######### # ### ### ### ##### # ### ##### ### # ####### # # ### ### #########
# #   # #   #   #             # # #         #   #   #   # #       #   #   #   #
# # # # ### # # ####### ##### # ### ### ########### # ### # # ##### # # # # # #
# # #   #   # #     # # #             #                   # #       # # # # # #
# # ####### ####### # ######### ##### ############# ####### ######### # # ### #
#   #             #     # #     #       #         #       #         #   #     #
# # ############# # ### # ######### ##### ##### ### ### # ##### ########### # #
# #           #   #   #           #       #   #   #   # #   #   #           # #
# ### ####### # ##### ####### ####### ### # ####### # ####### ##### ######### #
# #   # # #   #       #     #     #   # #       # # #       #     #   #     # #
# ##### # # ####### # # # ##### # # ### ### ##### # ### ### ##### ##### ### # #
# #   #         #   #   # #   # #   #     #       # #     # #   # #     # # # #
### # # ####### # ### ### ### ### ### # ######### # ####### # # # # # # # # # #
#   #   #   #   # #   #     #         # #   # # # #       #   # #   # #   # # #
########### # ### ################# ### # # # # # ##### # ########### ### # ###
# #       #   #   #   #             #     #   #     #   #     #   # # # # #   #
# ##### # ### # ### # # ####### # ### ### ##### ### # ##### ##### # # # # ### #
#       #   #   #   #   # #     #   #   #   #   #   # #   # #   # #     # # # #
# ######### # # ### ##### # ### # # # # ### # ### ### ### # # # # ##### ### # #
#   # #       #   # # #     #   # # # # # # # #   # #   # # # # #   # # #   # #
### # ##### ##### # # ######### ### # ### # ### ### ### # # ### ### # # # ### #
#   #   # #     # # # #   #       # #   #     #   #   # #   # #   # #   #   # #
# ### ### # # # ### # # # ######### ##### ####### ### # ##### # # # # ##### # #
#     #     # # #       #       #       # #         #           #   #       # #
###############################################################################
