###############################################################################
#       #     #   #         # #                     #     #   #           #   #
# ##### # ### ### # ##### # # # ### ##### ##### # ### ### # # ### ######### # #
#     #     #     # # #   #     #     # #     # #     #     # #   #         # #
# ######### # # ### # # # ####### # # # ##### # ##### ### ##### ### ##### # # #
# #   #     # #   # #   #   #     # #   #     #     #   # #     #   # #   # # #
# ### ####### # # # ####### ####### ##### ######### # ### ##### # ### # ### # #
#   #         # #   #     #     # # # #   #     #   #   #   #     #   # # # # #
### ######### # # ### ######### # ### ### # ############### # ### # # ### ### #
#     #       # #     #         #   #   #   #     #   #   # #   #   # #     # #
# ### ##### ########### # ##### ### ### # ### # # ### ### # # ####### ##### # #
#   #   #       #   #   # # #   # #   #   # # # #   # # # #     # #   #       #
### ### # ##### # # ##### # ##### ### ##### # # ##### # # ##### # ##### # ### #
# # #   #     # # #   #   #     #     #     # #   #   #   #   #   #     #   # #
# # # ####### ### ### # ### ### ### # ##### # ### # # ### ### ### ##### #######
#   #       #   # # # # #   # # #   #     # # # # # # #       #     # # #     #
# ##### ### ### # # ### ##### # # ####### # ### # # # # ### ### ### # ### #####
# #   # #   # #   #         #     # #     #       # #     #     #     # # #   #
### # # # ### ### ### ########### # # # ### ### ######### ### ####### # # ### #
#   #   # #   #   # # #     #     # # # #   #   # #     # #   #               #
######### # ### # # # ##### # ### # # ### # # ### ##### # # ######### ##### # #
#   #     # #   # # #   # #   #   #   #   # #           # # #       #     # # #
### ####### # ### # ### # ##### ### ### # # ########### ### # ##### ##### # # #
#     #     # # # # # # #       # #     # #       #   #     #     #       # # #
# ##### ### # # # # # ####### ### ####### # ### ### ####### ### # ### ####### #
#   #   # # # # #   #     #   #       #   #   # #   #       # # # #   #       #
### # ### # # # ### ### # # ### ##### # ### # ### # ### # # # ### ##### # ### #
#   # #     #   #   # # # # #     #     #   # #   #   # # #     # #   # # #   #
# ### ##### ### # ### ### ######### ##### ### ### ### # # ##### ### # ##### # #
# #   #   #     #     #             #     #   #     #   #   #     # #       # #
# # ### # ######################### # ######### ############# ### # ##### ### #
# #   # #     #                     #     # #       #       # #   #     # #   #
# ### # ##### # ##### # ################# # ### ##### ##### ### ### # ### # ###
#     # #     #     # # #   #   # #       #         #   #   #   #   #   # #   #
# ##### # ######### # ##### # # # # ################### # ### ######### ### # #
# #     #   #   #   #         # #   #           #   #   #             # #   # #
# ######### # # # ############# ######### # ##### # # ####### ####### # # ### #
#         #   #               #         # #       #   #           #   # #   # #
###############################################################################
