###############################################################################
#   #     #   #   #   #               #                 #   #     #       #   #
### # ##### # # ##### # ######### ### ####### ####### # # ##### ### ### # # # #
#   #       #         # #     #   #   #     # #       # #   #   #   #   #   # #
# ##### ############# # # # # # # ### ### # ### # ####### # # ##### # # #######
# #   # #     # #   #   # # #   # # #     #   # #         #   #   # # #       #
# # # # ### ### # # ##### # ####### # ####### # # ########### ### # # #########
#   #   #   #     #       #   #     # #     #   # #         #   # # #         #
### ####### ################### ##### # ### ### # ######### ##### ####### ### #
#   #     #       #   #       #       #   #   # #   #   #     # # # #     #   #
####### ######### ### # ##### ########### ### # ### ### # ### # # # # ### # ###
# #   #         # #   # #   #       # # # #       # # # # #       #   #   #   #
# # # ####### ### # ##### ### ####### # ####### ##### # # ######### ### #######
# # #         # # # #       #     # #     #   #   #   # #     #       #       #
# # ##### ##### # # # ##### ### ### ##### # # ### # ### # ### # ####### # ### #
#       #         #     #     # #       #   #   #     # # # # # #     # #   # #
# ##### ####### ######### ### # # ### # ### ### # ### # ### # # # # ##### ### #
# #       #     #         #   # # #   #   #   #   #   #   #   # # # #   # #   #
### ####### ##### ##### # # ### # ####### ### ##### ##### ### # # # # # #######
#   #                 # # #     #     #   # # # #   #   #   # #   #   # # #   #
### # ### ########### ######### ####### # # ### ### # # ### # # ### ### # # # #
# # #   #         #   #         #   #   #   # #   # # # #     #   # #   #   # #
# ############# ### ##### ### ### # ####### # # # # # ### ##### ##### ##### # #
#   #             # # # #   #   # #   #   # #   #   #           #     #   # # #
### # ### ####### ### # ### ### ##### ### # ##### ### ######### # ##### ### ###
#   # #         #   #     #   #   #   #   #   #       #       # #   # # #     #
# # # ####### ##### ### ##### ### # ### ##### ##### ### ############# # # #####
# # # #   #   #   #     #   #   #       # #     #       #   #   #   #   #   # #
# # # # # ##### ### ### # ########### # # ### ### # # ### # ### # # # ##### # #
# #     #   #   # #   # # # #     #   #       #   # #     #   # # # # #     # #
# ####### # # ### ### # # # # # ############# ### # # # ####### # # # ### # # #
# #   #   #   #   #   # #   # #   #           #   # # #         # #       #   #
### ### ####### ### # ### # # ### # ##### # ##### ##### ### ##### ### ### #####
#       #     #   # #   # #     #     #   #   #       # # #       #   # # #   #
# ##### # ##### # # ################### ##### # # ####### ### ##### ### ### # #
# #     # #     # # #       #   #     # #     # #       #   #     # #     # # #
# ####### # ##### # ##### # ### # ### # ### ##### ##### # ### ### ### ### ### #
#         #     #         #   #     #     #       #       #     #     #       #
###############################################################################
