###############################################################################
#     #       #       #     #     #       #     #       #       #   #         #
# ### ### ### # ##### # # # # # ### ##### ##### # ##### # ### # # # # ### ### #
# #       # # #   #   # # # # # #       # #     #   #   # #   # # # # # #   # #
# ####### # # ##### ##### ### # ##### # ### # # # ### ##### ### # # # # ### # #
#   #   #   #           #     #     # #     # #   # #         #   # #   #   # #
### # ### ######################### # ####### # ### ### ########### ##### #####
#   # #   # #       #         #     #   #   # #   #       #   #   #     #     #
# # # # ### ####### ######### ##### ### # ### ##### ####### # ### ##### ##### #
# #   # #       #   #   #   #       # #   # #   #   #       #         # #   # #
# ##### # ##### # ##### ### ### ##### ### # ######### ######### ##### # # ### #
# #     # #     #   # #   #         # #   # #           #     #   #   #   # # #
# ######### # ### # # ### ### ##### # # ### # ##### ### # ####### ### ##### # #
# #         # # # # # # #     #       # #     #       # #       #   #       # #
# # ########### # ### # ##### ### # ### # ##################### ### # ### # # #
#     #     #   # #       # # #   #         #             #   #     #   # # # #
##### ##### # ### # ####### # ####### # # ### ### ####### # ####### ### # ### #
# #       # # # #   #           #     # # #   # #     # # #   # #   # # # #   #
# ####### # # # # # # ### ####### ####### # ### ####### # ### # # ### # # # ###
#       #   # # # # #   #   #   #   #           #     #   #     #   # # #   # #
####### # ### # # ### ##### # ##### # ########### # ####### ####### # # ##### #
# #       #       #   #   # #       #     #       #       #   #   # # #   # # #
# ##### ##### # ####### ### ### ### ### ### # ####### ### ### # # # # ### # # #
#     #     # #   #         #   #   #     # # #     # #       # # # # #   #   #
##### ### # ### ### # ##### ##### ### # # # ### ##### ######### # # # # ### ###
#   #   # #   #     # #       #   #   # #   #   #   # #         # #   # #   # #
# # # ##### ######### # ##### # ### # # # ##### ### # # ######### ### # # ### #
# #             #     # #   # #   # # # #   #   # #   # #       #   # #       #
# ############# # # ### # ######### # # # # # ### # ##### ##### ### # ####### #
#     #     #     # # #       #     # # # #     # #     #   #   #   #     # # #
# ##### ### # ##### # ##### ### # ##### ### ##### ##### ##### # # ####### # # #
#   #   # #     #       #   #   #   #   #   #   # #   #   #   # #         #   #
####### # ##### ####### # ### ##### # ##### ### # ### ### # ### ########### ###
# #     # #     # # # # #   #     # # #   #         #       # # # #   #     # #
# # # ### ##### # # # # ### ### ####### ######### ########### ### # ### ##### #
# # # # # # #     #   #   # # #     #   #     #             # #   #   #       #
# # # # # # # ##### ##### # # ##### # ### ### # ############# # ### # ##### ###
#   #   #           #     # #       #       #                   #   #         #
###############################################################################
