###############################################################################
#                             #     #         #   #   #             #   #   # #
# ##################### # ####### ### ### ### ### # # ### ### # ### # ### # # #
#   # #       #   #     # #           # #   #     # # #   #   # #     #   # # #
# # # # ##### # ### ### ############### ######### # # # ### ######### # ##### #
# # # #   #     #   #   #   #           #       #   #   # # #   #   #   # #   #
# # # # # # ########### # # # ### ####### ##### ### ##### ### ### ####### # # #
# # #   # #   #     # #   #     #   #   # #     #       # #   #   #     #   # #
# ####### ### ##### # ##### ### ### ### # # ##### ####### # # # ### ### ##### #
#       #   #       #     # #   # #   #   #     #     # # # #   # # # #     # #
####### # # ####### ##### # # ### # ##### ##### ##### # # ### ### # # ### # # #
#     # # #   #         #   #   #   #     # # # #           # #   # #   # #   #
# # ##### ### ##### ############# ######### # # ####### ##### # # # # # # #####
# #   # # # #   # # #   #       #     #   #   # # #   # # #   # #     # #     #
# ### # # # ### # ### # # ##### ##### ### # ### # # # # # # ########### ### # #
#   #   # # #   #     # # #   #     #   #       # # #   # #         # # #   # #
### ### # # # ### ### # # ### ##### # ##### ##### # ##### # # ##### # ### ### #
#   # #   # # #   #   #     #       # #   # #   # #   # #   # # #     #   #   #
# ### ##### # # ### ############### # ### # # # # # # # ##### # # ######### ###
# #   #     # #   # #   #   #     # # # #   # #   # #           #   #         #
### ### ### # ### # # # # # # ### # # # # # ##### ### ### ####### # # ####### #
#   #   #   # #   # # #   # # #   #   #   #   # #     #       # # # # # #   # #
# # # ### # # ##### ####### ### ##### ### # ### ##### ### ### # # # # # # # # #
# # # #   # #       #             #       #     # #   # #   # # # #   #   #   #
# ### # ### ### ##### ##### ##### ##### # # ### # # ### # # ### ### ### ##### #
#     #   # #   # #     #   #   #   #   # #   #   #     # #   # # #   #   #   #
# # ##### ### ### ##### # # ### ### # ### # # ### # ######### # # ### ### ### #
# #     #   #       # # # # #           # # # # #       # #   # # #     # #   #
# # ####### # ####### ############### # # # ### ##### # # # ### # # ### # # ###
# # #   #   # #   # # #   #   #     # # # #   #   # # #   # #     #   # # # # #
### # # ### # # ### # # # # # # # # ### ### # # ### ##### ### # ####### # ### #
# # # #   #   #     #   #   #   # #     #   #   #       #   # #     # # # #   #
# # # ### # ##### # ####### ### # # ##### ##### # ##### # # # # # # # # # ### #
#   # #   #     # #         #   # # # #   #   # # #   # # #   # # # #   # #   #
##### ########### ############# # # # ### # ### ##### # # ####### ### ##### ###
#   #     #       #   #       # # # # #   #     #     # # #   #   #   #     # #
# ### # # # ####### # # # ####### ### ####### # # # ### # # # # ##### # ##### #
#     # #   #       #   #                   # #   #   #     # #     #         #
###############################################################################
