###############################################################################
#           # #   #       #         #       #     #       #       #       #   #
######### ### ### ####### # ##### # # ### ### ### ##### # # ##### # ##### # # #
# #     # #   #       #   # # #   # # #   #   # #       #   #   # #     # # # #
# ##### # # # ####### ### # # # ### ### ##### # # ##### ### # # # ##### # ### #
#         # #       #       # #   #   #     #   #     #   # # #     #   #     #
# ####### ######### # ##### # ##### # ##### # # ### ### ### # ####### ####### #
# #     #   #   #   # #         # # # # #     # #   #   #   #   #     #     # #
### # ##### # ### # ##### ### ### ##### ### ######### ### ##### # ##### ### # #
#   #   # #     # #       #   # # # # # #           # #       # # #   #   #   #
##### ### ##### # ### ##### ### # # # # # # ### ### ### ##### ### ### ### # # #
#   #         # #   # #   #     # #       #   # # #   #   # # #   #     # # # #
### ######### # ### # ### # # ### ##### # ##### # # ### ### # # ### ##### ### #
#         # #       # #   # #   #       #     # # #   # #   #   #       # #   #
# ######### ### # ####### ### # # # # ### ### ### ### # # ############# # # ###
#         #     #   #       # #   # # #   # #     #   # # # #     # # #   #   #
# ####### ####### ### # # # # # # # ####### ####### ##### # # ### # # ####### #
# # #   #     #   #   # # #   # # #       # # #     #   # # # # #   #   #   # #
### # ####### ### ### # # # # ### ####### # # ####### # # # # # ####### ### ###
#     #     # #   #   # # # #   # # #   #   #   #     #           #   #       #
##### # ### # ##### ##### # ####### ### ### # ####### # ############# # ##### #
#   #     #   #   # #     #   #         # #   #     # #   #         # # #   # #
# ####### ### ### # ### ##### ### ####### ### ### ### ### # ######### # # # # #
#       # #         #   #           #       #       #   # #   #       # # # # #
# ### # # ### ### ##### ### ####### ####### ########### ### # # ######### # # #
#   # # # #   # #     #   #       #         #     # #   # # # # #   #     #   #
### # # # # ### # ### ##### ### ### # ##### # ### # # ### ### # # # # ####### #
#   # #   #     #   # #     #     # # #   #   #       #     # #   # # #       #
# ### ######### ##### # ############# # # ##### ########### # # ### # ##### ###
#   #   # #     #   # # #               # #   # #   #       # # #   #     # # #
####### # # ##### # # ####### ######### # # ### # # # ####### # # ####### ### #
#     # # #     # # # #     # #   #     #     #   #   # #   # # # #   #   #   #
# ### # # ##### # ### # # # # # # ##### ##### ### # ### # # # # # # # # ### # #
#   #   #     #   #   # # # #   #   #       #   # #     # #   # #   #       # #
# # ######### ##### ### # # ####### # ####### # # ####### # ### ##### ####### #
# #       #       # #   # # #     # #     #   # # #       # #   #   # #   #   #
# ####### # ### ### # ### # ##### # ####### ########### ##### # ### ### # # ###
#       #   #   #     #   #     #     #                       #   #     #     #
###############################################################################
