###############################################################################
#     #           #                     #     #         #     #               #
# ##### ### ##### # ##### ####### ##### ##### # # ######### ####### ####### # #
# #   # #     #   #   # # # # #   #   #       # #         # #     # #       # #
# # # # # ##### ##### # # # # # ### # ##### ############# # ##### ### ####### #
# # #   # #             # #     #   # #       # #         #     # #   # # #   #
# # ### # ############# # ####### ### # ### ### # ############# # # ### # # ###
# # #   # #       # #   #   #     #   # #   #   #     #       # #       #   # #
# # ### ### ##### # # ##### # ######### ### # # ##### # ####### # ####### ### #
#   #     # #     # # #   # #   #     #   # # #       #         #   #   # #   #
# ####### # # # ### # # # # # # ##### ### ### ### ######### ### # # ### # ### #
#   #     # # #   # # # # # # #     #           # #   # #   # #   #   # #   # #
# ######### ##### # # # ##### ##### ### # # ##### ### # # # # ### ### # ### # #
# #   #     #     #   #       #   # #   # # #       # #   # #   # # # #       #
# ### # ##### ### ### # ##### # # # # ####### ####### ##### ### # # ### #######
# #   #     #   #     # # #     # #   # # # #   #     #         # #       #   #
### ##### ##### ######### ######### ### # # ### ### ####### ##### ######### # #
#   #   #     #   #   #       #   # #   #   # #   #             #       #   # #
# ### # ### ##### # # ##### # ### ### # ### # ### ####### ##### ####### # ### #
#     #     #     # # #     #   # #   #   #   # #   # #   #   #   #   #     # #
# ################# ##### ##### # ####### ### # # ### # # # # # ##### #########
#       #   #   # # #   # #   # #           #       #   #   # # #   #         #
######### ##### # # ### # ### # # # ### # # ####### # ### ### ### ##### ##### #
#       # #     # #   #       #   #   # # #       # # # # #   #       # #   # #
# ### # # # ##### ### ### ### ######### # ### # ### # # ### # # ##### # # ### #
#   # #   #       #   # # #   # # #     #   # #       # #   #       # # # #   #
# ### ##### ##### # ### ### ### # # ############# ##### ##### ####### # # ### #
#   #     # #   # #         #       # # #   #     #         #   #     #   # # #
### ####### ### # ####### ########### # # # # # ########### ### ##### ### # # #
# #       # #   #   #   #   #   #     #   # # # #   #   # #         # #   #   #
# ##### # # # # # # ### ### ### ### ##### ##### # # # # # ##### # # ### # ### #
#       #   # #   #   # #     #   #       #   #   #   #   #     # #     #   # #
# # ######### ##### # # # ### ### ####### # # ##### ##### # ### # ####### #####
# #   #     # #   # # #   #   #       #     #         #   # #   #       #     #
# # # # ##### # # ######### ### ##### ### ####### ######### # ############# # #
# # #   #   #   #   #   #     #   #     #     # #       # # #   #     #     # #
### ##### # ##### # # # ######### # ######### # ####### # # ### ### ### # #####
#   #     #       #   #           #                   #   # #     #     #     #
###############################################################################
