###############################################################################
#     #         #   #   #     #       #               #             #   #     #
# ##### ### ### ### # # # ### ##### # # ############# ############# # ### ### #
#     #   #   #     # #   # #       #       #       # # # # #       #     # # #
# ### ### ########### ##### ### ######### ### ##### ### # # # ##### ####### # #
# #   #       #         #   #   #     # #   # #   # # # # # #     #       # # #
### ### ### ### ######### # ##### ### # ### # ### # # # # # ##### ### ### # # #
#   #   # #     #   # #   #     # # #   # #   #   # #   #   #       # #   # # #
# ### ### ##### # # # ####### # ### ### # ####### # ### # ##### ### # ##### # #
#   #     #       #     #   # # #   # # #         #     #   #   #   # #   # # #
# # ### ### ### ######### # ### # # # # ### # ##### # ### # ### # ### # ### # #
# #   #   #   #   #       #     # #   #     # #   # #   # #   # # # # # #   # #
##### ### ### ### # ### # ####### ##### ### ### # ##### ##### # # # ### ### # #
#   # #   # # # #   # # #     #         #   #   # # # #         #   #   #   # #
# # # # ### # # ### # # ##### # ########### # ##### # ############# # ### ### #
# # # # #         #   #   #   #       #     #       #           #   #   #     #
# # # # # ####### ### ############### ### # ##### ########### # ### ### ### # #
# #   # # #     #   #   # #     #     # # #     # #         # # #   #   #   # #
# ##### ### ### # ####### ##### ### ### # ##### # # # ### ##### # ### ### #####
#     #     # # #   #   #   #     # #   # #   #   # # #         #   #     # # #
##### ####### # ##### ### ### ####### # # # # ### # ### # ####### # # ##### # #
#   # #       #     #     #   # #     #   # #   # # #   #   #   # # #       # #
# # # # ########### # ##### ### # ####### # ### # # ### ### ### # ##### ### # #
# # # # #   #     # # #     # #     # # # # # # # #   #   #   # #       # #   #
# ### # # # ##### # # # ### # ####### # # # # ### ### ### ### # ##### # # # # #
# #   #   # #   # #   # #   #     #       # #     #     # # #     #   # #   # #
# # # # ### ### # ### # # ####### # ####### ##### ##### ### ##### ##### ### # #
#   # # #       # # # # #       #       #             #     # # # #       # # #
# ##### # ### ### # # # ######### ##### ##### # ##### ### # # # # # ### # # ###
#     # # #   #   #   #     #   # #   # #     # #   #   # #   #     #   # # # #
# ### # # ##### ### ### ### # # # ### # ### ### ### ### ####### ####### ##### #
# #   # #       #   #   #   # # # #   #   # # #   #   #   #   # # #   # # # # #
# ##### ### ############# ### # ### ##### # # ### ### ### ### # # # # # # # # #
#   #   # # #     #     # #   #   #       #   #     #   #     # #   #   #     #
### # ### # # ##### ### # # ##### ### ####### ####### ####### # # ### ### ### #
#   #     #       #   # #   #   #     #     #     #     #     # # #       # # #
# ### ### ##### ##### # ### ### ##### ### # ##### ##### # ######### ### ### # #
#     #       #       #             #     #   #     #               #       # #
###############################################################################
