###############################################################################
#                 #   #     #             #     #         #       #           #
# ##### ######### # # # ##### ######### # # ### # ##### # ##### # # ### ##### #
#     #       #     #   #     #   # #   # #   # #   # # #   #   # #   #   #   #
### # ##### ################# # # # # # # ### # # ### # ### # # # ####### # ###
# # #     # #   # #   #   # #   # # # # #     # # # # # # # # # #     #   # # #
# # ### ### # # # # ### ### ##### # # ####### ##### # # # # # # ##### # # # # #
# #   #   # # #                   # #     #         # # #     #     #   # # # #
# # ##### ### ##################### # ### ########### # # # ##### ####### # # #
# #     #         #             #       #   # #       # # #   # # #   #   #   #
# ### # # ####### # ####### ### # ### ##### # # ####### # ##### # # ### #######
#     # #     # #   #       #   # #   #   #       # #   #       # # # # #     #
# # ##### # ### ##### ####### ### ##### # ####### # # ########### # # # # # ###
# #   #   #   #   #   #     # #   #     # #           #         #   #   # #   #
### # ######### ### # ##### ### ### ##### # ####### # # ##### # ### ######### #
#   # #       #     # #   # #       #   # #   #   # # #     # # # #         # #
# ### # ##### ######### # # # # ### # ####### # # ### ##### # ### ######### # #
# #     #   #     #     # #   # #         #   # # #     #   #       #     #   #
# # ##### ####### # ######### ### ####### # ##### # ##### ### # ### # ### ### #
# #     #   #     #           # # #   #   # #   #   # #   #   #   # #   #   # #
# # ### # # ############### ### # # # ### # # # ### # # ######### ##### # # # #
# # #   # # #             # #       #   # #   #   #   #         #     # # #   #
# ##### # # ##### # ######### ######### # ################### ### ### # ##### #
#     #   # #   # # #   #   #         # #   #   #   #         #   # #   #   # #
# ########### # # ##### # # ### ##### # ### # ### # # ####### # ### ##### # # #
#             # #         # # #   # # #   #       # #   #   # # #         # # #
# ######### ### # ### ##### # # ### # ### # ##### # ##### # ### # ######### # #
#     # #   # # #   # #   # #     # # #   #     # #     # #   # #       #   # #
##### # ##### # ##### # # # ##### # ### ####### ####### # ### # ####### # # # #
#       # #   # #   # # # #       #   # #       #   # #   #   #   #     # # # #
# ####### # # # # # ### # ########### # ####### # # # ### # ####### ##### ### #
# # #   # # # #   #     #     #     # #       #   # # #   # #       #   # #   #
# # ### # # ##### # ### # ### # ### # ### ########### # ##### ####### # ### # #
#       # #     # # #   # # # #   #   #   #   #       #   # # #   #   #     # #
### ##### ##### # ######### ### # ####### # # # # ####### # # # # # ######### #
# #   #         # #       #     #   #   # # #   #       #   # # #   #   #     #
# # # # ### ##### ### ### ######### # # # # ########### ### # ### ### # # #####
#   #   #   #           #           # #   #           #     #     #   #       #
###############################################################################
