###############################################################################
#   #     # #     #       #           #       #       #   #       #     #     #
# # # ### # ### # ### # ####### ### ##### ##### ### ### ### ##### # # # # # ###
# #   # #   #   #   # #   #   # #   #   #       #     #   # # # # # # # # #   #
####### ### ### ### # ### ### ### ##### ######### ##### ##### # # ### ### ### #
#       #   # #   # #   #     #     #             #     #       # #     #   # #
# ##### # ### ##### ### # ##### ### # ############# ##### ####### # ### ##### #
# # #   #   # #   # #   # #     #     #     # #                   # #     # # #
# # # ##### # # # # # ### # ### # ##### ##### # ####### ####### ### ##### # # #
#   #     # # # # #   #     # # # #       # # # #   #   #     #   #     #   # #
### ##### # # # ####### ##### # # ####### # # ### ### ### # ##### # ### ##### #
#   #       # #       #       # #   #   # #       #       #     #   #       # #
# ##### ### # ####### ##### ### ####### # # ####### # ### ################# # #
# #   #   # #             # #     # # #           # #   # #         #   # # # #
# # ##### # # # # # ##### # ##### # # # ##### # # # ####### # ##### # # # # # #
# #     # # # # # # #   # # #   # # #   #   # # #           # #   #   # # # # #
# ### # # ### # ####### # ##### # # # # ### # # ##### # ##### # ####### # # # #
#   # # #     # #     # #   #   #     #     # #   #   # #   # #     #     #   #
### # # ####### ##### # ### # # ### # ####### ##### # # # # # ### # # #########
# #   #       # #   # #   #   # #   # # #     # #   # # # # #     # #     #   #
# # ##### ##### ### # # ##### ### ##### # ##### # ####### ##### # ####### # ###
#     # # #   #   # # #           #   # # #               #     #     # # #   #
# ##### # # ####### # # ########### # # # ####### ##### ####### # # # # ##### #
#       # #   #     # # #           # #         #     # #     # # # #   #     #
########### ### # ### ############# ##### # ### ##### ##### # ##### # # # #####
#   #       #   #   #   #         # #     # # #   #         # # #   # # #     #
# # # # ##### ### # ### # # ####### # ####### ##### ########### # ##### # #####
# #   #       #   #   # # #           #   #             #   #     #   #     # #
# ################### # # ########### # ####### # ######### # ##### # ##### # #
#   #       #   #   # #   #           #       # #         #         #   # # # #
# # # ### ### # # # # ########### ### # ### # ####### ### # ##### ##### # # # #
# #   # #   # # # # #   #     #   #   # #   #         #   # #   # # #   # # # #
# ##### ### # # # ##### # # # ##### ### ### ####### # ####### # # # ##### # # #
#   #     # # # #   #     # #     # #   #   #     # #   #     # #   #     # # #
### # ### # ### # # # ##### # ##### # ######### # # ### ### ### # ### # ### # #
# # # # # # #   # # # #     #   #   #     # # # #     #   #   #   # # #     # #
# # # # # # # # ### # # ### ### # ####### # # # ### # ####### ##### # ####### #
#       # #   #     # #   #   #         #     #   # #     #       #           #
###############################################################################
