###############################################################################
# #     # # # #   #     #   # # #           #   #   #               #       # #
# ### ### # # # ### ### # # # # # ##### # ### ##### ############# ### # ### # #
#   # # # # # # #   # #   #     # #   # # #     # # #   #     #   #   # #   # #
# ### # # # # # ### # ##### ##### # # ### # ##### # # ####### # # # ##### ### #
#   #       #   # # #     # # # #   # #   #     #             # # # #     #   #
# # ####### # # # ####### # # # ##### ##### ### # ############# # ### ### ### #
# # #         #     # #   #   # #     #     #   #               #   #   # # # #
# ### ### ### ##### # ### ### # # ##### ########### ### ##### # ##### # ### # #
#     # # #   #               # # # #   # #   #     #   #   # # #   # # #     #
# ### # ######### ##### ####### # # # ### ### ####### ### # ### # # ### # ### #
#   # #         # #   # #   #       #   # #           #   # #   # # #   # #   #
# # ### ### ### # ### # # ##### ####### # # ##### ####### # ##### # # ### # # #
# #   # # # # #       #         # #   # #   # # #     #   #       #   #   # # #
### ##### # # ### # ##### ####### # # # # ### # # ##### ############### ### # #
#     #   #   #   # #   # #         # # # #   #       #           #     #   # #
# ##### ##### ### ##### # # # ######### # ### # # ### # ####### # # ##### ### #
#   # # #       #   # #     # #     #   # #   # # #   # #     # # # #   #   # #
# # # # # ####### # # ### ##### ##### # ##### # ### ### # ### ##### # # ### # #
# # # # # #     # # # #     #   # #   #       #   #     # #   # #   # #   # # #
# # # # ####### # ### ##### # ### # ############# ##### # # ### # ### ### # # #
# #       #   #   #   #     #   #   #         #       #   # #   #     #   # # #
# ####### # ####### # # ### ### # ### ##### # # ############# # ####### ##### #
#   # # # # #   #   #   #       # # # #     # # # #       #   #   #     # #   #
# ### # # # # # # ### # ##### ### # # ##### # # # # ####### ### ### ##### #####
# # #   # #   #   #   # #                 # #       #       #       #     #   #
# # # ####### # # # ####### ### # # ##### # ####### # # ########### # ### ### #
#   # #       # # # #     # #   # # #   # #   # # #   #   #       # # #     # #
##### # # # ##### # # # ### ##### ### # ##### # # ### # # ####### ### # ##### #
#     # # # #     # # # #     #       #     # # # #   # # #     # # # # #     #
# ####### ### # ##### ### ##### # ### ##### ### # # ##### ##### # # # # ##### #
#       # #   # #   #     #     # #   #   # #   # #     # # #   # # # #       #
# ### # # # # ##### ### ######### # ### # # # ### ##### # # # ### # # #########
# #   #   # #     #   #   #   #   #     # #   #     #   #           #         #
# # ##### # ##### # # ### # # ######### ##### ### ### ######### ####### ##### #
# # #   # # #   # # #   # # #         # # #   #   #       #   # #     # #   # #
# ### ### ##### ####### # # ####### # # # # ### ####### # # ### ### # # # ### #
# #                   #   # #       #   #         #     #   #       #   #     #
###############################################################################
