###############################################################################
#       #     #       #   #       #   #   #             #     #           #   #
# ##### # # # ####### # ### ##### # # # # # ####### ##### # ### ######### # # #
#   #   # # # # #   #   # # #   # # #   # # # #   #       # # #   # #     # # #
### # # # # # # # # ### # # # # # # ##### # # # # ######### # ##### # ##### # #
#   # # # # #   # # #   #   # # #       #   #   #   #     #   #     # #     # #
# ### ### # ##### # # ##### # # ########### # ### ##### ########### # # #######
#   #     #       # # # # #   # #       #   # # # #     #     #   #   #       #
### ########### ### # # # ### ### ##### # ### # # # ######### # # ### ####### #
# #   #         #         #   #   #     #   # #   #   #     # # #   #   # #   #
# ### # ##### ########### ##### ### ##### # # ##### # # ### # # ####### # # # #
#     # # #     #   #   #         # # # # # #   #   # # # # #   #       #   # #
####### # ####### ##### # # ##### # # # # # # # # ##### # ### # # ######### # #
#         #     #     # # # #     #       # # # # #     #     #     #   # # # #
# ####### ##### ##### # # # # ############# ### # # # ### ##### ##### # # ### #
# # #   # #     #   #     # #     #           #     # #   # #   #     #       #
# # # # # ### ##### ######### ### ####### ##### ####### ### # ### ########### #
#   # #       # # #   #       #   #     #       # # # #     #         #     # #
# ### ### ##### # ### ######### ##### ####### # # # # ### ########### # ### ###
# #   #     #   # # # #             # #       #     #     # #       #   # #   #
# ##### ### # # # # # ####### ####### # # # # ### ### ### # # ##### ##### ### #
#   #   # # # # #   #     #   # #       # # # #       #     # # #     #     # #
### # ### ### # # # ### ### ### ####### # ### ### # ### ### # # ####### ### # #
#   #     #   #   #       # #     #     #   # # # # #   #   #   #         # # #
# ##### ### ### ######### # # ##### ####### # # # # # ##### # # # # ##### # ###
# #     #   #   #   #       #       #       #   # # #     #   # # #   #   # # #
# ################# # ####### ##### ####### # # # ####### ####### ### # # ### #
#       #         #     # #   #     # #   # # # #     # #           # # #     #
##### # ##### # ##### # # # ### # ### ### ### ####### # ####### # # # # ##### #
#   # #   #   # #     # # #   # # # #       #   #     # #       # # # #   #   #
### # ### # ##### ##### # ##### ### ### ##### # # ##### # ### # # # # ##### ###
#   # #   # #   # #   # #     #     # #   #   # #       # #   # # # #   # #   #
# ### # ### # # # # # # ### # ### # # ### # # ####### ####### # ####### # # # #
#   # #   #   # # # # #   # #     # #   #   # # #   # #     # #     #   # # # #
### ##### # ### # ### ### ##### # # # # ##### # ### # # ##### # # ### ### ### #
#     #   #   # #       # #   # # # # # #     #     # #   #   # # # # #     # #
# ##### ##### # ####### ##### ### # # ####### ### ### ### # ### ### # # ### # #
#       #     #             #     #         #   #       #   #   #     #   #   #
###############################################################################
