###############################################################################
#   #   #     #       #     #   # #       #       #   #             #     #   #
# # ### # ##### ### ##### ### # # # ### # ### ### # # # ##### ##### # ### # # #
# #     #     # #         #   # #   #   #     #   # #   #   # #   # #   # # # #
# # ####### ### # ############# ##### ######### ### ##### # ##### # ### ### ###
# # #     #   # # #   # # #     # #     #           # #   #   #   # #   #     #
# # # ### # # # # # # # # ### ### ### # ############# # ### ### # # # ####### #
# # #   #   # # #   #   # #     #     #       #   #   #   #     # # # # #     #
# # ### ##### # ### ##### # # # ####### ### ##### # ##### # ### ### # # # #####
# #     #   #   # #         # #       #   #     #   #   # #   # #   # # # #   #
# ####### ####### ### ####### ### ### ### ##### # ### # # # # ### ### # # # # #
# # #     #   # #   #   #   # #     #   #   # #   #   #   # #         #   # # #
# # # ### # # # # ##### # ######### ### ### # ##### ########### # ##### ##### #
# #     # # #   #                 # #       #   #   #   #     # #   # #     # #
### ##### ### # # ### ############# # # # ### # ##### ####### ##### # # ### # #
#   # #     # #   # # #           # # # #     # #   # #     #             # # #
# ### ####### # ### # # ######### # # # ######### # # # ### ##### ######### # #
#     #     # #   #     #     # # # # #     # #   # # #   # #   #         #   #
# ##### ### ### # # ##### ##### # # ####### # # ### # # ### ### # ####### ### #
#   #   #     # # #       #     # #       #       #   #   #     #   # # # #   #
### # ### ### # # ### ##### ######### ### ######### # ### ######### # # # ### #
#   # #     #   # # #       #       #   # #       # # # #       #   # #   # # #
# ### ########### # ##### ### ######### ### ##### # # # ####### # ### ### # # #
#   #       #   #       #       #     # #     #   # # #       #   #     # # # #
### # ### # ### # ############# # ### # # # ### ### # ### # ####### # ### # # #
# # #   # #     # #         #   #   # # # # #   # # #   # # #     # #   # # # #
# # # # ####### ### ##### ##### ### ### ##### # # # ### ### # ### # ### ### # #
#     # # #     #   #   # # # # # #     #     # # # # # #   #   #   #   #   # #
####### # # # ### ### ##### # # # ##### # ####### # # ### # # # ####### # # # #
#   #   #   #     #       #   # #   #   # #     #   #     # # # #     # # #   #
# ##### # # ### ### # ### # ##### # # ### # ### # ### ####### # ##### # # #####
# # #   # # #       #   #       # #   #   # #   #     #   #   # #     #   #   #
# # # # # ### ####### ### ########### # # # # ### ##### ### ##### ########### #
#     # # #         # #   # #     #     #   # #         #   #   # #   #     # #
####### ########### # # ### # ### ########### # ### ##### ### # # # # # ### # #
#     #   #   #   # # # #   #   #         #   # #       #     # # # # # # # # #
##### ### # ### # ### # ### ### ### ####### ### ####### ####### # # # # # # # #
#         #     #     #   #       #         #     #           #     #   #     #
###############################################################################
