###############################################################################
#       #   #       #       #   #     #           #   # # #   # #       #     #
# # ##### # # ### ### ##### ### ### ######### ##### ### # # # # ####### # ### #
# # # #   #   #   #   #   #       # #   #     # #     #   # # #   #   # #   # #
### # ######### ### ### # # # ##### # ### ### # # ### # ### ##### # # # # # ###
#   #       #   #   # # #   # #     #   #   # # # # # # # #   #   # #   # #   #
# ######### # ### ### # ##### ##### ### ##### # # # # # # ### # # # ######### #
#         # # #   #   # #   # #             # #     #   #     # #   #         #
######### # # # ### # # ### # # ### ### ### # ######### ### ### ##### ##### # #
#       #     #     # #     # # # # #   # #   # #     #     #   #   # # #   # #
# ##### ##### ### # ####### # # # # # ### ##### ##### # ##### ### ### # ### # #
#     #     # #   # #       # # # # #     #       #     # # # # # #   #   # # #
# ### ##### # # ############# # # # ######### ### # ##### # # # # # # # ### # #
# # # # #   #   #       #   #   #   #     #   # #             # # # # #   # # #
# # # # # # ##### ##### # # ##### # # ####### # ### ### ####### # # ### # # ###
# #   #   #       #       #   #   # #     #   #   #   # # #     #     # # # # #
# ### # ######### ####### ### # ### ##### ### ### ### # # # # ##### # # ### # #
#   # #         #   #     #     # #   #   # #     #   # # # #     # #     # # #
### # ######### # # ### ### ### # ### ### # ### ### ##### # ##### # ##### # # #
# # #     #   # # # # #   #   #   #   # #   #   #       # #   #     #     #   #
# # ##### # # ### # # ### # ####### ### # ### # # # ##### # # ####### ### #####
# #     # # # #   # #     # #     # #   # #   # # # #     # #     # # # # #   #
# ##### ### # ##### # ##### ##### # # ### ### ### ##### # # ##### # ### ### ###
#     # #   #       #     # #           #     #       # # # #   #       #     #
# ####### ### ### ####### # # ### ##### ####### ##### ### # # ### # ##### ### #
#       # # # # #   #     # #   # #   #       # #       #     #   # #     #   #
# ##### # # ### ### # ##### ####### ######### # ##### # # # ### ##### ### ### #
# #     # # #       # #     #     # #         # #   # #   # #   # #   #     # #
# # ### # # # ####### # ##### # # # # # ####### ### # # ##### # # # ### ### ###
# # #   # # #     #   #   #   # #   # # #       # # # # # # # # # #   #   #   #
# # # ### # ##### # ##### ##### ####### # ####### # # ### # # # # # # ### # ###
# # # # #   #     # #   #       # #   #     #   # #   # # #   # #   #   # #   #
### # # # ### ##### # # ######### ### # # ##### # # ### # # ### ####### # ### #
#   #   #   # #   #   #           # #   #   #   # #   #   #   # #   # # #   # #
# ######### # # # ############### # ##### # # ### # # # ######### ### ### # ###
#   #   #   # # #       #       # # # #   # #     # # #   #     #         #   #
# # # # # ### ### ### ### # ##### # # # ### # ##### # # # # ### # ########### #
# #   #     #   #   #     #         #   #   #       #   #   #     #           #
###############################################################################
