###############################################################################
#     #   #                 #     #   #       #                 # #   #   #   #
# ### # # # ### # # ####### # ### # # ### ### # ####### ##### # # # ### # ### #
#   #   # #   # # # #     # # #     #       # #   #     # #   #       # # #   #
### # ####### ### # # # # # # # ##### ### # # ### # ##### ######### ### ### # #
#   #   #     #   # # # # #   #     # # # # #     #     #   #             # # #
####### ### ##### ### # ####### ### ### # ### ##### ### # # # # ######### # ###
#     #   #     # #   #   #     #     #   #       #   # # # # #     #   # #   #
# ### ### ### ### # ##### ##### ### # # # ####### ### ##### ### ### # ### ### #
#   #     # # #   # # #       # # # # # #   # # #   # #     #   #   #         #
##### ##### ### ### # ##### ### # ### ### # # # ### # ### ####### # # ####### #
# #   #       #   #   #   #     # # # # # # # #     #   #       # # #   #     #
# ### ####### ### ####### # ##### # # # ### # # ####### ### ### # ####### # ###
#     #   #     # #     #   #     # #     # #   #         # #   # # #     #   #
### ##### # ### # ### # # ### # ### ### ################### # ### # # #########
#       #   #   # #   #       #   # #   # #   #       #     #   # #   #       #
# ####### ### ##### # ### ####### # # ### # ##### ### ######### # # ####### # #
#         # # # #   #   #     #     #   # #     # #           # # #       # # #
### ####### ### # # ##### # ### ####### # # ### # # ######### # ######### ### #
# #     #       # #     # # # # #     #   # #     #         #   #     #       #
# ##### ##### ### ##### ### # # # ### ##### ############### ### # ### ####### #
#             #   #     #   #     #     #   #   #   #         #   #     #   # #
########### ####### # ####### ########### ### ### # # ################# # # # #
#     #           # #   #               #   #     # # # #         #     # # # #
# ### ### # # # # ### # ########### # # # # ### ##### # # # ##### # ##### # # #
# # #     # # # # #   #         #   # #   #   #     # # # #   # # #   # # #   #
# # ##### ##### ##### ####### ### ##### ##### # ##### # # # ### # ### # # #####
#   #     #           #   #   # #   # # #       #   # #   # #   # #   # # #   #
####################### # ### # ### # ### ####### # # ##### ### ### ### # # # #
#     #     #           # #       # #   #   #   # # # #       #   # #   # # # #
# # ### # # # ########### # ##### # # ##### # # # # # # # ### # ##### # # # # #
# # #   # #   #   # #   #   #   # #   #   #   # # # #   # #   #     # # #   # #
# # # ### ##### ### ### ### # # # ### ### ##### # ######### ##### ### # ##### #
# # # # # #   #       #   # # # # #     #     #     #       #   # #   #   #   #
# # # # ### # ### ####### ### ##### ### # ### ########### ### # # # ##### # ###
# #   #   # #   #             #     #   # #   #       #   #   #   # #   # # # #
# ##### # ##### ####### # ### # ##### ### # ##### ##### ### ####### # # # # # #
#       #             # #   #       #     #         #   #             # #     #
###############################################################################
