###############################################################################
#                   #               #     #   #       # #   #     #   # #     #
# ####### ######### # ############# # # ### # # ##### # # # ### # ### # ### # #
# #     # #   #     #   #       # # # #     # # #         #   # # #   #   # # #
# # ### # # # ######### ### ### # # # ####### # # ######### ### # # ##### # ###
# #   #   # # #       #   # # # # # #   #   # # # #     #       #   #       # #
# ### ##### # # ### ##### # # ### # # # # ### # # # ##### ########### ### ### #
#   #       # # # #   # #   #   # # # #   #   # # #     #     #     # #   #   #
# ####### ### # # ### # ### # # # # ####### ### ### ### ##### ### # # ####### #
# #       # # #   # # #     # #   # #     #   # # # # # #   #   # # # #       #
### ####### # # # # # ### ### ##### ### ### # # # ### # ### ### # # # # #######
#   #     #   # #   #   #     #   # #     # #         # # #   #   # # #       #
# ### ##### ### ### ### ####### # # # ### ######### ### # # # ##### # # ##### #
#   # #     #   # # # # #       #   #   # # #       #     # #     # # # #     #
### # # ##### ### # # # # ####### ##### # # ######### ########### # # ### #####
# # #     #       # #   # #       #     #   #         #   #     # # # #   #   #
# # ####### ####### ### # ####### # # ### ### ######### ### ### # # # # ### # #
# #         #       #   # #     #   #   # #           #       #   #   #     # #
# ############# ##### ### ##### ### ##### # # ####### ### ########### ####### #
#         #       #         #   #   #   #   # # # #   #     # # #     #     # #
### # ##### ######### ####### ####### # ##### # # # # # ##### # # ##### # ### #
#   # #     #         # #   #     # # #       #     #   #           #   #     #
# ### # ############# # # # ##### # ##### ##### ####### # ### ##### # ####### #
# #   #   #     # #   #   #       #     # #     #     #   # #   # # # #     # #
# # ##### # ### # # ### ######### ### ########### ### ##### ### # ##### ### # #
# #   # # # #   # # #     #   #   #     #         #     #               #   # #
# ##### # # # ### # ##### ### # ### ### # ####### # ### ####### ######### ### #
# #   # #   # #   #   #       # # # #     # #     # # #             #   #   # #
# # # # ####### ############### # # # ##### ### ##### ##### # ##### # # ### # #
#   #   #     #       #   #     # # # # # #       #   #     #     # # #   #   #
# ##### # # # ##### ### # # # ### # # # # ######### # # ### ### ### # ### #####
# #   # # # #       #   # # #   # # # #     #   #   #   # #   # #   # #   #   #
# ### # # # ##### ####### # ### # # # ##### # ### ####### # # ### # # # # ### #
#   # # # # #   # #     #   #   #   #   #   #   #     #   # # # # #   # #     #
### # # ### # # ### ### ##### ### ### ### # # ####### # ### # # ####### # #####
#   # #   #   #     # # #   #     # # #   #       # # # #   #     # #   # #   #
# ### ### # ##### ### # # # ##### # # # # ### ##### # # # # # ### # ##### # ###
#       #     #   #       #       #   # # #           #   # # #         #     #
###############################################################################
