###############################################################################
#                           # #   #         #     #     #     #   #           #
### # ################# # ### # ### ####### # ### ### # # ### # # ### ####### #
#   # #         #   # # #   #     # #     #   #   #   #   # #   #     # # #   #
# ##### ####### # # # ##### ##### # # ######### # # ####### ########### # # ###
#   # #     #   # #       #     # #   #     #   #   #   # # #     # #   #   # #
### # ##### # # # ##### ### ### # ### # ### ### # ### # # # # ### # # # ### # #
# # #     # # # #     #   # # #   #   #   #   # #     # # #   #   #   #     # #
# # ##### ### # # ######### # ##### ### # ### # ####### # ##### # ### ####### #
# #   #       # #     #     # #     # # # # # #   # # #   #     #   #         #
# ### # ### ######### # # ### ### ### ### # # ### # # ### # ####### ######### #
#     #   # #       #   # #         # #   #     # # #   # #     # # #         #
### ##### ### ##### ### # ##### ##### # ##### ### # ### # ##### # # # #########
#     # #     # #       #     #       #     # #   #   #         #   # #     # #
# ##### ####### # ### ### ####### ### # ### # ### ### ### ####### ### # ### # #
#   #       # #   # # #   #     # # # # #   #   #   #   # #   #     # # # # # #
########### # ### # # # ### ### # # # # ### # ##### ### ### # ### # # # # # # #
#       #   # #   #   #   #   # #   #   # # #     #   # # # #   # # #   #   # #
# ##### # ### # # ####### ##### ### # ### # # ####### # # # ### # # ##### # # #
#   # # #   # # # #   #   #       # #   #   # #   # # # #     # # # #   # # # #
##### # # # # # ### # ### # # ##### # ##### ### # # ### # ### # # # ### ### # #
#     # # # #     # #   #   #   #   # #   # #   #   #   # # # #   #   #   # # #
# ##### # # # ### # ### ######### ### # # # # ####### ##### # ########### # # #
#   # # # #   #     #   #           # # #   # #     #     # #   #   #   # # # #
### # # ##### ########### ##### ##### # ##### # ### ##### # ### # # # # # ### #
#               # #       #     #   # #       # #         #   # # #   # #   # #
# ####### ##### # # ####### ##### # ########### # ########### # # ##### # # # #
# #   #   #   # #       #   #     #             # #           # #   # #   #   #
# # ####### # ##### # # # ### ### # ############# ### ### ### ##### # ####### #
#       #   #       # # # # # #   #   #   #         # #   #   #   # #     #   #
####### # # ### ##### ### # # # ####### # ######### # ######### ### # ### # ###
# #       #   # #     # #     #         #       #   # # # #       # #   # # # #
# ##### ##### ####### # # ### ####### ##### ### ##### # # # ##### # ### ### # #
#   #   # #         # # # #     #     # # #   # #     # #       #   #   #   # #
### ##### # ### ### ### # ####### ### # # ### # ##### # ####### ### # # # ### #
#   #   #     # #   # #   #     # # #   # # # #     #     #   # #   # # # #   #
# ### # ### ### ##### # # ##### ### ### # # # ##### # ### # # ### ### ### # # #
#     #       #   #     #       #         #   #         #   #     #         # #
###############################################################################
