###############################################################################
#           # #     #     # #   # #   #   #                   #     # #       #
# ######### # # # # # ### # # # # ### # # ############### ### # ### # # ### # #
# #   #   # # # # #   #   #   #   #     #         # #   #   #   # #   #   # # #
# # # # # # # ### # ######### # ### # ### ####### # # ######### # ### ### #####
# # #   #   # #   #       #   # #   # # # # #   # # #   #     # #   #         #
### # # ##### # ######### # ######### # # # # # ### # # # # ### # # # # ##### #
#   # # #   # # #       #   #     #   # # #   #     # #   #     # #   # #   # #
# ### ### # # # # ##### ##### ### ### # # # ### ##### ########### ##### # ### #
# #       # #   # #   #     # # #   #   #     #   #   #     #   #   # #   #   #
# ######### # ####### ##### # # ################# # ##### # # # ### # ### ### #
# #   #   # #       # #     #     #   #     #   # #       # # #     #   #   # #
# ### # # # # ##### # # # ####### ### # ### # ### ### ##### ####### ### ### # #
# # # # #   # #     #   #     #   #       # # # # # #     #   #     #   # # # #
# # # # ####### # ####### ##### ####### ##### # # # ##### # # # ##### ### # # #
#   # #         # #     # # #     #     # #     #     # # # # # #     # #   # #
### # ########### # ### # # # ### # ##### # ##### ### # # # # ### ### # #######
#   #     #     # #   # # #     #               # #   #   # # #   #   #       #
# ####### ### # ####### # ##### ########### ##### # ### # # # ### # ####### # #
#   #   # #   #     #   #       #     #       #   # # # # # #   # # #   # # # #
### # ### # ####### # # ############# # # # ### ### # # ##### ##### # # # ### #
#     #     #         #     #           # #   #   #     #   # # #   # # #     #
# # ### ##### ######### # ### ######### # ### ### ####### ### # # ### # # #####
# #   # #     # # #     #     #   #   # # # # #     #   #     #     # # #     #
# ### # # ##### # # ########### # # ### # # # # ### # # # ##### ### # # ##### #
# # # # #   #     # #       # # # # #   #   #   # # # #     #   #     # #     #
# # ### ### ##### # ### ### # # # # # ### # ##### # # ####### ######### # #####
# #     # #     #   #   #     # #   #   # # #   #   #           #   # #       #
# # ##### ######### ##### ##### ##### # ##### # ### ### # ####### # # ####### #
#   #     #   #       # #   # # #     #   #   # #   #   # #       #     #     #
####### ### # # ##### # ### # # ####### ### ### # # # # # ##### ######### ### #
# #     #   # #   #   #   # # #           #   # # # # # # # #   #   #   # # # #
# # ##### ### ### # ##### # # # ### # ####### # ### # ### # # ### # # # # # # #
#   #       # #   # #     #     #   #         # #   # #   # # #   #   #   # # #
# # # ####### # ####### # # # ##### ########### # ######### # # ########### # #
# # # # #     #     #   # # #   #   # #   # # # #     #       # # #   #     # #
# ### # # ##### ##### ########### ### # ### # # ##### # ######### # # # # ### #
#       #       #                             #     #   #           #   #     #
###############################################################################
