###############################################################################
#   #       #   #         # #           #   #         #           #   #   #   #
# ##### ### # ### # ### # # # ########### # # ####### # ########### # # ### # #
# #     # #       #   # #   #         #   # #       # #           # # # #   # #
# ### ### # # ### # ### ### ### ##### # ### ####### # ### # ##### # # # # ### #
#     #   # #   # # # #   #   #     #     #     #   #   # #   # #   #   # #   #
### ### ### ### # ### ### ### # ######### ### ######### # ### # ####### # # ###
#   #   #   # # # # #   #   #   #   #     #   #       # # #       #   # # #   #
# ### # # ### # # # ### ####### # # # # ####### ##### # # ##### ### # ### # ###
# #   #   #     # #   # #     # # #   #         #   #   #     # #   # #   # # #
# # # ##### ##### # ### ### ### ################### # # ##### # # ### ### # # #
# # #   # # #     #   #       # #       #     #     # #   # # # # #   # # #   #
# ####### # ### # ### # ##### # # ##### # # # # ##### ### # # ### # ### # #####
# #     #   #   #     # # #   #   # # # # # # # #   #   #   # #   # #         #
# ##### ### ### ####### # # ### ### # # ### ### # # ##### # # # ### # ####### #
# #   #   # # #     #   #     # #   # #       #   # #     #   #   # # #       #
# # ##### # # ##### # ##### # ### ### ####### ##### ############# # ### ### ###
#   #   #   #     #       # # # #   #   #   #   #   #   #     #   #   #   # # #
# ### ### # # ### ### ### # # # # # # # # ### ### ### # # ### # ##### # # ### #
#   # #   #   #   # #   # # #   # #   # #     # #     #   # # #     # # #   # #
##### ######### # # # # # # # ##### ### ### ### ########### # # ### # # ### # #
# #   #         # #   # # # # #   # #     #     #   #         #   # # #   # # #
# # ### # ##### ####### ### # ### ### ### ####### ### ####### ### ### ### # # #
# #   # # #   # #   # # #   #   #       #   #   #     # #       # #       #   #
# ### # ### # ### # # ### ### ### ##### ### # ### ##### ##### # ### ######### #
#   #   #   # # # #   #   #     # # #   # #   #     #   #     #   # #       # #
# # ### # ### # # # ### ### ### # # # ### ######### # # # ####### # # # ### ###
# #   #   # # # # #     #   # #     #       #   #     # #       # #   #   #   #
# ### ##### # # # ####### ### ############### # ####### ### ### # ####### #####
# #       #   # #     #   # #                 #     #     #   # # #   # #     #
### ####### ### ##### ##### # ####### ##### ### ######### ##### # # # # ##### #
#   #     #     #     #       #   #   #   #   #       #   # # # #   # #       #
# ##### ##### # ### ### ####### # ### # # ########### # ### # # ##### ##### # #
# #     #     #   # # # #     # #   #   #           # #   # #     #   #     # #
# ### ### ### ####### ### ### # ### # ##### ### ### # ##### ####### ### ##### #
# #       # #       #     #   #   # #   #   # # # # #     # #     #     #     #
# ### ##### # ##### ####### # ### # ##### ### # # ##### # # # ### ### ### #####
#     #           #         #     #       #           # #     #       #       #
###############################################################################
