###############################################################################
#   #   #   #       #         # #     #     #       # #         #     #   # # #
# # # # ### # ####### # ##### # # # ### # ### # ##### ### ### # # ### # # # # #
# #   #   #     #     # #     # # #   # #     #     #   # #   # #   # # # # # #
# ##### ####### # ####### ##### ##### # ########### ### ### ######### # ### # #
#     #   #     # #   #     #   #   # # # #       #   #   #   #             # #
##### ### # ##### # # ##### # ##### # # # # ##### # ##### ### # # ########### #
#   #   # #     # # #     #       # #   #   #     #     #   # # #             #
# ####### ##### ### ##### ### ### # # ##### ########### ### # ##### ### ### # #
#     #   #   #     #       # #   # # #   #     # # #         # # # #     # # #
##### # ##### ####### ##### # ##### # # # # # # # # ### ### ### # # ##### # ###
#     #     #   #   # #   # #   #   # # # # # #   #   # #   #   #   #     #   #
# # ####### # ### # # # # ### ### ##### ### # ##### # # # ### # # ### ### # ###
# # #     #   #   # #   # # # #   #     #   # #     # # #   # #   #   # # # # #
# ### ### # ### ### ##### # # # ##### ### ########### ### ### ####### # # # # #
#   #   # #   # # # #     #   #   # # # #     #     #         #   #   # # # # #
### ### # ### # # # # ### ### ### # # # ### # ##### ########### # # # # ### # #
#       #   # #   #   # # #   #   # # # #   #       #   # #     #   # #   # # #
####### # # # # ####### # # # # ### # # ##### ##### ### # ########### # ### # #
#       # #     #   #     # #     #   #   #   #       # #           #   #   # #
# ########### ### # ############# ### ### # ### # ### # # # ##### # # ##### # #
#       #   # # # # #   #         #   #   # # # # # #     # # # # #   #       #
### ### # # # # # # # # # ##### ### ### # # # ##### ####### # # # ##### ### # #
# # #   # # #     #   # # # # #         #   # #             #   # #     # # # #
# # ##### # ########### # # # ##### ##### ### # ######### # # # ### # ### ### #
#   #   # # #   #     #   # #     # #   # #   #   # # #   # # #   # #       # #
# ### ##### # ### ### ##### ### # # ### ### # ### # # # ### ##### # # # ##### #
#   # #   # #     #     #       #         # # #   # # # # #   #   # # # #     #
### # # # # # ####### ### ######### # ### # # # # # # ### ### ### # # # ##### #
# #   # # # #   #   # #   #       # # # # # # # # #     #     #     # # # #   #
# ####### # ### # # ### ##### ##### ### ### # # ####### ############# # # # ###
#         #   #   # # #       #   #     #   #   #     #           #   # #     #
### ##### ### ##### # ### ### # # # ##### ####### ### ### ####### ### # ##### #
# # #   # #   #     # #   # # # # #     #       #   #   # #     # #   #     # #
# # # # ### ### ##### # ### ### # ##### ####### # # ####### # # # # ####### ###
# #   #     #   #   # # # #     #       #     #   # # #   # # #     # #   #   #
# ######### # # ### # # # ######### # ##### # # # ### # # # # ##### # # ##### #
#             #         #           #       # # #   #   #   #     #     #     #
###############################################################################
