###############################################################################
# # #             #   #                       # #           #             #   #
# # ##### # ##### # ### ######### ########### # ##### # ### ### ######### ### #
# #   #   #   #   #     #     # #           #   #   # # # #   # #       #     #
# ### # ##### # ####### # ### # # ############### # # ### ### ### ##### ##### #
# #     #   # # # #   #   #     #       #   # # # #     # #     # #   # #   # #
# # # # # # ### # # ##### ####### ### # # ### # # ##### # ##### # ### # # # # #
#   # #   # #   # # #   # #       #   #   #     # #     #     #   #   #   #   #
### ######### # # # ### # # ############### ##### ### ### ### ##### ###########
#   #     #   # # #   #   # # #   #         # #     #       # #   #         # #
# ####### # ##### ### ### # # # # ### ##### # ##### ####### # # ### ####### # #
# #   # #   #   #   #   # # #   #         # # #     #   # # #   #   # #     # #
# # ### ##### ##### ### ### ########### # # # # # ##### # ##### # ### ##### # #
#   #   # #     #     #         #     # # # #   # #         # #     # #   #   #
# ### ### ##### ##### ######### # ####### # ##### ##### ### # ##### # # # #####
# # # #       # #   #     #   # # # #     # #     #     #   #       #   #     #
# # # # ##### # # # ##### ### # # # # ####### ####### ### ### ##### # ##### # #
#   # #     # #   #           # #   #       #     # #   # # #   # #   # #   # #
# ### ####### ### ######### ### # # ####### # ### # ##### # ### # ##### # ### #
# #                       #   # # #       # #   #   #     #   # #   #       # #
# # ####### ### ##### ####### # ######### # ##### # # ####### ##### # ####### #
# #   # #     # #   #   #   # # # #           #   # #     #     #   #   #   # #
# # # # ### # # # ##### # ### # # # ######### # # # # ##### ### # ##### # ### #
# # # # # # # # #       #   #     #   #     # # # #     #     # #     # #     #
# ### # # # # # ######### # ##### # ### # # ### # ##### # ### # # ### # ### ###
# #     #   # # #   # #   #     # #   # # # # # #     # # #   # #   # # # #   #
# # ######### ### ### # ####### # # # ### # # # ######### # ### ##### # # ### #
# #       #   # # #   #     # # # # #     # #   # #     # # #   #   #   #     #
# ####### ##### # ### ##### # # # # ####### # # # # # # ### ##### # ####### ###
# #     #   #       #     # # #     #   #   # # #   # #   #       #       #   #
# ##### # # # ### # ##### # # ### # # # # # # # ##### ##### ##### ##### ##### #
#         #   # # #   # #   #     #   # # #   # #   #   # #   # #   # #     # #
######### ##### # ##### ####### # ##### ####### ### ### # ### # ### # ##### # #
# #             # #   #   #     # # # #       #     #   #   # # #   #     # # #
# ####### # ######### # # ####### # # ############### # ### # # # ##### # # # #
#   # #   #     # #     #     #   # # #               #   #   # # #   # # #   #
# # # # ### ### # # ######### ##### # # ######### ####### # ### # # # ### # ###
# #     #   #               #           #         #       #     #   #     #   #
###############################################################################
