###############################################################################
#   #   #     # #         #               #     # #     #             #       #
### # ### # ### # ####### ############# # # ### # # # # ### ######### # #######
# #   # # #   #   # #     #           # #   #   #   # #             # #       #
# # ### # ##### ### # ##### # ##### # # ##### ####### # ####### ### ######### #
#   # # # #   #   #         #     # #   #     #       # #       # # #         #
# ### # # # # ### ######### # ### # ### # ##### ##### # # ### # # # # ####### #
#     #     #             # #   # #   # #       #   # # # #   # # #   # #     #
# # ##### ### # ### ######### ####### # ##### # # ### ##### ##### ##### #######
# # #   #   # #   # #     #   #       # # #   #   #   #   #     #   # #       #
# ### # # # # ####### ### ### ######### # ######### ### # # # # ### # ####### #
#     #   # #   #   # # #   #         # #     #   # #   #   # #       #       #
### # # ### # # # # ### ### ######### ####### ### ### ### ### # ### ### ##### #
#   # #   # # # # #   #   #   #     #     #   #     #   # #   # #   #     #   #
# ####### # # # # ### # # # # # ### # # ### ### ##### # # ####### ####### ### #
#   # #   # # # #   # # #   # #   #   #         # #   # #   #         #     # #
# # # # ##### ##### # # ##### ### ############### # ####### # ######### ### ###
# # #   #   #   #   #   # #     # #     #       # #       # #   # #   #   #   #
# ### ### # # ### ### ### ######### ### # ##### # ##### # # ### # # # ### #####
#   #     # #   # #       #     #     # # # #   #     # # # # # # # #   # #   #
### ### ##### # # ####### # ### # # # ### # # ####### # ##### # # # ### # ### #
#   # # # #   #   #     # #   #   # #     #   #   #   # #   #       # # #   # #
# ### # # # ### ####### # # # ##### ##### # ##### # ### # ### ####### # ### # #
# # #   #   #         # # # # #   # # #   # # #   #     #     #   #   #     # #
# # ##### ####### # ### # # # # # # # ##### # # # ####### ##### # # ### ##### #
#   #     #       #     # # # # #   #       #   # #     # #     #   #   #     #
# ############### ##### # ### # ####### ##### ### # ### # ### # ############# #
# #     #         #   # #     #     # # # #     #   # # #   # #   #     #   # #
### # ##### ### ##### ##### ##### # # ### ##### # ### # ##### ### # # # ### # #
# # # # #   # #     #   # # #   # #   #   #     #     # #       # # # #   # # #
# # # # ### # ##### # # # # ### # ### # ### ##### ##### ##### ### ### ### # # #
# # # #   # #   # # # #   #   # # #   #   # #     #     #   # #   #   # # #   #
# # # ### # ### # # # ##### ### # # ### # # ### ### ####### # # ### ### # ### #
#   #   # # #   #   # # #   #   # # #   # #   # #     #     # #   #     #     #
# # ### # # # # ##### # # ##### # ### ### ### # # ##### # ##### # ### # #######
# # #   #     #     #   # #     #     # # #   # # #     #       #     # # #   #
# # ####### ######### # ##### # # ##### # # ##### ### ############### ### ### #
# #                   #       # #   #       #         #                       #
###############################################################################
