###############################################################################
#       #         #         #   #       #   #       #     #             #     #
# ##### # ### ### # ####### # # # ### ### # # # ### # ### # ########### ### # #
# #     # # #   # #       #   #   #     # # # #   #   #   #       #         # #
# ####### # ##### ####### ######### ### # ### ######### ######### #############
# #             # #     #     #   #   # # # # #         #     #               #
# # # ########### # ### # ### ### ##### # # # ########### ##### ############# #
#   # #   #       # # # #   #     #   # # #   #   #       #   #     #     #   #
### # # ### ####### # # ### # ####### # # # ##### # ####### ####### ### ### ###
#   # #   # #   #   # #   # # #   # #   #     #   #               #   #   #   #
# # # ### # # ### # # ### # ### # # # # ### ### ############# ### ### # ##### #
# # # #   #       #   # # # #   # # # #   #     #   #         # #   #   #     #
# ##### ############# # # # ##### # # ### ### ### # # ######### # ####### # ###
#       #       #     # # #     # #   #   #   #   # # #       # #     #   #   #
##### ### ##### ####### # ##### # ####### ### # # # # ####### # ##### # # #####
# #   #   #   #   #     #       # # #           # #     #     #       # # #   #
# # ### ### ### ### ####### ##### # # # # # ### # ########### # # ##### ### # #
# # #   #         #       # #     #   # # #   # # #   #     # # # #     #   # #
# # # ### ############# # # # ############### # ### # # ##### ### ### ### ### #
#   # #         #     # # #   #   #       #   #   # # #     #           # #   #
# ##### ####### # ##### # ##### # # # ### # ### # # # ### ############# # # ###
# #   #       # #       #     # # # #   # # #   #   #         #   # # #   #   #
# ### ####### # ### ####### ### # # ### ### # ##### ####### ### # # # ####### #
# # #     #   #   #   #     #   # #   #     # #   #       # #   #   #       # #
# # ##### # # ####### ####### ####### ##### # ### # # ### ### ######### # # # #
# #     #   #   #   #         #           # #     # # #   #   #     # # # #   #
# ##### ### ### # # # ### # ### ########### ### ### # # ### ### # ### ### #####
#       #     #   # #   # # #   #     #     #   #   # # #   # # #   #   # #   #
# ### # # ######### ##### # ##### ### ##### ######### # ### # ### # ### # ### #
# #   # # #       #       #       #   #     #       # #   #     # #   # # #   #
# # ####### ##### ########### ####### # ######### ### ### ##### ### # # # # ###
# #     #       #       #   #       # #         # #   # #         # # #   #   #
# ##### # ############# # ####### # # ### # # # # ##### ### ####### # ####### #
#     #   #       #   #   #       # #     # # #   #       # #     # #   #     #
##### ##### ##### # ### ### ######################### ######### # # ### # # # #
#     #     #     # #   #   #   #     #     #     #   #   # #   #   # # # # # #
# ####### ### ##### ##### ##### # ### # ### ### # # # # # # # ####### # ### # #
#         #             #         #     #       #   #   #     #             # #
###############################################################################
