###############################################################################
#     #       #                       #       #       #         #             #
### ### ### # ### ################# # ### ### # ##### # ####### # ### ####### #
#     # #   #     #   #     #     # #     #   # #   # #     # # #   # #   #   #
# ### ######### ##### # ### # # ########### # ### # # ##### # # ### # # # #####
#   # # #       #       # # # #           # # #   # #     # # #   # # # # #   #
### # # ### ##### ##### # ### ##### ########### # # # ##### # # ### # # # # # #
# # #     #       #     #       #         #   # # # #       # #     # # #   # #
# ### # ### # ##### ############# ####### # # # # # ##### ### # ####### ##### #
#     # # # # #   # # #     #   # #       # #   # #     # #   #     #       # #
# # ##### ####### # # # ### # # # ##### ### ##### ### # ##### ##### # ####### #
# #       # # #   #       #   #       # #   #     #   #       #   #     #     #
# ### ##### # # # # # ########### ####### ### ##### # # ######### ####### #####
#   #   #       # # #           # #   #   # #     # # #   #           #       #
# ##### # ####### ### ######### ### ### ### ##### # ##### ### ##### ### ##### #
# #         # #   #           # # #   # #       # #     #   #   #   #   #     #
# ####### ### # # # ### ### # ### ### # ### ########### ### # ####### ### #####
#   #   # # # # #   # #   # #   #     #   #     #     # # # #       # #       #
####### # # # # # ### # # ##### # ### ### ##### ##### ### # ####### # #########
#   #   # #     #   #   # # # # #   #     #   #   #     #   #   #   #   #     #
# # # ### ##### ### # # ### # # ### # ##### # ### # ### # ### ### ##### # ### #
# # #     #   # #   # #       #     #   #   #     #   # # #     # #     # #   #
# # # # ### # ####### ##### ######### # # ######### # ### ##### # ### # ### ###
# # # # # # #   #     #   #   #     # # #       #   #           # #   #   #   #
# # ### # # # ### # ### # ### # ##### # ##### # ### ######### ### # ######### #
# #   # # # #     # #   #   # #   #   #     # # # #     #   # #   # #         #
# # # # # # ####### ####### # ### ######### ### # ##### # ##### # # # ####### #
# # #   # #   #   #         #     #     #   #   #   #   # #     # # # #     # #
# ####### # # # ### ####### # ### ### ### ### ### # ##### # # ### # # # ### ###
#   #   # # # #     #   #   # #   #     #       # #   #   # #   # # #   #   # #
# # # # # # # # ##### ### ### ### # ### ### ### ##### # # # ### # # ##### ### #
# #   #   # # #     #       #   #   #   # #   #     #   # # #   #         #   #
# ##### ####### ### ########### ##### ### ######### # ####### ### ######### # #
# #   # #   #     #   #   #     #   # # # #   #   #   # #     #   #     #   # #
# # # ### # # ######### ### ##### # # # # # # # ####### # ##### ### ### # ### #
# # #     #   #   #       #       # # # # # #   #   #   # # # # #   #   # #   #
# # ############# # ########### ### # # # # # ### # ### # # # # # ### ### # ###
# #             #               #   #       #     #         #     #       #   #
###############################################################################
