###############################################################################
#           #             # #     #     #     #       #       #           #   #
# ####### # # ########### # ### # ### ### # ### ### # # ### # # ##### ### ### #
# # #     # # #         #   #   #   #     #     #   # # #   # # # #   #     # #
### # ##### # # ### # # # ### ########### ####### ### ### ##### # # ####### # #
#   #     # # #   # # # # #         # #   #         #   #     # # #   #   # # #
# ####### ##### # # # ### # ######### ######### ####### ##### # # ### # # # # #
#       # #   # # # #     #   #         #     # # #   #   #   # #   #   # # # #
# ####### # ############# # # # # ####### ### ### # # ### # ### ### ##### # # #
#   #   #   #   # #       # #   #     #   # #       #     #     #         #   #
### # ### ##### # # ### # # # ####### # ### ##################### ######### ###
#   #   #       #   #   #   # #         #   #   #             #   #       #   #
# # # ####### ### ### ### ### ##### ##### ### # # ##### ##### # ######### ### #
# # #       #   # # #   # #       #   #   #   # #   # #     #         #   #   #
# ### ######### ### ### # ##### ####### ### ### # # # ##### ##### ##### ### ###
#   # #       #       # #     # #       #   #   # # #   #   #   # #   # #     #
### # # ##### ####### ### ##### # ####### ### # # # # ### ### ####### # ##### #
#   # #     # #         # #     #   #   #   # # # # #     # #     #   #   #   #
### # # ### ### ####### ### ##### ### # ### # ##### # ##### # ### # ##### # ###
#   # # #     #   #   #     #     #   #   # # # #   # #       #     #     # # #
# ### ### # # # # # ######### ####### ### # # # # ### # ####### ##### ##### # #
#   #     # #   #       #     #     # #   # # #   #   #   #   # # #   #   # # #
### ######### # ##### ####### # ### ### # # # # ########### # # # # ### ### # #
#       # #   #     # # # # #     # #   # # #   #   # #     #       #   #   # #
# ####### # ##### ##### # # ####### # ### # # ### # # ####### ####### ### ### #
# #       # #         # # #   #     # # # # # #   #   # #     #   #     #   # #
# # ### ### ####### ### # ### # ##### # # # ### ##### # # ##### # # ### ### # #
#   #             #     #   #   #     #   #     #   #     #     # #   #   # # #
# ############### ######### # ##### # ####### ##### # ##### ### ##### ### # # #
# #   #   #     #   #       #       # #       # # #   #   #   #     # # # #   #
# # ### ### # ### ### ####### # ####### ####### # # ### # ### ### # # # # # # #
# #   #   # #   #     #       #     #   #       # #   # #   # # # # # # #   # #
# # ### ### ######### # # ##### ### # ### ### ### ### # ### ### # ### # ##### #
# #   #   #     #   #   # #     #   #       # #   #   #   # #   #   # #   #   #
# ### # # ### # # # ### # ### ####### ##### # # ### ##### # # # ### # # # # ###
#   #   #   # # # # #   #   #     #   #     #   #   #     #   # # # # # # #   #
# ### ####### # ### # ##### # ### ### # ######### # # ######### # # # # # ### #
#             #     #   #   #   #     # #         #   #           #   # #     #
###############################################################################
