###############################################################################
#           #               #       #   #         #               #       # # #
# ####### # ##### # # ####### ##### # # ####### ### ### ######### ### # ### # #
#     #   #     # # # #           #   #               # #     #   #   #     # #
##### # ####### ### ### ############# ##### ########### # # # # ### ### # ### #
# #   # #     #   # #   #     #   # # #   #       #     # # #   #   #   # #   #
# ##### ### # ### # ##### ### # # # ##### # ####### # # # ##### # # # ### # # #
#     #   # #   # #   # # #   # # # #   #   # #     # # #   # # # # # #     # #
##### ### # ### ### ### # ##### # # # # ##### # ####### ### # # ### ### ##### #
#   # #   # #     # #   #   #   # #   #       #     #   #   #     # # # #     #
# ### # ##### ### # ### # # # ### ##### ################# ### ##### # # #######
#       #   #   #     # # #     #     #     #   #     #   #     #   # #       #
# # ####### # # ##### # # ####### ### ##### # # # ### ### ####### ### ####### #
# # #     #   # #   # # #   #   # #   #       #   #           #   # #         #
# # ##### ##### # # ### ##### # # # ### ####### ### ######### # ### ### #######
# # #   #   # #   #   #       # # # # # # #   # # # #       #   # #   # # #   #
# # ### ### # ##### ########### ### # ### # # ### # # ### # ### # # ### # # # #
# #   #   # #           #   #   #   #       #     # # #   #   # #   # #     # #
# ### ### # # ### ####### ### ### ########### ### # # # ####### ### # ####### #
#   #     # # # #       #   #                 # #   # #           #           #
### # ##### # # ### ### # # ########### ####### ##### ### # # ####### ### #####
#   #       # # # #   #   #   #       #     #   #   #   # # # #     # # #   # #
# ######### ### # ### ####### # # ### ### # # # # # ### # ######### # # ### # #
#         #   #     #     # #   #   #   # # # # # #     # # #   #     # #     #
### ##### ### ##### ##### # ####### ### ##### # ######### # # # ##### # # #####
# #   #     #     #     # # #   #   # #   #   #           #   #   #   #       #
# ### ########### # ##### # # # # ### ### # ### ### ####### # # # # ### ### # #
#   #       # #   # #     # # # # # #     #   # # #       # # # # # # #   # # #
# ######### # # # # # ##### ### # # # ####### # # ### ##### # # ##### ### #####
#       #     # #   # #   #   # # # #       # #   # #       # # #   #         #
##### ### ##### ### # # ##### # # # ####### ####### ##### ##### # ######### # #
#     #   #   #   # #   #     #   #       #   #         # #   #   #     #   # #
# ##### ### # # ##### ### ######### # ####### # ######### # # ### # ### # #####
#     # #   # # #     #   #     #   #       # #     #     # #   # # # #   #   #
# ### # # ##### # ##### # # # ### ######### # ### # # ### # ### ### # # ### ###
#   #   # #   #   #   # # # # # # # #       #   # #   #     # # # #   #   #   #
### ##### # # ##### # # ### # # # # # ##### # # ####### ##### # # # ##### ### #
#       #   #       #       #     #       #   #               # #   #         #
###############################################################################
