###############################################################################
#       #   #   #         #         #   #           #         # #         #   #
# # # ### # # ### ##### ### # ##### # # # ######### # ####### # # ### ### ### #
# # #     # #     # #     # # #     # #   #     # #   #     #       #   #   # #
# # ### ### # ##### ##### # # # ##### ##### ### # ##### ######### ##### ### # #
# # #   # #   #   #   #     # #   #       #   # # #   #     #     #     #   # #
# # # ### ##### # # # ####### ########### # # ### ### # ### ### ### ####### # #
# # #     # #   # # #         #         # # #         #   # #   # # #       # #
# ####### # # ##### ####### ####### ### # ########### ##### # ### # # ####### #
#     #   #     #   #     #     #   #   # #   # # #   #   #   #     # #       #
### # ######### ### # # ####### # ####### ### # # # ### # ##### ### # ##### # #
#   # #         #   # #   #         #       #           # # #   #   #     # # #
# ### # ### ######### ### # # ##### # ##### # ####### ### # # ############# ###
# #     #   #           # # # # #   #   #   #   #     #   # # #           #   #
### ##### ########### ### # # # # # ### # ##### # # ##### # # ### ####### ### #
#   #   #   #       # # #   #   # #     #       # #     # # #         # #     #
# ### # ##### # ### # # # ##### # ### ### # ### ####### # # ######### # ### ###
#   # #       #   # # # #   #   # # # #   #   # # #   # # #     #       # #   #
### # ######### ### # # ### ##### # # ##### ### # # ##### ##### ######### ### #
#   #     #   # #   #   #   # #     #   #     #   #       #   #     #   # #   #
# ####### # # # # ##### # # # ### ##### # # ############# # # ### # # # # # ###
#   #   # # # # # #   # # #     #     # # #             #   # # # #   #   #   #
### # ##### # ### # # ### ####### ### ######### ### ######### # ##### ####### #
# # #     # #   #   #         #   #       #   # # #       #   #     # #   #   #
# ### # ### # ##################### ######### ### ### ####### ##### # # # # ###
#   # #     #     #       #     #       #     #     # #   #         # # #     #
# # # ######### ### ### # # ### # ####### # ### ### # # # # ######### ####### #
# #           #   # #   # # #         #   #   # #   #   # # #             #   #
# ############### # ### ### ##### ### ### # # # # ### ### ### ### ####### #####
#   #   #       # #   # #   #   #   #     # #   # #   #   # #   #   #     #   #
# # # # # ##### # # # # # ### ### # ################### # # ####### # ##### # #
# #   # # # #   # # # # # # #   # #   #       #       # # #       # #       # #
# ##### # # # ### # # # # # ### ### ### ##### # ##### ### ### ### # ######### #
#   #   #   # #   # # # #   #   #       #   # # # #   # #     #     # #     # #
##### ####### # ### # # ### # ### ######### # ### # # # ##### # ##### # # ### #
#     #   #   #   # # # #   #               # #   # #   #     #   #   # #   # #
# ##### # # # ### # # ### # ### ### ### ##### # ### ############### ### ### # #
#       #   #   #   #     # #   #     #     #   #                         #   #
###############################################################################
