###############################################################################
#       #               #   #         #   #     #   #       #     #     #     #
# ##### # ####### ### ### # # ### ##### # ### ### # # ##### ### # # ### # ### #
#   #   # #     #   # #   #   #         # #   #   # #     #   # #   # #   # # #
### # ### # ### ### ### ### ### ######### # # # # # ### ##### # ##### ##### # #
#   #     # # #   #   #   #   #   #     #   # # # #     #     #   # #       # #
# ##### ### # ### ### ### ### ##### ### ##### # ######### ##### ### # ### ### #
#   #       #     # #   #   #         # #   # #   # #     #       # # # #     #
### ##### ### ##### ### ### ########### # # # ### # # ### # ##### # ### #######
#   # #   #   #     #     # #       #   # # # # #   #   # #   # # # #   #     #
# # # ##### ### # ##### # # # # ##### # # ### # ####### ##### # # # # # # ### #
# # # #     #   #     # # # # # #     # # #   #   #     # #     #   # #     # #
# # # # ##### ##### ### # ##### # ##### # # ##### # ##### # ####### # ##### # #
# #   # #   # #     #   #       # #   # #   #   # #     #   #     #   #     # #
# ##### # ####### ######### ##### # # # ##### # # ### ####### # # ##### ##### #
#     #           #   #     #     # #   #   # #     # #       # # #   #     # #
# ################# ### ##### ####### ##### # ##### # ##### ##### ### # ##### #
# #   #         #       #     #     # #     #   #   #     # #   # #     #   # #
### # # ####### # ####### ### # # ### # # # ### # ####### # # # # # ##### # # #
#   #   #     # #     # # # # # #   # # # # #   #     #   # # # #   #     #   #
# ####### ### ####### # # # # # # ### # # ### ######### ##### # # # # ####### #
#   #     # # #       # #   # # #     # # #       #   #       # # # # #       #
### # ##### # # # ##### ### # ######### # # ##### ### # ### # # ##### # #######
#   # #     #   #     #     #   #       #   #     #   # #   # #   #   #       #
# ### # ### ##### ### ######### # ########### ##### ##### ####### # ######### #
# #   # #     #   #   #   #   # #         #   #   # #   #   #     # #       # #
# # ### # ##### ### ##### # # # ######### ####### # # # # ### ##### # ##### ###
# # #   #     # #   #   # # #         #       #   #   #   #   #     # #   #   #
# # # ##### # # # ### # # # ##### # ### ####### ########### ### ##### # ##### #
#   #     # #   #     # #   #     # #   #       #     #     #   # #   #     # #
######### # ########### ##### ##### # ### ##### # ### # ##### ### # ##### # # #
#     #   # #     #   # #   #     # #   #   # #     #   # # #   #       # # # #
# # ### ### ### # # # # # ####### ##### ### # ########### # ### # ######### # #
# # #   #     # #   #     #     #   #         # #       #         #       # # #
# ########### ### # ##### # # # # # # ##### ### ####### ####### # # ####### # #
# #           #   #     # # # # # #   #     #   #     #     #   # #       # # #
# ############# ### ### ####### # ##### ### # # # ### # # ### ### ### ### # # #
#               #     #             #     #   #     #   #     #       #   #   #
###############################################################################
