###############################################################################
# #   #     #         #       #   # #     # #       #         #   #           #
# # # # ### # ####### # ### # # # # # ### # # ### ### ####### # # # ### ##### #
#   # #   #       #   # #   # # #   # #   #     #   # #     #   #   #   #   # #
##### # ##### ### # # ### ### # ####### # # ####### # # ### ####### ### # # ###
# #   # #     #   # #     #   #       # #   #       # #   #     #     #   #   #
# # ### ##### # ### ####### ### ### ### ##### ##### # ### ##### # ########### #
# #   #   # # # # # #       #   #   #     #   #     # # #   #   #   #     #   #
# # # ### # # # # # # ########### ### # # # ######### # ### ######### ### # # #
# # #       # # # # # #           #   # # #   #   #   #   #     # #   # # # # #
# # ######### # # # # ### ######### ##### ### # # ### # ####### # ### # # # # #
# # #   #     # #   #   # #     #   #       #   #   #     # #   #     # #   # #
# ### # # ##### ####### # # ### ##### ############# ##### # # ### ##### # # # #
#     #   #     # #   #   # # #     # #       #     #       #   # #   #   # # #
########### ##### # # ##### # ### # ##### # ### ##### ####### # ##### # # #####
#   # #     #     # #       #     #   #   # #   #   # #     # #     #   #   # #
# # # # ####### # # ######### ####### # ##### # ### ### ### ####### ### ##### #
# #   #       # # # #   #   # #   #   # # #   #   #     # #     #     #   #   #
# ### ####### # ### ### # # ### # # ### # # ### ##### ### ##### ##### # # ### #
# #         # #     #   # #     #   #     #   # #   # #     #       #   #     #
# ######### # ####### ### ##### ##### # ### # ### # # # ##### ### ### ####### #
#   #       #     # #       #     #   # #   #     #     #     # # #   #       #
### ############# # # # # # ##### # # # ### ########### # ##### # # # ### #####
# #             # #   # # #     # # # #   #     #   #   #     #     #   #     #
# ##### ### ##### ##### # ##### ### # ### ######### ### ##### ### ####### # # #
# #     #       #       # # #     # #   #             #     # #     #   # # # #
# # ##### ##### ######### # # ### # ####### # ### ### ####### ####### # # ### #
# #   #   # #   #   #     #   #   #       # #   # # #           #     #     # #
# ### # ### # ### # ########### # # ### ### ### # # ####################### # #
# #   # #   #     #     #   #   # #   #   # # # #     #       #       #     # #
# # ##### ######### ### ### # ### ### ### # # # ### ### # ####### ##### ##### #
# # #   #     #     # # #   # #   #     # #   # #   #   #     #     #   #   # #
# # # ##### ### ##### # # # # # ####### # ##### ##### ####### # # ### ##### ###
# # #     #   # #         # # #         # #   #   #   #     #   # # #         #
# # # ### ### # ### ### ############# ### # ##### # ### ### ##### # # # # #####
# # #   #   # #   #   # #           # # #   #     #   #   #   #       # # #   #
# # ####### # ### ### # ##### ### ### # ### ############# # ### ####### # # ###
#           #     #   #         #         #             # #       #     #     #
###############################################################################
