###############################################################################
# #           #               #   # #             #     #     #         #     #
# ####### ### ### ########### # # # # ### ####### # ### # # # ##### ######### #
#       #   #           #   #   #     #   # #     # # #   # #     #         # #
##### ### # # # ####### ### ######### # ### # ##### # ##### ############# # # #
#     #   # # #     #   #     #     # # #         # #       #     #       # # #
# ##### ##### ##### ### # ##### ### # # # ########### ####### ### # ######### #
#         #   # #     # # #   #   # # # # #   #         #   # # #   #       # #
# # ##### # ### ####### # # ##### # # # # ### # ######### ### # # ### ##### # #
# #   #   # #   # #     # #     # #   # #   #   #   #   # #   # #   #   #   # #
# # ##### ##### # ##### # ### ### ##### ####### ### # ### # ### # ##### # # # #
# # #     #     #     # #     #     #           #   #   # # #   # #     # #   #
# ### # # # ##### ### # # ######### # ########### ### # # # ### # # ### # #####
# # # # #   # #     # # #       #   #       #         #     #   # # # # # #   #
# # ### ##### # ### ### ### # ### ### # ######### ### ####### ##### # # # # # #
# #   #       # #   #       # #   # # # #   #   #   #       #       #   # # # #
# ### # ### ####### # ####### # ### # ### # # ##### ### ### ### ######### # # #
#   # # #   # #     #     # # #   # #     #         #   #     #         #   # #
# ### # # # # # ####### # # # # # # ### ############# ####### ######### ##### #
#     # # # # #     # # #   # # # #   #     #       #   #     #   #     #   # #
######### # # ##### # # ##### ##### # ### # ##### ### ### ##### ### ##### # # #
#         #       #     #       # # #     # #       # #   #     #   #   # #   #
######### ####### ##### # ##### # ### ### ######### # ### # ##### ### # # #####
#         #         #   # #   # #   # # #           #   # #       #   # #     #
##### ############# # ### ### # # ### # ########### ### ####### ### ######### #
# # # #         #   # #   #     #     #           #   #       #   #         # #
# # # ##### ### ####### ### # # ### # # # ########### ######### ########### # #
#     #     # # #         # # #   # #   #     #   #           #   # #         #
# ####### ### # # ### ##### # ##### ######### # ### ######### ### # ######### #
# #   #   #   #   #   #     # #   # #   #   # #   # # #     #         #     # #
# # ### ##### ##### ########### ### # ##### ### # # # # ####### # # ### ### ###
# #     # #       #         # #     #     #   # # # # #       # # # # # # #   #
# ### # # # ############### # # ### ##### # # # # # # ### ### ### ### # # ### #
# #   # # #                 #   # #       # # # # # #   # #   #   #     #   # #
### ### # ##### ############# ### ######### ### # # # ### # # # ### ####### # #
# # # # #     # #     #       #           #   # #   #     # #   #   # #     # #
# # # # ### ### # ### # ############# ### ### # ##### ##### ##### # # # ##### #
#   #     #     #   #                 #     #   #         #       # #         #
###############################################################################
