###############################################################################
#     #           #     #           #     #               #     #     #       #
##### # ### ##### # ### # ######### ### ### ##### ####### # ### # ##### # ### #
#   # #   # #     # # # #   #     #   # #   #   # # #     # # # #     # # #   #
# ### ### # ##### ### # ### ##### ### # ### # # ### ### ### # # # ### # # # ###
#   #   # # #   #     #   #     #   # # #   # #   # # # #   #   #   #   # #   #
# # ### # # # # ######### ##### # ### # ### # ### # # ### ### ##### ##### ### #
# #       # # # #         #   # #   #   # # # #   #   #   #   #       #   #   #
# ######### # ### ####### # ### ### # ### # ### ### ### ####### ####### #######
# # #     #   #   #         #   #   # #   #   # # #   #     #     #           #
# # # # # ### # ########### # # # ### # ### # # # ### ### # ##### # ######### #
# # # # #     #   #     #   # # #     #   # # #         # #   #   # #   #     #
### # ######### # # ### ##### # ######### ### ######### ##### ##### ### # ### #
#   #   #     # #     # #     # #     # #   #       #   #   #     #   # # #   #
# ##### ##### # # ##### ### ### ### ### ### ####### # ### # ##### ### # ### ###
# #       #   # # #   #     # #   #   #     #       # #   #     # # #   # #   #
# ### ##### ##### # # ####### # # ### ##### ##### # # ### ##### # # ### # ### #
#   # #           # #           #         #       #   # #   #     # #   # #   #
# # # ####### ##### ##### # ####### ##### ##### ####### ### # ##### # ### # # #
# #   #   #   # #     #   #   #   #     # #     #   #       # #     # #   # # #
##### # # # ### # ##### ####### # ### ### # ####### # ######### ##### # # # # #
#       # # # #   #   # # # # # #   # #                 # #   #     # # #   # #
# ####### # # # ##### # # # # # ### ### ### ##### ##### # # # ### # ######### #
# #   #   #   # # #   # # #     #     #   #   # # #   #   # # #   #   #       #
# # # # ##### # # # # # # ### # ####### # ##### # # # ##### ##### ### ### ### #
# # # #     # #   # # # #   # # #       #       #   #       #   #   #   #   # #
# # # ####### ### # # ### # # # # ####### ### ########### ##### ####### ##### #
#   #   # #   #   # # #   # # #   #     # # #     #       # # #   #   #   #   #
# ### # # # ### ### # # ### # ####### ### # ##### # ##### # # ### # # ### # # #
#   # #   # # #   # #   #       #     #         # # # #   #   # #   #   # # # #
##### ### # # ### ####### # ### # ##### ############# # ### ### ##### # # # ###
#     #   #     #   #   # # #   #     #       #       # #           # # #     #
# # ########### ### # ### ### ####### ####### # ### ##### ####### ### # ### # #
# # #   #   # # #   # #   #   #     #   #   # #   #   # #   #   # #   #   # # #
# ### # # # # # # ### # # ####### # ### ### # ####### # ### # ### # ### # ### #
#     #   # #   #   # # #   # #   # #   #   #       # # #   #     #   # #     #
# ######### ### ### # ### # # ##### # ##### # # ##### # # ### ####### # #######
#         #     #   #     #       #           #           #           #       #
###############################################################################
