###############################################################################
#               #     #   #       #           #       #       #     #         #
# ############### ##### # # # ### # ######### # ##### ### ### ### # ### ##### #
# # #   #             # # # # #   #         #   #     #   #   # # #   #   # # #
# # # ### # # ### # # # # ### # ########### ##### ##### ####### # ### ### # # #
#   # #   # # # # # #   #     # # #   # #   #   #       #   #       #     #   #
# ### # ### ### # # ########### # # ### # # # # ### # ### # # # ### ####### ###
#       # #     # # # #         #   #   # # # # #   # #   #   # # #   #       #
##### ### ######### # # ######### ### ### # # # # ### # ####### # ### # #######
#   #   #       # # # # #   #   #   #     #   # #   #   #       #     # #     #
# # ### ####### # ### # ### # # # # ############### ##### ### ####### # # ### #
# #   #     #   #     #       # # #   #     #     # #   #   # #       # # # # #
# ### ### ### ####### # ####### ### # # ### # ### # # # ### # # ### ##### # # #
#   #     #       #   # #   #     # #   #   #   # # # #     # # #   #     # # #
### ####### ####### # ### # ##### # ####### ### # # # ##### # # # # # ##### # #
# #         #       # #   #   # # # #     # #   # # # # #   # # # # # #       #
# ######### # # ##### ####### # # # # ### # # ##### ### ##### ##### # ### #####
#     # #   # #   #   # #     #     #   # #     #   #       # #   # #   # #   #
# # ### ### ### # # ### # ### ######### # ##### # # # # # ### # # ##### # ### #
# # # # #   #   # #       #   #     #   #   #   # # # # # #   # #   #   #   # #
# ### # # ### ### # ########### ##### # ######### # # # ### ### # # # # ### # #
#         # # # # # #         #   #   #   #     # # # #   #     # #   # #   # #
######### # # # # # ######### ### # ##### # ### # # ##### ####### ##### ### # #
#     #     # # # # #         #   #     # #   # # #     #       #   # # #   # #
# # ### ##### # # # # # # ##### # ##### ##### # # ##### ##### # ### # # # ### #
# #     #     # # # # # # #   # # #   #       #   #     #   # #   # # # #   # #
# ##### # ##### # ####### # ### ##### ##### # # ##### ### # # ##### # # ### # #
#     # # # #   #   #     #   #     # # #   # #     #     #     #   # #   #   #
####### # # ### ##### ### ### ##### # # # ######### ########### # ### ### ### #
# #         # # #   #   #   #       # # # #       #   #     #   # #     # #   #
# # # ##### # # # # # ##### ####### # # # # ##### ######### # ### # ##### # ###
# # # #     # #   # # #           # # # #   #     #         # #   #       #   #
# ### # ##### ##### ### # ####### # # # ##### ####### ##### # ##### ######### #
# #   #         #   # # #     #       #     #     # # #     # #     #         #
# # ### ### ### # ### # ##### ############# ##### # # ######### ##### #########
# # #   # #   #   #     #   #   #   #   #     #   # # #         #   #     #   #
# ### ### ### ##### ##### ##### # # # ##### # # # # # # ######### # ##### # # #
#           #       #             #         #   #   #     #       #         # #
###############################################################################
