###############################################################################
#     #       #   #     #   #   #             #           #     #     # #     #
# ##### ####### # # ### # # # # # ### ### ##### ####### # ### # # ### # # ### #
#     # #       #   # # # #   #   #     # #   # #       #   # #   # # #     # #
# ### # # ######### # # ####### ### ##### # # # # ### ##### # ##### ### ##### #
#   # #         # # #   #       #     # #   #   #   # #     #   #       #   # #
##### # ####### # # ### # ############# ####### ####### ####### ######### # # #
#     #   #   # # #   # #   #   #     #     # # #   # #   # #   #       # #   #
# ######### # ### ### # ### # ####### ### # # # # # # # # # # # ####### # ### #
# #         #   # #   # #   #     # #   # #     # # # # # # # #   #     #   # #
# # ##### ##### # # # # ### ### ### ### ####### # # # ### # ##### # ####### # #
#   #     #   # #   # #   #     #   #   #     # # #   #   #       #       # # #
# ##### ### ######### ### ##### # # ### # ### ### # # # # # ########### ### ###
#     # #   #   #   # #   #     # #     # # # # # # #   #   #           #     #
# ### ### ### # # # # # ### ##### ####### # # # # # ####### ### ############# #
#   #   #     #   #   # # # #       #   # #     # # #   #     #         #   # #
####### ### ########### # # ##### # ### # ##### # # # # # ### ##### ### ### # #
#     #   # #         # #       # #     #   #     # # #     #     # #   #   # #
# ### ### # # ### ### # ####### # ##### ##### # ### ##### ########### ### ### #
#   #     # #   #   # #   # #   #     #     # #   # #           #   #         #
### ####### ####### # ### # # ##### ####### ######### ####### # # # ### #######
#   #     # #       #   # # #   # # #     #       #   #     # #   #   # #     #
# ### ### # # ##### ##### # ##### ### # ####### # ##### # # # ### ### # ##### #
#   #   #   # #     #     #     #   # #       # # #     # #     #   #       # #
### ### ### # # ##### ##### ### # ### ##### ### ### # ### ####### ##### # ### #
#   #     # # # #   #       #   # #   #   #   #   # # #       #   #     #     #
# ### ### # # # # # ######### ### # ##### ### ### # ######### # ##### #########
# #   #   # # #   # # #   #       #     # #   #         #   # # #         #   #
# # ### ### # ##### # # # ############# # # ### ### ##### # ############# # ###
# # #   # # # #     # # #             #   #     #   #   # #     #     #   #   #
# # # ### # # ### ### # ########### # ### # ##### ##### # ##### # ### # # ### #
# # # # #   # #   #   #     #     # #   # #   # #             #   # # # #     #
# ### # # # ### ##### # ##### ### # ### ##### # ############# ##### ### ### ###
#   # # # #   # #   #   #   #   #   # #     # # #     #     # # #     # # # # #
# # # # # ### # # # ##### # ### ##### ### ### # # ### # ### # # ##### # # # # #
# # #   #   #   # #   #   #   #       # #   # #   # #   #   #   #     #   #   #
# # ####### ### # ### # # ########### # ### ##### # ##### ### ### ####### #####
# #           #   #     #               #         #               #           #
###############################################################################
