###############################################################################
#         #   #       #   #             #         #     #               #     #
# ####### # # ####### # # # # ######### ######### # ### # ### ####### # ##### #
# #   #     # # #   #   # # #       # #   #       #   # #   # #     # #     # #
# ### # ##### # # # # ### ######### # ### # ### ### # # ### # ##### # # ### # #
# #   # #         # #   # #         #     #   # #   # #   # # #     # # #   # #
# # ### ########### ##### # ######### # ##### # ### # ##### # # # ##### # # # #
#   #   #   #   # #     # #     #     #     # #   # #       # # # #   # # #   #
##### ### # # # # # ### # ##### # ####### # # ########### ### # ### # # # #####
#   #     # # # # #   #     #   # #       # # #         # #   #     # # # #   #
# ##### ### ### # ### ####### ### ######### # # ####### ### ######### ### ### #
#         #     #   #         #         #   # #       #     #       #   #   # #
# ####### # ##### # ### ########### ##### ### ####### ############# ### # # # #
# #   #   # #     #   # #       #     #   # # #     # #           # #   # #   #
# ### # # # # ######### # ##### ##### # ### # # ### # # ######### # # ### #####
#   # # # # # #     #   #   #   #   # # #   #   #       #       #   #   #   # #
### # # ### # # ### # ##### # ##### ### # ### ### ####### ### ##### # # ### # #
#   # # #   # # #   #       # #     #   #   #   #   #       # #     # #   # # #
# ### ### ### # # # ######### # ##### ##### ### ############# # # ##### # # # #
#   # #   #   # # #       #   #   #   #   # # #       #         # #   # # # # #
### # # ##### # ######### # ##### # ### # # # # ##### # ########### # ### # # #
#   #   #       # #     # #     #   # # # #   # #     # #   #     # #   #   # #
# ######### ##### ##### # ####### ### # # # ### # ##### # # # ### # ### ### # #
#     #     #         #         #   # # # # # # #     #   #   # #   #   # # # #
# ### # ##### ##### # ######### ##### # # # # # ############### # ### ### # # #
# #   # #   #   #   #     #   # #   # # #     # #               #   #     #   #
### ### ### # ### ####### # ##### # # # ##### # # ######### ####### ####### ###
#   #   # #   # # #     # #     # # # #     #   # #       #   #   #   #   # # #
# ### ### ##### # # ##### ##### # ### ##### ##### ### # ##### # # ##### # ### #
#   #           #   #     # #   #   #   #   #         # #   #   # #     #   # #
### ######### ### ######### # ##### # # # ### ######### # ####### # ####### # #
# #     #           #             #   # # #   #   #     # #     #       # # # #
# ##### # ### ##### ####### ##### # ##### # ##### ##### # # ### ####### # ### #
#       #   #     #       # #   # # #     # #         #   #   #   # #     #   #
# ##### ### # ######### ### # ### # # # ### # ####### ### ### # ### ####### ###
#     #     # #   #   #   # #     #   #   # #   #   # # #     # #   #     #   #
##### ##### # # # # # # # # # ######### # # # ### # # # ####### # # # ### ### #
#       #   #   #   # # #   #           #     #   #   #           #   #       #
###############################################################################
