###############################################################################
# #               #   # # #         #             #     #         #   #       #
# # ########### # ### # # ##### ### ####### # ### # ### ##### # # # # ### # # #
# #   #   #   # #   #   #         #       # #   # #   # #   # # # # #   # # # #
# # ### # # ### ### ### # ############### # ### # ### # # # ### # # ### # # ###
#   #   # # #   #     # # #               # # # #     #   #     #   #   # #   #
### # ### # ##### ### # # ### ####### ##### # # ### ################# ### ### #
#   # # # # #     #         #       #     #   #   # #     #       #     # #   #
##### # # # # ##### # ### # ##### ####### ####### ### ### # ##### ##### ### ###
#   # # #     #   # #   # # # #   # #   #           #   # #     #     #   #   #
# ##### ######### # ### # # # # ### # # ####### ### # ######### ##### ### ### #
#         #   #     #   # # # # #   # #         # # #   #     #   #   #     # #
### ### ### # # ####### # # # # # ##### ######### # ### ### # ### # ####### # #
# # #       #       #   # #   #   #   # #     #     #       #   # #       #   #
# # ############# # ##### # ####### # # ### # # ##### ##### ##### ####### #####
# # # #           # #   # # #   #   # #   # # #       #     # #   #     #     #
# # # # # ######### # # ##### # # ### ##### # ##### ### ##### # ##### ####### #
#     # #     #     # #       #   # # # # # # #     # # # #         # #       #
# ##### ### # # # ####### ######### ### # ### # # ### # # ### ##### # # ##### #
# #     #   # # #         #   # #       #   #   #   # # #   # #   #   #     # #
# # ### # ##### ### ####### # # # ######### # ##### # # ### ### # ######### ###
# #   # #   #   #     #     # #   #   #     # #   # # # #   #   #   #     #   #
# ### # ### ######### # ######### # # # ##### # # # # ### # # ##### # ####### #
#   # # #   #   #   #           #   #   #   # # #     #   # #   # # #   #     #
##### ### ### # # # ########### # ### ##### # ######### ### # ### # ### # #####
#   # #   #   # # # #   #       #   # #     # #         # # #     #         # #
# ### # ### # ##### # # # # ######### # # ### ########### # ##### # ######### #
# #   #   # #     #   #   #       #   # # # #       #   #     #   #       #   #
# ### ### ##### ################# # # ### # # ### # # ####### # ######### # # #
#   #   #     # #         #         #     # # #   # #           #     # # # # #
### ### ##### # # ####### # ############### ### ### ##### ######### # # # ### #
# # #       #   #   #     #   # #             # # #     # #       # #   # #   #
# # # ######### ### # ### ### # ### ########### # ### # # ### ### # ##### # ###
# #   #         #   # # #   # # #   #       #   # #   # #   # #   #   #   #   #
# ##### ######### ### # ### ### # ### # ### ##### # ### ### # # ### # # ##### #
#     #   #   #   # #   #   #   #     # # #       #   #   #   # # # #   #     #
# ### # # # # # ### ### # # ### # ##### # ####### ### ### ##### # # ##### ### #
#   #   #   #   #       # #     #     #         #       #       #         #   #
###############################################################################
