###############################################################################
# #   #             #         #             #   #         # #     #     #   # #
# # # ############# # ####### ### ####### ### # ### ####### # ######### # # # #
# # #     # #     # # #   #   #     #   # #   # # #     #   #       #     #   #
# # ### ### # ### # # ### # # ##### ### ####### # ### ### # # ##### # ####### #
#   # # #       # # #   # # # #   # # #     #       #   # # # #   # # # #     #
##### # # ####### # ### # # ### # # # ##### # ##### # ### # # # # ### # # #####
# #     #     #   # #     # #   # # #   # #       #       #     #     # #     #
# # ### ##### # ### # ##### # ##### # # # ##### ### ################### ##### #
# # # # #   # # #   #     #   #   # # #   #     #             #       #     # #
# # # # # ### # # ##### ##### # # # # ############# ### # ##### ##### # ##### #
# # #     #   #   #       #   # #       #         # #   #   #       #   #     #
# # ### ### ### # # ##### # ### ####### # ####### ### ####### ########### #####
# #   # # # #   # # # # # #       #     #       #     #     # #   #       #   #
# ### ### # # ### ### # # ##### ### # ### # # # ####### ### # ### # ####### # #
#   #     # #   #   #     #     #   #     # # # #       # # #     # #   #   # #
# # ##### ##### ######### ##### # # ####### ### ### ### # # ##### # # # ##### #
# #     #       #           #   # # # #     #     # #   #         #   # #     #
# ### ####### ######### ### # ####### # ######### # # ##### ########### # ### #
#   #       #           # # # #       #   # #       #   # #     #     # # #   #
### ##### ########### ### # # ####### ### # # ######### # ##### ### # ### #####
# #   # #     #     #   #   #         #   #     #     #     # #   # #         #
# ### # ### # # ### ### ### ##### # # # ### ### # # ##### ### ### ########### #
#     #   # #   # # # # # # # # # # # # #     # # #       #     #     #     # #
# ##### # # # ### # # # # # # # ### # # ####### ### # ####### ####### # ### # #
#       # # #   # # # # # # # #     # #     # #   # #       #   #   #   #     #
######### # ### # # # ### ### ##### ######### ### ######### ### # # ##### ### #
# #     # #   #   # #   # #   #     #   #           #     #     # #   # #   # #
# # ### # ### ######### # # # ### ### # # ########### ########### ### # ### # #
# # # #   # #   #   #   #   #   # #   # # #     #   #             #   #   # # #
# # # ##### ### # # # # ##### ### ### ### # ### # # ####### # ####### # ### # #
#     #     #     # # #   #         #       # #   #         # #     # #     # #
# ##### ### # ##### # ##### ####### ######### ######### ####### ### # ####### #
#   #   #   #   # #   #     # #   #   #   #     #               # # # #   #   #
### # ### ##### # # ######### # # # # # ### ### # ####### ####### # # ### # ###
#   # # # #     # # #     #     # # #   #   # # # #     #         # #     # # #
# ### # # # ##### # # ### # ##### # # ##### # # # ### ### ##### ### ####### # #
#     #   #       #     #       #   #       #   #   #       #   #   #         #
###############################################################################
