###############################################################################
#   #         #   #     #     #             #     #   #     #             #   #
# # ####### ### # # ### # ### ### ######### # ### # ### ### # # ######### # # #
# #             #   #   # #     #     # #   #   #   # #   #   # #   #   #   # #
# ################### ### ##### ##### # # ##### ##### # # # ##### # ### ##### #
#   #       #   # #   #   #   # #   # # #   #           # #       #   #       #
# ### ##### # # # ### # # # # # # # # # ##### ########### ################### #
#   # #     # #     #   # # # #   # #       #     #     #   #         #     # #
### # # ##### # ########### ####### ### # # ##### ##### ### ##### ### # ### # #
#   # # #   # # #     #     # #   #   # # #     #     #   #   #     #   #   # #
# ##### ### # # # ### # # ### # # ### # # # # # # # ### ##### # ##### ### ### #
# #   #   # # #     # # # #   # #   # # # # # #   # #       #   #   # #   #   #
# # ##### # ####### # ### # ### ### # ### # ####### ####### ##### ### # ### ###
# #       #     # # #     # #   # # #   # #   #   #   #           #   # #   # #
# ####### ### # # # ####### ### # # ### # ### # ##### # # ######### ### # ### #
#       #   # #   #       # #   #     #   #   #       # #       #   #   #   # #
### # ##### # ### ##### # # ##### ### ##### # # ### ### ####### # ### ##### # #
# # # #       #     #   # # #     #   #   # # # #     #   #   #   # # #     # #
# ### # ############# ### # # ##### # # # # ### ##### ####### ##### # ##### # #
#     #   #         # # # #   #     # # #   #   #   #     # # #           # # #
# ### ### # ####### # # # ##### # ##### ########### ##### # # # ### ####### # #
#   #   # # #     #     # #     # #       #   #           # #   #   #     #   #
# # ### # ### ### ### ##### ####### ####### # # ##### ##### ##### ### # # ### #
# #   # #   #   #   #     #     #   #     # #   #     #   #   #   #   # # # # #
### # ##### ### # ### # ####### ####### ### ### # ####### ### # ####### ### # #
# # #           #     #       #   # #       #   #   #     #   # #       #   # #
# ##### ##### ##### ######### ### # # ##### # ### # ### ### # # # # ##### # # #
#     #     # #     #       # # # # #   # # # # # #   #   # # #   #   #   #   #
##### ### # ### ##### # # ### # # # ### # ### # # ### ### # ######### ##### ###
#       # #   #     # # #     # # # #   #   #   #   # #   # #   #   # #   #   #
# ### ##### # ##### # ### ##### # # # ### ##### ### # # ### # # # # # # # ### #
#   # # #   # #   # # #   #     #   #   # #   # #   #   #   # # # # # # #   # #
### # # # ### # ##### ### ##### ### # # # # # ### ####### ### # ### # # ### # #
#   # #   # #   #   #   #   #     #   #   # #   #             #   #     # # # #
# ### # ### # ### # ### ### # ########### # ### # ############### ####### # ###
# #   #   # #     # # # # #   #     #   # # #   # #         # # #   #     #   #
### ##### # ####### # # # # ### ### # # ### # ##### # ### # # # ##### ### ### #
#           #       #     #     #     #     #       # #   #   #         #     #
###############################################################################
