###############################################################################
#             #     #       #   #       # #           #       #       #       #
# ##### ### # # # # ##### ### # # ####### ### ####### # ##### # ### # ####### #
# # # # #   #   # #       #   # #       # #       #   #   # #   # # #         #
# # # ### ####### ####### ##### ##### # # # ##### # ### # # ### # # ### ##### #
#   #     #     # #     # # # #   #   # #     #   #     # #   # # # # #     # #
##### # # # ### # ##### # # # # # # # ####### # ####### # ### ### # # ##### # #
#     # # # #   #     #   #   # #   #       # #     #   #   #       #   #   # #
# ### ### ### # # ##### ### ### ####### ### # ######### ### ### ####### # ### #
#   #   #   # #   #   #     #     #       #   #   #   # # #   # #       # # # #
# ######### # ### # ### # ### ##### # ### # ### ### # # # ### # ### ### ### # #
# #         # #   #     #   #   #   # #   # #   #   #   #   # #     # # #   # #
# ########### # ##### ##### ### ##### ### ##### # ##### # # # # ##### # # # # #
#     #     # #     #     #     # #     #   #   # #       # # #   #   # # #   #
# # # ### # # ##### # ########### # ### ##### ### ######### # ### # ##### #####
# # #   # # # #   # # #   #     #   #   #   #   #     #   # #   # # #   # #   #
### ### # ### ### # ### # ##### # # # ### ##### ##### # # # ####### # # # # ###
#   # # #   #   # #   # #     #   # # #   #         # # #   #   #   # #   #   #
##### # ### ### # ### # ##### # ### # ### # ######### # ####### # ### ####### #
# #     #   #   #   # #   # #   #   # #   # #         #       # #             #
# # ##### ### # ### ####### ######### # ### # ############# # # # ########### #
# #   #   #   #       #   #       #   # #   # #       #   # #   #     #   #   #
# ### # # # ####### # ### # # ### # ### # # # ### ### # # ######### ### # ### #
#   #   # #   #     #   #   # #   # #   # #   #   #     # #     #   #   #   # #
# ####### # ### ####### ##### # ##### # ##### # ######### # ### ##### ##### # #
# #       #   # #     #       #     # # #     #       #   #   #           # # #
# # ### ##### # ##### ####### ### ### ### ########### # ################### # #
# #   # #   # #       # #   # # # #   #           #   # #   #         #   # # #
# # # # # ### ### ##### # # # # # # ### # ####### # ##### ### ####### # # # ###
#   # #   #   # #     # # #   # # #     #   #   #   #     #   #     #   # #   #
# ####### # ### ##### # # # ### # ######### # ########### # ##### ### # # ### #
#     # # # #   #   # # # #     #   #     # #         # # # #   # #   # #   # #
##### # # # ### ### ### ##### ### # # ### # ### ##### # # # # # # ### # ### # #
#   #   # #     #         # # #   #   #   #         #   # #   #   #   # # #   #
# ####### ####### ### ### # # # ######### ####### ####### # ##### ##### # ### #
#       # #         # # # #   #   #     # #     # #   #     #     #     # # # #
# ##### # ### ##### ### # ### ### # # # ### # ### # # ####### ##### ##### # # #
#     #       #         #   #   #   # #     #   #   #         #           #   #
###############################################################################
