###############################################################################
#     #           #     #     #       #   #         #   # #   #           #   #
##### # ######### # ##### # # # # ### # # # ##### # ### # # # ### # ##### ### #
#     #       #   #       # # # # #   # # #     # #     # # #   # # #   # #   #
# ### ### ##### ### ####### ### # ##### # ####### ####### # ### # # # # # # # #
# #   #   #   # #   #     #   # # #     #       # #     #   # # # #   # # # # #
# ######### # # # ### ### ### # # # ##### ##### # # ### ### # # ####### ### # #
#     #     # # # #   #       # #       # #   # # # #     # # #   #   # #   # #
# ### # ##### # # # ######### # # ##### # # # # # # ####### # ### # # # # ### #
#   # #   #     # #   #     # # # #   # # # #     #         #   #   #   # #   #
# ### ### ####### ### # ### ### ### # ### ########### ### ### # ####### # ### #
# #   # #   #   #   #     #     #   #     # #     # #   #   # #   #   # #   # #
### ### ### # # ### ############# ####### # # ##### ### ### # # ##### ##### # #
#   #   #   # #     #         #   #       # #     #     #   # # # #         # #
# ### ### ### ####### ### ### # # ### ##### ##### ####### ### ### # ##### ### #
# #   #   #   #     # # #   #   #   # #     #   #   #     #       #   #     # #
# # ##### # ##### ##### ### ####### ### ### # # # # # ### # ### ##### ####### #
# #     # #     #         #   #   #   # #   # #   # # #   # #     #   #     # #
# ##### # ##### ##### ####### # # ### # ##### ##### # # ##### ### # ### ### # #
#     #   #   #       #       # #   # # #       # #   #         # #   # # #   #
# ##### # # # ####### # ########### # # # ##### # ##### # ##### ##### # # # ###
#     # # # #     #   # #   #     #     # #     #     # # #       #   #   #   #
# ### # ### ##### ##### # # # ########### # ##### ############# ### ##### #####
# #   # #   #   #   #   # # #             #       #   #   #   #     # #   #   #
# # ### # ### ##### # # # # ####### ########### ### ### ### # ####### # ### ###
# # # #     # #     # #   #       # #   #       #   #   #   # #     # # #   # #
# # # ##### # # ##### ####### ##### # # # ####### ### ####### ### ### # # ### #
# # #     # #   #     #     # #     # # #   #   #   # # #   #   #   #   #     #
### ### # # ##### # ### ##### # ####### ### # ##### # # # ##### ### ######### #
#   #   # # #     #   #     #   #   # #   #           # # #         #       # #
# # # ### # # ####### ##### ### # # # ### ### ######### # ### ### ### ##### # #
# #   #   #   #     #         # # # #   #           #     #     # #   #   # # #
# ##### ######### ####### ### ### # # ########### # # ######### ######### # # #
# #     #   #     # #   #   # #   #   #   # #   # #   #     #       #     #   #
# ### ### # ##### # # # # # ### ### ### # # ### # ### ##### ### ### # ### ### #
#   # #   #           #   #   # #   #   #       #   # #     #   #     #     # #
# # ### ##################### # ##### ##### ####### ### ##### ### ########### #
# #               #           #           #                     #             #
###############################################################################
