###############################################################################
#   #                 #   #   #   #     #         #     #                 #   #
# ### ### ########### ### # ### # ### # ####### # ##### # ### ########### ### #
#     #   #   # #   #   # # #   #     # #   # # #     #     # #   #         # #
########### # # ### # # # # # # ####### # # # # ##### ##### # # # ######### # #
#       #   #     #   # # #   #     # #   # # #   #   #   # #   #       # # # #
####### # # ########### # ### ##### # ##### # ### ##### # # ########### # # # #
#     # # # #           # #   # #   #     #   # #     # # # #   #       # # # #
### ### # # # ####### ### # ### # ### ######### # # # # ### # # # ####### # # #
#     # # #   #   #           # #   #     #     # # # # #   # # # #   #   #   #
# ### # # ##### # # ##### ### # # ####### ### # # ### # ##### # # # # # ##### #
#   #   #   #   #   #   #   # # # #       # # # #   #   #     # # # # #       #
# ######### ### ##### # ### # # ### ####### # ##### ##### ##### # # # ### #####
#           #   #     #     #     #         #   #   #       #   #   #   # #   #
### ####### ##### ####### # ### # # ### ##### # # ### ####### ### ### # # # ###
# # #     #   # #       # # #   # # # # #   # # #       #   # # # # # # # #   #
# # ### # ##### ### ##### ### # ### # ### # ### ### ##### # # # # # # # # # # #
# #   # #   #   #   #   #   # #     #     #   # #   # #   #   #   # # # # # # #
# ### # ### # ### # # ####### # # ########### # # ### # ########### # # # ### #
#     #   #   #   # #     # # # #     #       # # # #   #           # # # #   #
# ##### # ##### ### ### ### # # ##### # ####### # # # ### ############# # # # #
#     # # #   #   #   # #   # #     # # #         #   #         #   #   #   # #
##### ### # # ### ### # # ### ######### # ##################### # # # ####### #
#     #   # #   # # #   # #         #   # #         #           # # #       # #
# ##### ##### ### # ##### # ### ### ### # ######### # # ### ##### ### ##### # #
#       #         #     #   #     #   # #   #     #   # # #       #   #   # # #
### ############### ### ########### # # ### # ######### # ############# # # ###
# # #       #   # # # #             #   #     #         # #   #         # #   #
# # # ##### # # # # # # ######### ### # # # # # ##### ### # # # ######### ### #
# # #   # #   # # #   # #     #   # # # # # #     #   #   # #       #   #   # #
# # ### # ##### # ### ### ### # # # # ### # # ##### ### ### ######### # ### # #
# # #   #     # #     # #   # # #   #     # #     #   # #     #       # #   # #
# # # ####### # ### ### ### # ### ##### ### ######### # # ### # ### ##### ### #
# # #     #   #   # #     # #     #     #   #   #   # # #   # #   #     #     #
# # ### # # # ### # # ##### # ########### ##### # # # # ### # ####### # #######
#     # # # #   # #   #   # # #         #   #   # #   #     # #     # #   #   #
# ##### # # ##### ##### # # # # ### ######### ### ##### ##### # ### ### # # # #
# #     # #             #   # #   #                     #       #       #   # #
###############################################################################
