###############################################################################
#       #                     #   #     #   #     #     #       #             #
# ##### # ####### ######### ### # # # # # # # ### # ### # ### # ##### ####### #
# #   #       #   #   #   # #   #   # #   #   #   #   # # #   #   #   # #   # #
### # ######### ### # # # # # # ##### ######### ##### # ##### ##### ### # # # #
#   #     #       # # # # #   #   #   #       #       # #   #   #   #     #   #
# ####### # ##### # ### # # ####### ### ##### ######### # # ### # ### #########
# #   # #   # # # # #   # #   #   # # # #   #   #     #   #   #   #   #       #
# # # # ##### # # # ##### ##### # # # ### ##### ### # ##### # # ######### #####
#   #   #   # #     #   #     # #   #   #     #   # # #     #   #   #   #     #
### ### # # # ##### ### ##### # # ### # # ### # # # ### ####### # ### # # ### #
# # # #   # #   #         #   # # #   # #   # # # # # # # # #   # #   #   #   #
# # # ######### ######### # ### # ##### ### # ### # # # # # ##### ### # ### ###
#       #     #   #       #     #     #   # #   #   # # # #   #   # # # # #   #
# ####### ####### ################### # # # ### # ### # # ### # ### # ### #####
#   #   #       #             # #   # # #   #   #   #     # # #   # # #   #   #
##### # ### # ### ########### # # # # # ####### # # ##### # # # ### # # # ### #
#     #     #     #   #     #   # #   # #     #   # #     # #     #   # # #   #
# ################# # # ### ### # ####### ######### # ##### ##### ### # ### ###
#   #       #       # #   #   #   # #     #     #   # #       # #     #       #
### # ### ### # ##### ### # ####### ### ### ### # ### ##### # # ### ####### # #
# # #   #   # #   # # # # #       #           # #   #     # #   # #         # #
# # ####### # ### # # # ######### ##### ####### # # ##### ##### # ####### ### #
# #       # # # # #         # #           #     # # #   #       #       # #   #
# ####### # # # # ### ####### # ######### # ### ### ### ### # ### # ### # #####
# #   #   #     #   # #     #   #     # # #   #     #   #   #   # #   #   #   #
# # # # # # ####### # # ### ##### ### # # ########### ### # # ### ####### # ###
#   #   # #   # #   # # #       # # # # #                 # #       #     #   #
######### ##### # ##### # # ##### # # # # ######### # ##### ####### # ####### #
#         #   # #   #   # # #     # #   #         # # #     #     # #         #
# # # ##### # # # # # ### ### ##### ### ### ### # # ### ### ##### # ###########
# # #       #   # # #   #   #   #     #     #   # #   #   #   #   #         # #
# # ############### # ##### ##### # # ########### ### ### ##### ########### # #
# # #     #       #   #     #     # #     # #     # #   #     #   #       # # #
# ### ### # ##### # ### ##### ##### ##### # ####### ### ######### ####### # # #
# #   #   #     # #   # #     #   #   #   #       #   #     #   # #   #   # # #
# # ### ####### # ##### ####### # ### # ### # ##### # ##### # # # ### # ### # #
#   #           #               #     #     # #     #         #       #       #
###############################################################################
