###############################################################################
#       #     #   #   #     # # #       #         #     #         #           #
# # ### # ### # # # # # # # # # # ####### ##### # ### ### # ### ### ######### #
# # #   # # #   # # # # # #   # #   #     #   # #   # # # # #       # #   #   #
# # ##### # # ##### # # # ##### ### # ####### # ### # # # ########### # # ### #
# #   #   #   #     # # # #       #         # #   # # #   #     #   # # #     #
# ### # ##### # # ### ### # ##### ########### ### # # ### # ### # ### # ##### #
# #   #     # # #   # #   # #     #   #   #   #   #     # # #   #         #   #
# # # ##### # # ##### # # # # ##### # # # # ### ### ##### ### ### ##### # #####
# # #     # # # #   #   #   # #     #   # #       # #         # # #   # #     #
# # ##### # ### # # ######### # ######### ####### ### ######### ### ### # ### #
# #     # #   #   #   #     #   #   #   # #     #   #   #   #       #   # #   #
##### # # ### ####### # ### ##### ##### # # ### ### ### # # # ##### ##### # # #
#   # # # # #   #   # #   #       #   #   #   # #   #     # #   #   #   # # # #
# # ### # # ### # # # # # # ####### # # ### # # # ### ### # ##### # # # ### ###
# #     #   #   # # #   # # #       # # #   # #   # # #   #     # #   # #     #
# ########### ### # ##### ### ####### # # ### ### # # # ### ### # ##### ##### #
# #         #     # #     #   #     #     # # #       # #     # # #   #     # #
# # ####### ### ### # ##### ##### # ####### # # ##### # ##### # ### ### # # # #
#         # #   #   #   #   #   # #         # #   # # #   #   # #       # #   #
########### # ### ### # # ### # ### ####### # ### # # ### ####### ### # ### ###
#     #     #   #   # # # #   #   #   # #   # # #   #   #   #   #   # # #   # #
# ### # # ##### ### # ### # # ### ### # # ### # ### ######### # # ### ### ### #
#   #   # #     #   # #   # # #       #   # # # # #     #   # # # #   #   #   #
# # # ##### # ####### # ### # ######### ### # # # ### # ### # # # # ### ##### #
# # # #     #         # #   #   #   #   #   # #     # #   # # #   # # # #     #
# # ### ######### ##### ### ### ### # ##### # ### ### # ### # ##### # # ### ###
# #   #     #   # #   #   # #     # #       #   #   # #     #   #   #     #   #
##### ##### # # # # # # # ### ### # ####### ### ### ######### # # ####### # # #
#     #   #   # # # #   #     #   #       #   #   # # #   #   # # #   # #   # #
# ##### # ##### # # ####### ### ##### ####### ### # # # # # ### ### ### # ### #
# #     #   #   # # #         #       #   #     #   # # # # #   #       # #   #
# # ##### # # ##### ### ######### ####### ######### # # # # ##### ##### # # # #
#     #   # # #   #   # #   #     #     #           #   # #   #   #   # # # # #
# ##### ### # # # ### # # ### ##### # ##### # ####### ### ### # ### # # ##### #
#   #   #   #   # #   # # #   #   # # #     # #   #     #   # # # # #   #   # #
### # ########### # ##### # ##### # ### ##### ### ####### # # # # ##### # # # #
#   #             #       #       #     #       #         #   #       #   #   #
###############################################################################
