###############################################################################
#   #           #   #               #   #         #       #   #     #         #
# ##### ### ### # # ### # ######### # # ##### ##### ##### ### # ######### # ###
#     #   # #     #   # #   #       # # #     # # # #       #   #   #   # # # #
##### ##### ######### ##### # ##### # # # ### # # ### ##### # # # ### # ### # #
#   #     #       # #   # # # # #     # #   # # #   #   #   # # #     #   #   #
# # ##### ### ### # ### # # # # # ##### # # ### # ##### ##### ### ####### ### #
# #     #   # #   #     # # # # #     # # #   # #   #   #   # #   #     #     #
# ##### # # # # ### ##### # # # ##### # ### # # ### # ### # # # ### ### # ### #
#     # # # # #   #       # # #     # # #   #       # #   #   # #     # #   # #
# ### # ### ##### ######### # ##### # # # ####### # # # # ##### # ### # #######
# #   #     #   #     #     # #       #   #   #   #     # #     # #   # #   # #
# # ######### # # ### # ##### ##### ####### # # ### ####### # ### # ##### ### #
# # #         # #   #     #   #   # #     # # #   #       # #   # #   #   #   #
# # # ##### ########### ####### # ### ### # ####### # ### # # ### ### # # # ###
# # #   # #         #   #   #   #       # #       # # # #   # #     #   # # # #
# # ### # ######### # ### # # ########### ####### # ### # ##### # # ####### # #
# #   #       #   # # # # #   #           #   #   # #   #       # #         # #
# ### ######### # # ### # ##### ####### ##### # # # # ##### ##### ####### ### #
#   #     #     #   #   #     #   #   #     # # #     # #   #   # #   # # #   #
### ##### # ####### # # ##### ### # ####### # # ##### # # ### ### ### # # # # #
# # #   # # #   #   # # #       # #       #   #   # # # # #     #   # # # # # #
# # # # # # # # ##### ######### # ####### ### ##### # # # ##### ### # # # ### #
# #   # #     #     #           #     #     #   #   # #   #   #     # #       #
# ##### ########### ############### # # ### ### # # ### ##### # # ### #########
#     #       # #     #     #     # # #   #     # #     # #     #     #       #
# ######### # # # ### ### # # ### # ##### ### ### ####### # ### ####### ##### #
# #       # #   # #   #   # # # # # #   #   #     #   #     #   #   #   #   # #
# # # ### ##### # # ### ### # # # # # # ### ####### # # ##### ### # # ### # ###
#   # #   #     # # #   #   #   #   # #     # #     # # #   #     #   #   # # #
# ### # ### ##### # # # # ##### ##### ##### # # ##### ### # ##### ### ##### # #
#   # # #   #   # # # # #   #   #     #   #   # #     #   #     #   # #     # #
##### # # ### ### # ### ### # ######### # ### # # ##### ####### # # ### ### # #
#     # # #     # #     #   #         # #     # #   #   #     # # #     # #   #
# ##### # ##### # ##### ############# # ####### ### # ##### # ####### ### #####
#     # #   #   # #     #         #   #   #     # #   #     #   #   #   #     #
# ### ##### # ### ####### # ####### ##### ##### # ##### ### # ##### ### ##### #
#   #         #           #             #             # #   #                 #
###############################################################################
