###############################################################################
#   #   #   #     #   #         #   # #   #     #   #                   #     #
# # # # # ### ### # # # ######### # # # ### # # # # # ########### ####### ### #
# #   # #   # #   # #   #         #   # #   # #   #   #   #     # #     # # # #
# ##### ### # # ### ##### ##### ####### ##### ####### # # # ### ### ### # # # #
# #   # #   # # #   #   # #   #   #   # #   #     # # # #   # #   # #     #   #
# # # # # ### # # ### # # ### ### # # # # # # ### # ### ##### ### # ####### ###
# # #   #     # # #   #       #   # #   # #     # #   #       # # #       # # #
### ### ##### # # # ########### ### ##### # ##### ### ####### # # ####### ### #
#   #   #     # # # #           #   #     #   # #   #     # #   #         #   #
# ### ### ##### # ### ######### # ### # ##### # ### ##### # ### ######### # ###
# #     #   #         #     #   #   # # #     # #     #   #   #       # # #   #
# ######### # ########### ### # # # # ### ##### # # # # ##### ### ### # # ### #
#           # #   #       #   # # # #   #       # # #   #   #   #   # # #   # #
# ############# # # ####### ##### # ### ########### ##### # # # ### # # ### # #
# #       #     #   #       #   # #   #   #   #   #       # # #   # #     #   #
# # ##### # ######### ######### ##### # # # ### # ##### ### # # # # # #########
#   #   # #   #           # #           # #     # #   #   # # # # # # #   #   #
# ### # ##### ### ####### # ### ######### ### ### # ##### # # # # # ### # # # #
# #   #     #   # #   #   #   #   #   #     # # # # #   # # # # # #     #   # #
# # ####### ### # # # # # ### ### # # ##### # # # # # ### # ### # ### ####### #
# #   #   #     # # #   #     #   # #   # # # # #   #   # #     #   # #     # #
# ### ### ### ### # ####### ### # # ##### # # # ####### # ######### # ### # # #
# # # #   # #     #   #     #   #     #     #   #     # #   #     # #   # # # #
# # # # # # ######### # ####### ############# # ##### # # ####### # ### # ### #
# # # # #         #   #     #   # #   # #   # # #   #   # #     # #   # #   # #
# # ### ##### ##### ######### ### # # # # ### ### # ### ####### # ##### # # # #
# #   #     # #   #         # # #   # #     #   # # #   #   #   # #   # # #   #
# # ####### ##### ### ##### # # ### # ### # ### # # # ### ### ### # # # # #####
# # #     #   # #   #     # #   #   #     #   #   #   #   #     #   # # # #   #
# # # ### ### # ### ### ### # ##### # # ##### ### ### # ####### ### # # # ### #
#   # # #   #     #     #   # # # # # #   #       # # #           # #   #     #
### ### # ### ########### ### # # # ####### ####### ######### ##### # ####### #
#   #   # #   #     #     #   #   #   #   #     #   #   #   # #     #       # #
# ### ### # # ##### # ##### # ### # # ### ##### ### # # # # # ############# # #
# #   #   # # #     # #     # #   # #     #   #   # # #   #   #       #     # #
# ### # ### ##### # # # ####### ### ##### ### # ### # ######### ####### ##### #
#     #           #                 #         #                         #     #
###############################################################################
