###############################################################################
# #   #     #     #     #     #       #     #     #         #   #     #       #
# # # ### ####### # ##### # # # ### # # ### ### # ### ### # ### # # # ##### # #
#   # #   # #     #       # # #   # #   # # #   # #   #   #   #   # #       # #
##### # ### ### ########### ##### # ##### # # ### # ##### # ##### # ######### #
#   # #             # #     #   # #   #   # # # # #     # #     # # #   # #   #
### # ####### ### # # # ##### # # ### ### # # # # # ### ##### # ### # # # # ###
#   #           # #   #       # #   # #   # #   # # #   #     #   # # # # # # #
# # # ######### # # ### ####### ### # # ### ### # # # ### ####### # # # # # # #
# # #   #   #   # #   #   #   #     # #   # #   # # # # #     #   # # # # # # #
# ##### # # # ############# # ####### ### # # # # ### # # ### ##### # # # ### #
#   #   # # #   #       #   #             # # # #     #   #     # #   # #     #
### # # ### ### # ####### ######### ##### # # # # # ### ### ##### ##### ##### #
#   # #   #     # # #   # #       #     # #   # # # #   # #   #     #   #     #
# ### ### ### ### # # ### # ##### ##### ####### # # ### # ##### ### # ### ### #
#   # #     # #   # #   #   #     #   #   #     # #   #       #   # #       # #
### # ####### ### # # # ##### ##### ##### # ##### ### ####### # # ########### #
#   #       #     #   #   #   #     #     #     #   # #   #   # # #       #   #
# ### ##### # ########### # ##### ### ##### ### ### # # # # ##### # ##### # # #
#     # #   # # #     #   #       #   #   # #   #   #   # #       #     # # # #
### # # # ### # # ### # ########### ##### # # ########### ### ####### # # # ###
#   # #     #   # #   #   #     #   # #     # #     #   # # # #     # # # #   #
# ### ##### ### # # ### # # ##### ### # ##### # ##### # # # # # ### ### # ### #
#   #     #   #   # #   #         #   #   # # # # #   #   # # # #       # #   #
# # # ############# # ####### ##### ##### # # # # # ####### # # ######### # ###
# # # # #         # #       #     # # #   # #   # #         # # #   #   #   # #
### # # ### ##### # # ##### # ##### # # ### ##### ######### # # # # # # ##### #
# # # #   #   #   # #   #   # #     # # #         #     #   # #   # # # #     #
# ### ### ### # ### ### # ### # ##### # ### # ### # # ####### ##### # # ##### #
#   #     #   # # # #   # #   # #         # # # # # # #       # #   # # #   # #
# # ### ####### # # # ### ##### ### ##### ### # # # ### ####### # ### # # # # #
# #   #       # # # # #   #       # #   #   # # # #   #   #     #     # # #   #
# # # ####### # # # ### ### ######### # ### # # # ### ### # # ######### # ### #
# # # #   #   #   #       #       #   #   #   # # # #   #   # #         # #   #
# # # # # # ##### ##### ######### # ########### # # # ### ### # ####### # # ###
# # # # #     #       #           #   #             #     # # #     # #   #   #
# ### ######### ##### ### ######### # ##################### ####### # ####### #
#   #               #               #                               #         #
###############################################################################
