###############################################################################
#     #   #     #   #                   #               #     #       #   #   #
# ####### ### # # ### ######### ##### ### ### # ####### # ####### # # # # ### #
#   #   #   # #           #     #     #     # # #   # # # #     # # #   # #   #
# # # # ### # ########### # ##### ##### ##### # # # # # # # ### ### ##### # # #
# #   # #     #     #     #   #   #     #   # # # # #     #   #     #     # # #
# ##### ### ### # ### ##### # ########### # # ### # ##### ### # # ### ##### ###
# #         #   # #   #   # #           # #       #     #   # # # # # #   #   #
# # ########### # ##### ### ### ####### # ####### ##### ##### # ### # # # ### #
# #     #     # # #     #     # # #     #   #     #   #   #   # #   #   # # # #
# ##### # # # # # # ##### ##### # # ####### # ### ### ### # ### # ####### # # #
# #   # # # #   # #   #     #     #   #     # # #       #   # #   #     #     #
# # # # ### ##### ### ##### # ### ### # ##### # ####### ### # ##### ### ##### #
# # #       #     # #     # #   # #   # #     # #       # # #     #   #       #
# # ######### ##### ##### ##### ### ### ####### ### ##### ### ##### ### # #####
# # #       # #     #   #       # #   #       #   # #     #   #   #   # #   # #
# # # ### # # # # # ### ##### # # ### ### ### # # # # ### # # # ####### # ### #
# # # # # # # # # #     # #   #     #     # #   # # # #   # #     #   # # #   #
# # # # # ### ### ##### # # ####### ####### ######### ### # ### # ### # # # # #
# # #   #   #     #     # #   #     #       #     #     #   #   # # #   # # # #
# ######### ####### ##### ### # ####### ### ### # # ######### # ### # # ### # #
#         #       #       #   #       # #       # #   #       # #   # #     # #
##### ### ##### # ### ##### ######### # ####### ### ### # ### # ### # ##### ###
#   # #   #   # # #   #     #         # # #   # #   # # # # # #   #   #     # #
# # # # ### # # # # ### ##### ### ### # # # # # # ### # # # ##### # # # ##### #
# #   #     # # # #   # #     # # #   # # # #   #   #   #   # #     # #   #   #
# ########### ### ### # ####### ### ### # # ####### ##### ### # ######### # # #
# #         #   #     # #     #   #     # #   #   #   # #   # #         #   # #
# # ####### ### # ##### # ### ### # # ### ### ### ### # ### # ######### # # # #
# # #   #   # # #   # # # # # # #   # #   # #   #   # # #   #       #   # # # #
# # ### # ### # ### # # # # ### # ##### ### ### # # # # # ####### ### ### # # #
#   #   #     # # #   #   #     # # #   #         # # # #       #   # #   # # #
##### # ##### ### ### ##### # ### # # # ############# # ##### # ### # # ### ###
#     # #     #       #   # #   # #   #         #   #   #   # #     # #   # # #
# ####### ##### ####### # ##### # ############# ### ####### ### ######### ### #
#       # #     #       # #   # # #   #   #   #   #   #   # #   #     #       #
# ##### # # ########### # # # # # # # # # # # # ##### ### # # ### # # # ##### #
#     #   #             #   #   #   #   #   #           #     #   # #       # #
###############################################################################
