###############################################################################
#     #   #   #       #     #   #     #       #         #   #     #           #
##### # # # # # # ##### ### ### ##### ### ### # ####### # ### ### ### ####### #
#     # #   # # #     # # #             # # #     #   # #   # #     # #       #
# ####### # ####### ### # ##### ####### # # ##### # # # ### # ##### ### ##### #
# #   #   #           # #       # #         #   # # # #     #     #   #   #   #
# # # # ### ##################### # # # ##### ### # ##### ####### ### # # ### #
# # # #   #     #         #     # # # # #   # #   # #     #       #   # #   # #
# # # # # ##### # # ### # # ### # # # ### # # # ### ### ### ####### ### ### ###
#   #   #     #   # #   #     #     # #   # # #   #   #   #     # #   #   #   #
# ######### ####### ####### ######### # ### # ### # ##### ### ### ### ####### #
# #   #     #     # #     # #       #   #   # #     #   # #   #     #     #   #
# ### # ##### # ### ##### # # # ### # ### ### # ##### # ### ### # ####### # # #
# # # # #     #   #       # # # #   # #   #     #     # #   # # #       #   # #
# # # # ##### ### ### # ##### # # ### # ### ##### ##### # ### # ##### ##### ###
#   # #     # #   #   # #     # #   # #   # #         #   #     #   # #   #   #
### # ##### ### # # ##### ##### ### # ### ### ####### ########### # # # # ### #
#   #   #     # # #     #   #     #   #     #       # #         # #   # #     #
##### ### ### # ########### ##### # ##### ##### ### # # ####### # ##### #######
#   #     #   #   #       #   # # # #   #     #   # # #   # #   # #     #     #
# # ####### ### # # # # ##### # # # # ####### ##### # ### # # ### # ##### #####
# #     #   #   # # # #       # # #   #     #       #   # #     #     #       #
# ##### # ####### # # ######### # ### ##### ### ######### ##### ##### # ##### #
# #     # #     #   #     #   # # #     #   # # # # #     #     #   # # #     #
# # ##### # ####### ### # # # # # ##### # ### # # # # ##### ##### # # # # ### #
# #     #   #       #   #   # # #   # # # #         #   #     #   # # # # #   #
# ##### ##### ### # ##### # # # ### # # # ############# # ### # ### # # # # ###
#   # # #   # # # # #     # #   #   #   # #   #         # # #   # # # # # #   #
### # # # # # # # # ########### # ### ### # # # ######### # ##### # # # # #####
# # # #   #   #   #   #     #   #   #     # #   #     #       #   # # # #     #
# # # ################# ### ####### # ##### ##### ### ####### # # # # ### ### #
# # #   #         #       #         # #     #     # #   #     # #   #   #   # #
# # ### ######### # ##### ####### ### # ##### ### # ### # ### ##### ### ##### #
# # #     #     #   # #   #     # #   #       #   #   # # # # #   # #   #     #
# # # ##### ### ##### # ####### # # ### ####### ### # ##### # ### # ### # #####
#   #     #   #   #   #       #   # #   #   #       # #     #     # # #   #   #
# ####### ####### # ######### ### ### ### ### ####### # ######### # # ##### # #
#                 #             #     #             #   #         #         # #
###############################################################################
