###############################################################################
#         #       #     #   # #   #       #   #     #     #       #       #   #
# ##### ### ### # # ### # # # # # # ### ### # ##### # ### ##### # # ### ### # #
#     #     #   #     # # # # # # # # #     #   #   #   #       #   #       # #
##### ####### ######### # # # ### # # ######### # # ### ########### # ####### #
#   #     #       #     # # #     #   #       # # #   #       #     #   # #   #
# ####### ######### ##### # ### ##### ####### # # # ##### # ### ####### # # ###
#         #   #   # #     #   #     #         #   # #     # #       # # #   # #
# ######### # # # # # ##### ##### # ####### ##### ### ####### # ### # # # ### #
#     # #   #   #   #     # #   # # # #   # #   #   # #   #   #   # # # #     #
##### # # ##### ##### ### ### # ### # # # # # ##### # ### # ##### ### # ### # #
#   # # #     # #   # # #     #   # #   #   #   # #     # # #     #   # #   # #
# # # # # ### ### # # # ### ##### # # ######### # ### # # # ### ##### # # #####
# #   # #   #     # # #   # #   # # # # #       #   # #   #   # # #   # #   # #
# ##### ### ####### ##### # # # ### # # # ####### # # ### ### # # # ### # # # #
#         # #   #   #     #   # #     # #         #   #   # # # # #     # #   #
######### # # ### ### ######### # ##### ############### ### # ### # ### ##### #
#       # #     #   # #       # #   #   #       #     # #   #     # # # #   # #
# ### # # ##### # # # # # ### # # # # # # ##### # # # # ### ####### # # ### ###
# #   # #   # # # # #   #   # #   #   # #     # # # # #     #     # # # #     #
# # ####### # # # # ####### ########### ### # # # # ####### ##### ### # ##### #
# #       # #   # #     #   #     #   #   # # # # #         #   #   #       # #
# ##### ##### ### ##### # ##### # # # ##### # # # ########### ##### # ##### # #
# #   #     # # #     # # #     #   #       # #   #     #     #   # # #     # #
# # # ### ### # ##### # # # ########### ##### ##### ##### # ### # # # ##### # #
#   # # # #   # #   # #   # #         # #   #     #   #   # # # #     #     # #
##### # # ### # # # # ### ### ### ### # ### ##### ### ##### # # ##### # ##### #
#   #   #   #   # #   #   #   # #   # #   #   # #   # #     #   #     #     # #
# ##### ### ### # ######### # # ### ##### # # # ##### # ### ##### ##### ### # #
#     #   # #   #       # # #   #   #       #         # # #       #   #   #   #
# ### # ### # ####### # # # ##### ############# ##### # # # # ####### ### # ###
#   # # #   # #     # # # #   #   #     #     # #   # # # # # # #         # # #
### # # # # # # ### # # # ### # ### # ### ### # # # ### # # # # # ####### # # #
#   #   # # # #   # # # #     # #   # #     #   # #   # #   # # # #     # # # #
######### # # ### # ### ### ### # ######### ##### ### ####### # # # # ### ### #
#         # #   # #     #     # #       #   #     #   #       # # # # #   #   #
# ############# # ############# ##### # ##### ##### ########### # # # # ##### #
#               #                     #           #               # #         #
###############################################################################
