###############################################################################
#         #         #         #       #     #                   #     #       #
# ####### ##### # ### # ##### # ### ### ### # ########### ### ### # # ### ### #
# #     # #   # # #   #   #   # #       # #     #         #   #   # #     #   #
# # ##### # # # # # ##### ############### ##### # ############# ### # ##### ###
# #     # # #   # # #   #       #     #     #   #               #   # #   #   #
# ##### # # ##### # # # ####### # # ### ### ################# # # ##### # #####
#     # # # #   # #   #   #     # #     # # #   #             # #   #   # #   #
##### # # # ### # # ####### ##### ##### # # # # ############### # # # ### # # #
#     # # #   #   # #   #     #   #   #   #   #   #             # # # # #   # #
# ##### # # # # ### # # # # ### ### ##### ####### # ############# ### # ##### #
#   #   # # # #   # # #   # #   # #         #               #   #       #   # #
### # # # # # ### # # ### ### ### # ######### ############# # # ######### # # #
#   # # # # # #   # #   # #   #           #   # #   #   #     #   #       #   #
# ### # # ### # ### ### ### ############# # ### # # # # # ####### # # ####### #
# #   # #     # #   # #   # #       #     # #     # # # #   #   # # # #       #
# ### ### ##### # ### ### # ### ### # ############# # # ##### # ### # # #######
#   # #   #   # #   #   # #     #   #   #         # # # #   # # #   # #       #
### # # ### # # ### # # # ##### # ##### ### ##### # ### ### # ### ### ####### #
#   #   #   # #   #   # #   #   #   #   # #   #     # #   # #   #   # # #   # #
# ##### # ### ##### ####### ### ### # ### ### ##### # # ### ### ### # # # ### #
#     # # # #   #   #     #     #   #   #   #     #   #     #       #   #   # #
# ### ### # ### # ### ### ##### # ##### # ####### ##### ##### ######### ### # #
#   #   # #   #   #   # #     # #   # # # # #   #   #       # # #   # # #   # #
####### # # # ##### ### ##### # ### # # # # # # ### # ####### # # # # # # ### #
#   #   # # #   # # #       # # #   #   # # # #   #           #   # #   #     #
# # # # # ### # # # ##### # # ### ### ### # # # ####### ########### ###########
# #   # #     # # #       # #     #   #   #   # # #   # #       #   #         #
# ####### ####### ### ##### ####### ### # ##### # # # # ##### ### ### ####### #
#         #     # #   #       #   #     #   #   #   #     #           # #     #
# ##### ### ### # # ########### # ##### ##### # ####### # # ######### # # #####
# #     #   #     #   #         #   #   #     #         #   # #       #       #
# ####### ########### # # ######### ##### ######### ### # ### # ### ##### #####
#       #   #   #   # # #   # #     #           # # #   # # # # # # #   # #   #
####### ### # # # # ### ##### # ### # ######### # ### ##### # # # # # # ##### #
#     #   # # #   # #   #     #   # #   #   # # #     #   #     # #   #     # #
# # ##### # # ##### # ##### # ### ##### ### # # # ####### ####### ######### # #
# #       #       #         #   #           #   #                         #   #
###############################################################################
