###############################################################################
# #         #   #   #               #               #               #         #
# # ### ### # # ### # ### # ### # ### ####### # ### # ########### # # ####### #
# #   # #   # #   #     # # #   # #   #     # # # # #     #     # # #   #   # #
# # ### # ### ### ####### ### # ### ### ### # # # # ##### # ### # # # # ### # #
# # #   # #   #   #   #   #   #     # #   #   #   #   #   #   # # # # #   #   #
# # # # # # ### ### # # ####### # ### # ##### ####### # # ### # ### ##### # ###
#   # # #   # #     #   #   #   #   #   #   #       # # #   # #   # #   # # # #
# ### # ### # ### ####### ### ### # ##### # ####### # ##### # ### # # # # # # #
# #   # # #     # #     #     #   # # #   #   # #   #   # # # # #   # #   #   #
# # ### # # ##### # # ######### ##### # ##### # # ##### # ### # # ### ### ### #
# # #   # # #   # # #   #     # # #   # #   # #       # # #     # #   #   #   #
# # ##### # ### # ##### # ### # # # # # # ### ######### # # ##### # ### ### ###
# # #   #       #     #   #   # # # #   # #           #   # #     #   #   # # #
# # # # ######### ### ### # ### # # # ### # ######### ### # ### ### # ### # # #
# #   #         #   #     # #       #     #   #     # #   #   #   # # #   # # #
############### ### # ################# ##### ##### ### # ### ### ### # ### # #
#         # #   #   # #       #   #     #     #   #   # #     #   #   # #   # #
# ######### # ### ### ### ### # # # ##### ##### # ### # ####### ### ##### ### #
#           # #   # # #   #     # #   #   #     #   # #   #   # #   #   #     #
### ##### # ####### # # ############# ####### ##### # ### ### # # ##### # ### #
# #   # # #     #   # #         #   # #     # #   #     #   # # #     # #   # #
# ### # # ##### ### # # ####### # # ### ### # # # ##### ### # # ##### # ### # #
# #   #   #     #     #   #   #   #     #     # #     #   # #   #     #     # #
# ##### ### ### # ### ### # # ##### # # ########### ##### # # ### ##### ##### #
#     #   #   # #   # #   # #     # # # #         #       # #     #     #   # #
# # ##### # # ##### ### ### ### # # # # # ####### # ####### ####### ##### # # #
# #   #   # #     # #   #     # # # # # # #   # # #     #   #     # #     # # #
# ### # ######### # ##### ########### # # ### # # # ##### # # ##### # # # ### #
# # # #         #   #   # # #         # # #   # # # #     # #       # # # #   #
# # # # # ##### ##### # # # # ######### # # ### # ### ##### ### ##### # ### ###
#   #   # #     #   # #   # # #     # # #   #   #     #   #   # #   # #   # # #
########### ### # ### ##### # # ### # # ##### # ####### ####### # # ##### # # #
#             #       #     # #   #   # #     #       #       #   #   #   #   #
# ########### # ##### ### ### ### ####### # # ######### ##### ####### # # ### #
#           # #     #     #     # #       # # #     #   #   #   #   # # # #   #
########### # ##### ########### # # ####### ### ### # ### # ### # # # # ### ###
#           #     #             #         #     #         #   #   #   #       #
###############################################################################
