###############################################################################
#     #       #                 #       #     # #   #   #           #         #
# ### # ##### # # ####### ####### ##### # ##### # # # ######### ### # ####### #
# #   # #   # # # #     # #       #   #   #     # # # # #     #   # # #     # #
# # ### # # # # # # ### ### ######### ##### ##### ### # # ### ### # # # # # # #
# #   #   # # # # #   #     #         #   #       #     # #     # #   # # #   #
# ### ##### # # ##### ### ### ### ##### # # ##### # # ### # ### # #############
# #         #   #   # # # #   # #       # # #   #   # #   #   # #     #       #
# ############### # # # ### ### ######### # ### ##### # ##### # ##### ### # ###
# #   #       #   # # #                 #       #   #   #     #     #   # #   #
# # # # ##### # ### # ####### ############# ##### # ##### ##### ### ### ##### #
#   # # #   #   #   #       # #           # #     #       #   #   #   # #   # #
# ### # ### ##### ######### ### ######### # ######### # ### # ##### ### # # # #
# #   # #   # #     #     # #   #     # # #   #   #   #     #   #   #   # #   #
### ### # # # # ##### ### # # ### ### # # ##### # ##### ####### ##### ### ### #
#   #   # #   #   #   #   #   # # #       #   # #             # #       #   # #
# ### ### ### ### # ### ##### # # ######### ### ######### ### ### ##### ### ###
# #   #     #   #   # #     #   #       #   #     #       #       # # #   #   #
# # ### ### ### ##### ##### ### ####### # ### # # # ############### # ### ### #
# #   #   # # #       #   # #     #     #   # # # #   #                 #     #
# ### ### # # ####### # # # ####### ####### ### # ### # # ### ######### #######
#   #   # # #   #     # # # # #   # #     # #   # # #   #   # #       # #     #
# ##### ### # ### ##### # # # # ### # ### # # ### # ####### ##### # ### # ### #
#     #     #   # #     # #   #   #   #   #   # # #   #     #     # #   # # # #
# # ######### # # # ##### ### ### ##### ####### # # ### # ####### # # ### # # #
# #         # #   # #   #       #                 # #   #   #     # # #   #   #
######### # # ##### # # # ### ##### ############### ##### # # ##### # # # #####
#         # #   #     # #   # #     #     #         # #   # # #     #   # #   #
# ########### ### ##### ####### ### ### # ####### # # # ### # # ### ######### #
# #   #   #   #   #   #   #   # #     # #   #     #   #   # # #   # # #   #   #
# # # # # # ### ### # ### # # # # # ### ### # ##### ##### # # ### ### # # # # #
# # #   # # #   #   # #     #   # # #   #   # #     #     # #   # #     #   # #
# # ##### # # ### ##### ######### ####### ### # ##### # ######### ########### #
#   #   #   #   # #   # #       #   #   #   # # #     #         #           # #
# ### # ####### # ### # # # ### ### # # ### # ### ####### ##### ########### # #
#     #   #   # #   # # # #   # #   # # # #   #   #       #     #   #       # #
######### # # # ### # # ##### ### ### ### ### # ### ####### ##### ### ##### # #
#           # #     #         #             #   #         #           #       #
###############################################################################
