###############################################################################
#       #       #             #       #   #       #       # #           #     #
# ### ### ### # # ### ####### ### ##### # # ##### # # ##### # # ####### # ### #
#   #     #   # #   # #   #   #   #     # #   #   # #     #   # #   #   #   # #
### ####### ####### # # # # ### # # ##### ### # ######### ##### # # # ####### #
# # #     #         #   # #     # #   #   #   # #   #       #   # # #       # #
# # ### ################# ##### ##### ### # ### # # # # ##### ### # ### ### # #
#   #   #   #         #   # #   #   #   #   #   # #   # #     #   #     # #   #
# # # ### # # ######### # # ##### # ### ##### ######### ####### ####### # # # #
# #   #   # # #         # #       # #   #   #       #   #     #   #     #   # #
# ##### ### # # ################### # ##### ####### # ### ### ### # ######### #
#       #     # #             #   # #     # #     # #       #     # #   #     #
######### ##### # ######### ### # # ##### # # # ### ####### ### ####### # ### #
#   #       #   #       # # #   # # #   #   # #     #     #   #   #         # #
# # # ####### ######### # # # ### # # # ### # ##### # ### ### ### ### ##### # #
# #     #   # #       #   # # # # #   #     # #     # #   #   #     # # #   # #
# ####### # # # ##### # # # # # # ### ##### # ##### # # ####### ##### # ### # #
#   #   # #   #     # # # # #   #   # #   # #     # # #   #   # #   # #   # # #
# ### # # ### ### ### # # # ### ### # ### # ##### ### ### # # # # # # ### ### #
# #   # #   #   # #   # # #   #   #   #   #   #   #   #   # # # # # #   #   # #
# # ### ### ##### # ### ##### ### ##### ##### # ### ####### # # ### ### ### # #
# # #       #     # #   #   # #       #       #         #   #   #   #     #   #
# # ######### ##### # ### # # ####### ######### ####### # ####### ### ####### #
# #   #     # # #   #   # # #       # #         # #   #   #   #       # #     #
# ### # ### # # # ##### # # ### ##### # ##### ### # ####### # ######### # #####
#   #   # #     #     #   #   #       # #   # #   #     #   #     #           #
# # ##### ####### ########### ######### # # # # # ##### # ####### ########### #
# # #   #     #   #   #     #   #   # #   # # # #     #   #     # #   #       #
# # # # # # ### ### # # # ### # # ### ##### # ### # ######### ### # ####### ###
# #   # # # #   #   # # #     # # #   #     #     # #         #     #     #   #
# ##### # # # # # ### # # ####### # # # ######### ### # ### # # ##### ### ### #
#     # # # # # # #   # # #   #     # # #     #   #   # #   # # # #   #     # #
####### ### # ### # ### # ### # ####### # ### ######### # # ### # ##### ### # #
#   # #     #     #   # #     #         # #   #   #   # # #       #   #   # # #
# # # ##### ######### # ################# ### # # # # ### ### ### # # ### # # #
# #   #   #   # #     #       # #       # #   # #   #     #   #   # #     #   #
# ##### # ### # # ########### # ### ### # # ### # ######### # # ### ### ##### #
#       #       #             #       #   #     #       #   # #     #   #     #
###############################################################################
