###############################################################################
#   #                 #           #                 #   #   #                 #
### # ######### ### ##### ####### # ######### ####### # # # # # ############# #
#   # # #       #       #   # #   # #       #   #     # # #   #       #       #
# ### # # ### ####### # ### # # ### ####### ### # ##### # ### ####### # #######
# #   # # # #   #     # # #   #           #   #     #   # #   #     # # #     #
# # ### # # ### # ####### ### ########### # ####### # ### # ##### # # ### ### #
# #   #   # #   #           #     # #   #   #     # # #   #     # # #   # #   #
# ### ### # # ############# ##### # # ####### ### # # # ####### # ##### # # ###
#   # # # #   #   #   #   #     #   # #       #   # #   # #     #     #   # # #
### # # # ### # # # # ### ##### ##### # ####### ######### # ######### ##### # #
# #   #     #   #   #     #   #       # #   #   #     # #   #           #   # #
# ##### ### ##### ####### # # ### ##### # # # ### ### # # ### ##### ##### ### #
#     # #       #     # #   #   #   #   # # #   # # # #   #   #     #     #   #
# ### ### ##### ##### # ####### ##### ### # ### # # ### ### ### ##### ### # ###
# # #         # # #   #   #   # #   #     #   #   #       # # #     # #   #   #
# # ########### # # ### # # ### # # # ################### # # ####### ####### #
#   # #   #       #     # # #   # # #           #       #   #     #   #     # #
### # # ### ##### ####### # # ### # ######### # ### ### ##### # # # # # ### # #
# #   #   # #   # # #       #     # #   #     #     # # #   # # #   # #   #   #
# ### ### # ### # # # ##### ### ### # # # ##### ##### # # ##### ##### ### #####
# #   #   #   # #   # #     #   # #   #   #   # #     # # #     #   #   # #   #
# # ### # # ### ##### ### ### ### ########### # ##### # # # ##### ####### # # #
# # #   #     #     #   #   #   #     #       #     # #   #   #         #   # #
# # # ##### # ##### ### ####### # # ####### ### ### # ##### # ######### ##### #
#   # #     # #   #   #   #     # # #       #   #   #       # #       # #     #
# ### # ####### # ### ### # # # # ### ### ##### # ### ####### # ##### # # # # #
# #   #   #   # #   #   # # # # # #   # #     # # # #   #   #   #     #   # # #
### ##### ### # ### # # # # ### # # ### ##### ### # # # # ####### ##### ### ###
#   #     # # # #   # #   #   #   #       #   #   #   # #     #   #   #   #   #
# ####### # # # # # ####### # ########### ##### ####### # # # # ### # ####### #
#       # # #   # # #       #     # #     #   #       # # # # #     #     # # #
### ### # # # ### ############### # # ##### ######### # ### ##### ####### # # #
#   # # # # # # #   #           # # #     #       #   #   #     # #     #   # #
# ### # # # # # ### # # ### ##### # ##### # ##### # ##### # ### # ### ### ### #
# # # # #   # #   #   #   # #     #       #     # # #     # #     #     # #   #
# # # # ### ##### ####### # # ######### ####### # # # ##### ####### ### ### # #
#   #     #               # #           #       #     #             #       # #
###############################################################################
