###############################################################################
#       #     #   # #     #     #           #   #   #       #   #           # #
# ##### # ##### # # # ### # ### ##### # ##### # # ### # ### # # # ######### # #
# #   # #       # # # # # # #         # #     # #     # #     # #         #   #
# ### ### ####### # # # # # # ########### # # # # # ### # ########### ### ### #
#   #   # #   #   # # # # # # #     #     # # #   #   # #   #   #     #     # #
### # # ### ### # # ### # # ### ### # ### ### ####### # # ### # # ##### ### # #
#   # #   # #   #   #     #     # #   # #   # #     # # # #   #   #     #   # #
# ##### ### # ####### ######### # ##### # ### # # ### # ### ####### # ### ### #
#     # #   #         #           #   #   #   # # #   #     #       #   # #   #
##### # # ### ### ####### # ### ### # # ####### # # ######### ########### ### #
#     # #   #   #         # # # #   #     #   # # # #       # #   #     #   # #
# ##### ### ############### # # # ####### # # # # # ### ### # ### # # # ### ###
# #     #   #               # # #   #   #   #   # #   # # # #   #   # # # #   #
# # ##### ### ############### # ##### # # ####### ### # # # ### ##### # # ### #
# #           #       # #     # #     # # #   #     #   #   #   # #   #       #
# # ######### ### ### # ### ### # ##### ### # ##### ##### ### ### # ### ### # #
# # #       #     # # #   #   # # #   # #   # #   #     # # #   #   #   #   # #
# # # ### ######### # # # ### # # # ### # ### # # # ### # # ### ##### ####### #
# # #   #           # # #   #   # #   #   # #   # # # # #   # # #   # # #     #
# # ### ######### ### # ######### ### ##### ##### ### # ### # # ### # # # # ###
# #   # #       # #   #         #   #         #   # # #   # # #     # #   # # #
# ##### ### ##### # # ####### # ### ######### # # # # ### # # ##### # ##### # #
# #   # #         # #   #     #   #           # # # # #   # # #     # #   #   #
# # # ### ### ##### ### # ####### ##### ####### ### # ##### # # ##### # # ### #
#   #   #   # #   # #   # #     #   # # #       #   # #   #   # # #   # #     #
####### ### # # # # # ### # ### ### # # # ##### # ### # # ### # # # ### # ### #
#   #   # # # # #   #     #   #   # #   # #     # #   # # #   #   # #   # #   #
# # # # # # ### ##### ####### # ### # ### ####### # ### # # ##### ### ### # ###
# # # # #       # #   #       #     # #     #     # #   # #   # # # #   # #   #
# # # # # ####### # ##### ########### # ### # ##### # ### ### # # # ### # ### #
# # # # #     # # #     #   #     #   #   # #   #   # #   # # #       # #   # #
# # # ##### ### # ##### ### # ########### # # # ### ### ### # ##### ### ### ###
# # #         # #       # # #   #   #     # # # #     #   # #     # #   # #   #
# # ######### # # # ##### # # # # # # ##### ### # ### ### # ##### # # ### ### #
# #     #     # # #     # # # # # #   #         #   #   #     #   # #   #   # #
# ##### ##### # ####### # # ### # ##### ########### ### # # ### ####### # ### #
#     #       #         #         #         #         #   #     #       #     #
###############################################################################
