###############################################################################
# #               #             #         #     #   #       # #       #     # #
# # ##### # ##### # ######### # ### ##### # ### ### # ##### # # # ### # ### # #
#   #   # #     # # #         #     #   #   #   #   #     # # # # #   # #     #
##### # ####### ### # ########### ### # ####### # # ##### # # # # # ### #######
#     #       # #   # # #     #   #   #     # #   #     # # #   # #   # #     #
# ########### # # ### # # ### # ### ####### # ##### # ### # ### # ### # ##### #
#   #   #     # # #   #     #     #       #   #     # #   #   # # # #   #   # #
### # ### ##### # # ##################### ########### # ##### ### # # ### # # #
#   #   # #   #   # #       #           # #   #     # #   # #   # #   #   #   #
# ##### # ### ##### # ##### # ######### # # # # ### # ### # ### # ##### #######
#     #   #         # #   # # #         # # #     # #   # #   # #     #       #
# ### ### # ####### # # ### # # ####### # # ####### ##### ### # # ### ####### #
# # #   #   #     # #   #   # #       # # # #       #     # # # # #           #
# # ### ### # ### ####### # ##### ### # # # # ####### ##### # ### # ####### ###
#   #   # # # # #   #     # #   # # # # # # #     #   # #   #     # # #   #   #
##### ### # # # # ### ####### # ### ### # # # ### # ### # # ##### # # # # ### #
# #   #     #   #   #         # #   #   #   #   # # #     #   #   # # # #     #
# # ####### ### ############### # ### ### ##### # # ### ### ### ### # # #######
#   #     #   #               # # #   #       # #     # # #       #   # #   # #
# ### ### ############# ##### # # # ####### ### ##### ### # ########### # # # #
#     # # #           #   #     # #       # #   #   # #   # #           # # # #
##### # # # ####### ##### ####### ####### ### ### ### # ##### ########### # # #
#       #   #     #     #     #         #     #       #   #   #           #   #
# ########### ### # ### ##### # ########### ######### ### # ### ###############
#     #     #   # #   #   #   #             #       # #   # #   #             #
##### # ### ### # ####### # # ##### ### ##### ##### ### ### # ### ### ####### #
# #   #   #   # #   #   # # # #   #   #   #   #   # #     # #   # #   #     # #
# # ######### ##### # # # ### ### ### ### # ### # # # ##### ### ### ### ##### #
#   #       # #   #   #   #     # #   # # #   # # # #   # #   #   # #   #     #
# ### ### ### # # ##### # # ##### # ### # ### # ### # # # ### ### # # # # #####
#     #   #     # #   # # #     # # #     #   #   # # #       # #   # # # #   #
### ####### # ### # # # # ##### # # # ##### ### # # ### # ##### # ### # # ### #
#   #   #   # # # # # # #           # #     #   # #     # #   #   #   # # #   #
# ### # # ##### # # # # ############### ##### ### ######### # ### # ### # # # #
# #   #   #     #   #   #           #   #       #   #       #   # #   # #   # #
# # ####### ######### # ######### # # ########### # ##### ##### # # # ####### #
# #             #     #           #               #       #       # #         #
###############################################################################
