###############################################################################
#       #   #       #     #         #       #     #     #       # # #   #     #
# # ### # ### ### ### # # # ####### # ##### # ### # ### ##### # # # # # ### # #
# # #     #   #       # # # #       # #   #     # #   # #     #   # # #   # # #
# # ##### # ### ####### ### # ####### # # ####### ### # # # ##### # # ### ### #
# #   #   #   #   #   #   # #   # #   # #             #   # #   #   # #       #
# ### ####### ### # # ### # ### # # ### ################### # # ##### # ##### #
#   #       #   # # #   # # #         # #   #     # #       # #   #   #   #   #
### ####### ### ### ### # # # ######### # # ##### # ####### # ### # # ### # ###
# #       #   #   #   # # # #     #     # # #     # #       #   #   # #   #   #
# ####### ### ### ### # # # ##### # # # # # # ### # # ##### ### ##### # #######
#       # # #     # # # # # #   # # # #   #   #   #   #   #       #   # #     #
# ####### # ####### # # # # # # ### # ######### ### ### # ####### # ### # ### #
#         #         # #     # #     # #         #   #   #   #     #   #   #   #
# ############# ### # ####### ##### # # ######### ####### ### # ######### # ###
# #     #     # #   # #     # #   # # # #   #   #   #   #     # #   #     #   #
# # ### ### ##### ### # # # # ### ### ### ### # ### # # # ### ### # # ####### #
# #   #     #     #   # # # # #     # #     # #   #   # # # #     # #     #   #
# ### ####### ##### ##### ### # ##### ### # # ### ##### ### ##### ####### ### #
#   #   #         #     # #   # #   #   # #     # #     #   #   #   #   # #   #
### ### # ####### ##### # # ### # # ############# # ##### ##### ### # ### # ###
# # #   #   # #       # # # #   # #   #       #   #     # # #     #   # # # # #
# # # ##### # # ####### # # # ### ##### ##### # ####### # # # ####### # # # # #
# #   # #   # # #     # #   #   #           #   #   #   # # #         #   # # #
# ##### # ### # # ### # # ##### ########### ### # # # # # # # ############# # #
# #       #   # # # #   # #   #       #   # # #   #   #   # # #       #     # #
# # ####### # # ### ##### # # ####### # # ### ### # # ##### # # ##### # ##### #
# # #       # #     #   #   #         # #   #   # # # #     # #     # # #     #
# # ### ########### # # ### ######### ##### ### ### # ### # # ##### ### # # ###
# #   #     #     #   #     #       # #   #       # #   # # #     # #   # #   #
# ### # ### ##### ########### # ##### # # ####### # ### ### ##### # # ##### # #
#   # #   # #   # #           # #     # #     # #   #   #   #     # #     # # #
# ### ### # # # # ### ##### # ### ######### # # ####### # ### ### # ##### ### #
#   #   # #   # #   # #   # #   # #         #   #   #     #   # #   #   #     #
# # # # # ##### ### ### # ### # # ### ######### # # ####### ### ### ### ##### #
# #   # # #   #   # #   #   # # #     #   #   # # # #   #   # #   # #   # # # #
# ##### ### # ### # # ##### # # ##### # # ### # # # # ### ### # # # # # # # # #
#     #     #     #       #   #         #   #     #   #   #     #     #   #   #
###############################################################################
