###############################################################################
# #           #           #       #     # #     #           #         #       #
# # ##### ### # # ### ##### ##### ### # # ##### # ######### ### ### # ### ### #
# # #   #   # # #   # #   # #       # # #   #   #     #   #     #   #   # # # #
# # # # ### # ##### ### # # # ##### # ##### # # ##### ### ############# # # # #
#   # #     # #     #   # # # # # # #     # # #   #   #   #     #   # #   #   #
##### ####### # ### # ### # # # # # ##### # # ##### ### # # ####### # ##### ###
#   # #     #   #   # #     # # #     # # # #   #   #   #   #     #       # # #
# # # # # ##### ##### # ####### ##### # # # ### # # # ####### ### ####### # # #
# #   # #       #   # # # #   #   # # # # # #   # # #     #   # # #         # #
# # ### ######### # # # # # # ### # # # # # # ### # ##### # ### # ########### #
# # # #   #       # # #   # #   # #     # # #     #     # #     #           # #
# # # # ### ####### # ### # ### # # ##### # ########### # ### ### ######### # #
# # # # #   #   #   #   # # #   # #   #   # #         # # #   # # #         # #
# # # ### ### ### ##### ### # ### ### # # # # ####### # # # ### # # ######### #
# # #     # #   #           #     #   # # #   # #   #   #   #   # # #     #   #
# ######### # # ### ### ####### ####### ##### # # # ##### ### ##### # ### # ###
#         #   #   # # # #     #     #   #   # # # #     #   # #     # # # #   #
####### # ##### ### # # ### # ##### # ### # # # # ##### # ### # ##### # # ### #
#       #   #   #     #     #     # # #   #   #   #   #   #   # #     # #   # #
# ######### # ### ########### ##### # # ########### # ##### ### # # ### ### # #
# #   #   # #   # #       #   #     # # #       #   #       #   # #   #   # # #
# # # # # # ### # # ##### ### # ##### # ### ### # ########### # ##### # # # # #
# # # # #       # # #   #   # #       #   #   # #         #   # #     # #   # #
# # # ### ####### # ### ### ##### ####### ### # ####### # # ### # ##### ##### #
#   #   # #     # #   #     #   # #   #   # # #   #     # # #   #   #         #
# ##### ### ### # ### ### ### # # # ### ### # # # # ####### # ### # # #########
#   #   #   #   #   #   #   # #       #     # # # # #     # #     # # #       #
### # # # ### ### # ### # ### ####### ##### # # ### # ### # ####### ### # #####
# # # # # #   #   #   # # # # #   #   #   #   #     # #     #     #     #     #
# # # ### # ### ##### # ### # # ### ##### ##### ##### # ####### ############# #
# # #     #     #   #   # # #   #   #   #   # #   # # # #     #     #   #     #
# # ############### ##### # ### # ### # ### # # ### # ### ### ### # # #########
#   #               #   # #   # #     # #   # #     # #   #   #   # # #       #
# ### ############# # # # # ### ####### # ### # ##### # ### ### ### # # # #####
#   #   #   #       # # # #   # #       # # # #   # #   #     # #   #   #     #
### ### # # # ######### # ### # # ####### # # # # # ######### # # ########### #
#       # #             #       #               #               #             #
###############################################################################
