###############################################################################
#     #       #     #             #     #     # #   #   #   #     #   #       #
# ##### ##### # ### # # ########### # # # ### # # # # ### # ### # # # # ##### #
# #     #   # #   #   #       #   # # #   # #   # #       #     #   #   #   # #
# # ####### # ### ########### # # # # ##### ### # ################# ##### ### #
# # #   #   #   #           #   # # #     #     #   #       #   #   #     #   #
# # # # # # ### ################# # # ### ######### # ##### # # # ##### # # ###
# # # #   #   #   #     #         # # # #   #     #       # # # #   #   # # # #
# # # ####### ### # ### # ######### # # ### # ### # ####### # # ### # ### # # #
# # # #     #   #   # # #         # #   # # # #   # #       # #   # #   # #   #
# # # # ### ### ##### # ### ##### # ### # # # ### ### ####### ### # ### ##### #
# #   # #   #   #     #     #     # # # # # #   #   # #   #   # # #   #     # #
# ##### # ### ####### ### ####### # # ### # ### ### # # # # ### # ### # # # # #
# #     # #   #       # # #       #       #   # # # # # # #   # #   # # # # # #
# # ##### # ### ##### # # ######### ######### # # # # # # # # # # # # ### ### #
#   #   # #     # # # # #         #     #     # # # # # # # # # # # # #   #   #
##### ### ### ### # # # ### ##### ### # ####### # # # ### ### # # ### # ### ###
#   #   # #     # # # #   #     # #   #         #   #   #   #   # #   #     # #
# ### # # ##### # # # ### ##### # # ################### # ##### # # ### ##### #
#     # #     # # #       #   # # #       #           # # #     #   #   #     #
# ##### ##### # # # ####### # # # ##### # ######### # # # # ######### ### # # #
#     #       # # # # #     #   #   #   #   #   #   # # #         # #   # # # #
# ##### ##### # # # # ######### ### ####### ### # ### # ######### # ### # # # #
# #   #   #   #   #     #   #   #         #   # # # # # #   #   # #   # # # # #
# # ##### # ##### ####### # ##### ####### ### # # # # # # # # # # # ### ### # #
# # # #   #       #       #     # # #   #   # #   #   # # # # #   #   #     # #
# # # # ####### ### ########### # # ### ### # ### # ### # # ### ### # ####### #
# # # # #   #   # # #     #   # # #   #     #     #   # # #   # #   #     #   #
# # # # ### # ### # # ##### # # # ### # ####### ##### # # ### # ##### ##### ###
# # # # #   # #   # #   #   # # #   # # # #     # #   #   #   #     #       # #
### # # # ### # # # ### # ### # ### # # # # ##### # ### ### ####### # ##### # #
#   #     #   # # # #   # #   # #   # # # # #   # #   #   # #       # #   #   #
# ### ##### ##### # ### # # ### # ### ### # ### # ### # ### # # ####### ### ###
# #   #     #     #   #   # #   #     #   #   #   #   # #   # #     #   # #   #
# ##### ####### ##### # ### # ### ### ### ### # ### ##### ### ##### # ### ### #
#     #     #   #     #   # #       # #     # #     #   # # #     # #   # #   #
# ### ##### # # # ######### ### ### # # # ### ##### # # # # ##### # ### # # ###
#   #         # #             #   # #   #         #   #   #       #     #     #
###############################################################################
