###############################################################################
# #       #               #         #   #                 #               #   #
# # ### # # ############# ### ##### # # ### ### ######### ### ### ####### # ###
#     # # # #           #     #     # #     # # #   #   #       # #   # # # # #
####### # # # ######### ####### ##### ####### # # # ### ####### ### # # # # # #
#       #   #   #     #   #         #   #   #   # # #   # #   #     # #   # # #
# ######### ### # ### ### # ####### ### # # ##### # # # # # # ####### # ### # #
# #           # # #   #   # #   #   # #   #   #   # # # #   #     #   #   # # #
# # ########### # ##### ##### # ##### ####### # ### # # # ##### ### ####### # #
# #   #         #     #   #   # #   #   #   #   #   # # #     # #   #       # #
# ##### ### ######### # # ##### # # ### # # ##### ### # ####### # ##### ##### #
# #   #   #         # # #     #   # #   # #       #   #         #     # #     #
# # # ### # ##### ### # ### ####### # ### ########### ######### ####### # ### #
#   #     # #   # #   # #           #   #     #       #       #   #   # # #   #
# ########### ##### ### ########### ### ##### # ############# ### # # # # # # #
# #   #     # #   #   #   #         #         # #           #   #   #   # # # #
# # # # ### # # ### ##### # ######### ######### # ##### ### # ########### # ###
# # #   #   # # #     #   # #   #   # #       #     #   # # #         #   #   #
# # ##### ### # ##### # ### # # # # # # ### # ####### ### # # ##### # ##### # #
# # #     #   #     # # #   # #   # # # #   # #       #   # # # #   #     # # #
### # ####### ##### # # # ### ##### # # # ##### ### ### # ### # # ####### ### #
#   #             # # # # #     #   # # #     # #   #   #       # #     #   # #
# ############### # # # # ##### # ### # ##### # ### ############# # ### ### # #
#   #       #     # #   # #   # #     #   #   # #               # #   #     # #
### # ##### # ##### ##### # # # ######### # ### # ############# # ### ####### #
#   #   # # # #   # #       #   #       # #     #   #         #   # #     #   #
# ##### # # ### # # # ####### ### # ### # ######### # ####### ##### ##### ### #
#   # # # # # # #   #   # # #     # #   # # #     # # #     # #   #     #     #
### # # # # # # ### # # # # ######### ### # # # ### # # ##### ### # # # ##### #
#   #   #   #     # # #   #         # # # #   #   # # # #   #     # # #     # #
# # ### # ####### # # ### ### ##### # # # ####### # # # # # # ##### # ####### #
# #   # #   #   # # # #     # #     # # # #     # # # # # #   #     #     #   #
##### # ### # # # # # ##### ### ### # # # # ### # # # # # ### # ######### # ###
#     # #   # #   # #   #   # #   # # #       #   # #   #   # # #       # #   #
# ##### # ### ##### ### # ### # # # ############### # ##### # # ####### # ### #
#       # # # #     #   #     # # #         #     # # #     # #   #     # #   #
# ### ##### # # ##### ########### ######### # ### # # # ######### # ### # # ###
#   #         #                   #           #     # #             #   #     #
###############################################################################
