###############################################################################
#       #           #   #         #     #               #     #   #       #   #
# ### ### ######### ### # ####### # ### # # # ##### ##### ### # # # ##### # # #
# # #     #       #   #   # #     #   # # # # #   # #     # #   #   #     # # #
# # ####### ##### ### # ### # ##### ### # # ### # ### ##### ######### # ##### #
#   #     #   # #     #     #       #   # # #   #   # # #     #       # #     #
### # # # ### # ##### ####### ####### ### # # ##### # # # # ### ### ### # ### #
#   # # #   # # #   # #     # #   #   #   #   #   #   #   #       # #   # #   #
# # ### # ### # # # # # ### # # # # ### ####### ####### ########### # ### # ###
# # #   # #   #   # # # #   # # # #   #     #   #       # #         # #   #   #
# # # ### # ####### ### # ##### # ### ##### # ### ####### # ######### # ##### #
# # # #   # #     #     # #     #   #     # #       #     #   #         #   # #
# # # ##### # ### # # ### # ####### # # ##### ##### ##### ### ########### # # #
# # #       #   # # #   #   # #     # #   #   #   #       #   #   # #   # #   #
### # ##### ##### ### ####### # ##### ### # ### # ######### ### # # # ### #####
#   #     # #     #   # #     #   #   # #     # # #   #     #   #   #   #     #
# ####### # # ##### ### # ####### ### # ####### # # # # ##### ####### # ##### #
# #   # # # #     # #   # #     #   # # #       #   #   #     # #     #       #
# # # # ### ##### # # ### # # # ### # # # ############### ##### # #############
# # #   #   #     #   #     # # #   #   # #       #     #     #         #     #
# # ### # ### ####### ##### # # # ####### # # ### ### # # ### ######### # # # #
# # #     #               # # # # #     # # #   #     # #   #   #     # # # # #
# # ### ####### ######### # # # # # ### # # ### ####### ### ### ### # # ### # #
# #   # #     # #   # #   # # # #   # #   #   # # #   #   #   #   # #       # #
# ### ### ### # # # # # ##### # ##### ####### # # # # # ##### ### # ######### #
# # #   # # #   # # # #       #     #       # # #   #   #   #   # # #     #   #
# # ### # # ##### # # ### ######### ####### # # ### ##### # # ### ### ### #####
# #   # # #       # # #   # # #     #     #   #   #   #   # # #   #   # # #   #
# # # # ### ####### # # ### # # ##### ### # ##### ##### ### # # ### ### # # # #
# # # #     #   #     # #   #   #     # # # #   # #     #     # #     # #   # #
# # # # ##### # ####### # ### ### # ### # ### # # # ########### ##### # ##### #
# # # #       #         # #   #   # #     #   #   #       #     #     #     # #
# ### ######### ######### # ####### # ##### ############# # ##### ##### ##### #
#         #   #   #     # # #       # # #         #   #   # # #       # #   # #
######### # ##### ### # # # ### ##### # # ### ### # # # ### # # ##### # # # # #
# #       # #     #   #   # #   #     #   #   # # # # #   # #   #   # # # # # #
# # ####### # ### # ##### # # ### ######### ### # # # ### # ##### # # # # # # #
#         #     #   #     #   #             #       #     #       #   #   #   #
###############################################################################
