###############################################################################
#   #                 #   #   #                     #   # #     # #   #       #
# ### ##### ########### # # # # ### ############# # # # # # # # # # # # # #####
#     #   #   #         #   # # #   #           # #   # #   # # # # # # #     #
# ####### ### ############### # ##### ######### # ######### # # # # # # ##### #
#         # #         #     # #     #   #   #   # #   #   # # #   # #       # #
######### # ### ### # # ### # ##### # # # ### ### # ### # # # ### # ######### #
#       # #   #   # # #   # #     # # # #   #   # #     # # #   # # #       # #
##### # ### ##### # ##### # # ##### # # ### ### ### ##### ### # ### # ##### # #
#     #   #       #       # #     # # #       #   # #   #   # #     # #   #   #
# ####### # ############### ##### # # # ########### # ##### ######### # # ### #
#       # #     #         #     #   # #   #   #     #     #   #       # #   # #
# ##### # # ##### ####### # ####### ##### # # ##### # # ##### # ### ### ### # #
#     # # # #     #     # # #   # #       # #     # # #     #   # #       # # #
##### # ### # ##### # ### # # # # ####### ### ### # ##### ##### # ######### ###
#     #     #   #   #       # # #   #         # # # #     #   #   #       #   #
############### ############# # ### # # ####### ### # ##### # ##### ##### # # #
#     #     #   #       #     #   # # # #     #     #   #   #       #     # # #
# # # # ### # ### ##### ### ##### # # ### ### ##### ### # ########### ####### #
# # #     #       #   #     #   # #   # #   #     #     # #   #   #   #       #
# # ##### ####### ### ####### # # # ### ### ##### ##### # # # # # # ### #######
# #     # #   # # # #   #   # #           #     #   #   #   # # #     # #     #
# # ### ### # # # # # # # # # ####### # # ##### ### # ####### ####### # # ### #
# # #       # #     # # # # #   #     # #     # # # #   #   # #     # #   #   #
# ### ##### ### ##### ### # ### # ########### # # # ### ### # # ### # ### # ###
# #   #   # #   #         # # # #     # #     # #   #       #     # #   # #   #
# # ### # ### ####### ##### # # ### # # # ##### # # ####### ####### ### ### # #
# #     # #   #     #     #   # #   # # # #     # #   # #     #       #   # # #
# ####### ##### ### ##### # # # # ### # # # ##### ### # # ##### # ####### ### #
# #     # #     # #   # # # # # #   # # #   # #   #   #     #   # #   #       #
# ### # ### ##### ### # ### ####### # # ##### # ### ####### # ### # # ####### #
#   # # #   #   #   # #   #     #   #   #   #   #   #     # # #   # #     # # #
### ### # ### ### # # ### ### # ######### ### ### ##### # ### ##### ##### # # #
#   #     #       # #   # #   #       #     #   # #     #   #       # #   # # #
# # # ##### ####### ### # # ######### # ### ### # # # ##### ######### # ### # #
# # #   #   #     #   # # #   #       # # #   # # # # #     #     #     #   # #
# # ### # ### ### ### # # ##### ####### # # ### # ### # ##### # ### ##### # # #
# #     #     #     #           #         #     #     #       #     #     #   #
###############################################################################
