###############################################################################
#       #   #     #     # #   #     #   #   #         #   #         #         #
### # ### # # # ### ### # # # # ### # # # # # ### ##### # ####### # # ### #####
#   # #   # # # #   #   #   # #   # # #   #   # #   #   #   #   # # # #   #   #
# ### # ### ### # ### ### ### ### # ##### ##### ### # ##### # # # # ### ### # #
# # #     #   # #   #   #   #   # # #   # #     #   #     #   #   # #   #   # #
# # ######### # ### ### ##### ##### # # # ### ### ####### ######### # ####### #
#   # #       # #   #   #   # #   #   # #     #   #     #   #     # # #     # #
### # # ####### # ##### # # # # # ##### ##### # ### ### ### ### # # # # # # # #
#     #   #     #     #   #   # #     # #     #       #   # #   # #   # # # # #
# ####### ### ####### ####### # ##### # # ############### # # ######### # # # #
# #           # #     #     # # #   # # #     #   #       # #           # #   #
# # ### ####### # ### # ### ### # ### # ##### # ### ##### # ##### ####### #####
# # # #       # # # # #   #   # #   # #   # #   #   #     # #   #   # #       #
# # # ##### # # # # # # ### # # # # # ### # ### # # ####### # # ### # # ##### #
# # #       #     #   # #   #   # # #   # # #   # # #     # # #   #   # #     #
### # ############# ### # ####### # ### # # # ### # # ### # # # # ##### ##### #
#   #             # #   #       # #     # #   # # # # #   #   # # #     #     #
# ##### ######### # ########### # ####### ##### # ### # ####### # # ##### #####
#   #     #   #   #   #       # #   #     #     #     #       # #   #   #     #
### # ##### # # ##### ### # ### ### # ##### ##### ######### # # ####### ##### #
#   # #     #   #   #   # # #   #   #     #   #       #   # #   #         #   #
# ##### ########### ### # ### ### # ##### # # ##### ### # ####### # ##### # ###
#     # #         #     #   # # # #     # # #   #   #   # #       # #   # #   #
##### # ##### # # ### ##### # # # ##### # # ### # ### ##### ### ### # # # # # #
#   # #   #   # #   # #     # # # #   # # # #   # #     #   # # #   # # # # # #
# # # ### # ### ##### # ##### # # ### # # # # ### # ##### ### # # ### # # # ###
# # # #   #   # #   #   #     #       # #   # #   #       #     #   # # # #   #
# # # # ##### # # # ### # ############# ##### ############### ### # ### # ### #
# #   # #     # # #     #             #             # #     # #   # #   #   # #
# ##### # ##### ########### ######### ### ######### # # ### ### ### # ##### # #
#     #   #               #   #       # # #     #   # # #   #   #   #     #   #
# ### ################### ##### ### ### # # ### # ### # # # # ### ### # ### ###
# #   #       #   #     #       #       # #   #   #     # #   #   #   #     # #
# # ### ##### # # ### ########### ####### ### ########### ##### ### ######### #
# # #   #   #   #   # #   #     # #     #   # #           #   # # # #   #     #
# # # ##### ##### # # # # # ####### ####### ### ########### # # # # # # # ### #
# #           #   #     #           #           #           #   #     #   #   #
###############################################################################
