###############################################################################
#   #         #     #             # #             #             #       #     #
# ### # ##### # ### ### ### ##### # # ##### # ##### ########### ##### # ### ###
#     # #   #   # #   # #   #       # #   # #     #     #       #   # #   #   #
# ##### # # ##### ### ### ######### # # # # ##### # ##### ####### # # ### # # #
#   #   # # # #     #   # #       # # # # # #   #   #   # #     # #   #   # # #
### # ### # # # ### ### # # ##### ### # # ### # ##### # # ##### # ##### ##### #
#   #     # #     #       # #   #     # #     #       # # #     # #   #       #
########### ##### ######### # # ####### ############### # # ### # # # #########
#     #   #     # # #       # #   #   #       # #     #   # # # #   #         #
# ##### # # ### # # # ### ##### # # # ####### # ##### ##### # # ####### ##### #
#     # # # #   #   # # # #     # # # # #   #     # #         # #     #   #   #
# ### # # ### ####### # # # ##### # # # # ####### # ########### # ### ##### # #
#   # # #     #   #   # #   # #   # #   #     #               # #   #     # # #
# ### # ####### # # ### ##### # ### # ### # # # ##### # ##### # ### ##### # ###
# #   #         # # #         # #   # #   # #   #     #   #       #   #   #   #
### ########### # # # # ####### # # ### ### ### # ####### # ##### ### # ##### #
#   #     #   # #   # #         # # #   #   #   # #       #   #   #   # # #   #
# ##### # # # # ### # ############# # ####### ### # ### ##### # ### ### # # # #
#       # # # #   # #       #       #   #   # # # #   # # #   # #   #   #   # #
######### # # ##### ####### # # ##### ### ### # # ### # # # # # # ### # ##### #
#       #   #   #   #       # #       #   #   #     # #   # # # #   # #       #
# # ########### ##### # ##### ####### # ### # ####### ### # # # ### ###########
# # #     #   #     # # #   #       #   # # # #         # # # # #   #         #
# # # ### # # ##### # # # # ############# # # # ######### # # # # ### ####### #
# #   #   # #     #   # # #     #         # # #   #   #   # # #   # #     # # #
# ##### ### ##### ##### # ##### # ####### # # ### # # ### # # ##### ##### # # #
# #     #   #   # #     # #   #   #   #     # #   # #     # # #     #     # # #
# # ##### ### ### # ##### # ######### # ####### ### ####### # ### # # ##### # #
# # #     #         #   # #     #     #       #   #     #   #     # # # #     #
# # # ### # ######### # # ### # # ########### ##### # ### ######### # # # #####
# #   #   #     #     # #     # #     #     # #     # #   #     # # # # # #   #
### ### ####### ### # # ####### # ### ##### ##### ### # ##### # # # # # # # # #
# #   # #     #   # # #   #   # #   #   #   #   # #   #       # #   # # # # # #
# ##### # # ##### # # ### # # ######### # ### # ### ################# # # ### #
# #     # # #     # # #   # #   #   #   # #   #       #     #       # # #   # #
# # ####### # ####### # ### ### # # # # # # ######### # ### ### ### # # ### # #
#           #         #     #     #   # #           #   #         #   #       #
###############################################################################
