###############################################################################
#     # #             #         #     #     #         #                       #
# ### # # ########### # ##### # # ### # ### ####### # ########### ########### #
#   #   # #   #     #   # #   # #   #   # #         #       #   # #     #     #
# # ### # ### # ### # ### # ### ### ##### # ############### # # ### ### # ### #
# # #   #   # # #   # #   #   #     #   #   #       #     #   #     # # # #   #
# # ####### # # # # # # # ### ### ### # ##### ##### # # ##### ####### # # ### #
# #   #   # # # # # #   #   #   # #   # #       #   # #       #   #     #   # #
# ### # # # # # # ######### # # ### ### # ####### ### ######### # # ####### ###
#   # # #     # # #       # # #   #   #   #     #   #     #     # #       #   #
# ### # ####### # # # ##### # ### ### ####### # ### ####### ############# # # #
# #   #   #     # # #   #   #   #         #   #     #   #   #   #     #   # # #
# # ### ### ##### ##### # ##### ########### ######### # # ### # ##### # ### # #
# #     #       #   #   # #   #     #       #       # #   #   #     #   #   # #
######### ######### # ### # # ### ### ##### # ####### ####### ####### ####### #
#           #     # #     # # #   #   #   #         # # #     #     # #   #   #
########### # ### # ####### # # ### # ### ### ##### # # # ######### # # # # ###
#   #     # # #     #       #     # #     #       # #   # #       #     # #   #
# # # ### ### # ######### ##### ### ##### ####### # # ### ### ### ####### ### #
# #   #       # #       # #   # #   #   #   # #   # #     #   # #   #   #     #
# ####### ####### ##### ### # ### ### # ### # # ### # ##### ### ### # # #######
# #     # #       #     #   # #   #   #       # # # #   #     #   #   #       #
# # ### # # ####### ##### ### # ### ### ####### # # ### # ### # ############# #
#   #   # #     #   #   #   #   #   #   #       # #     # # # # #       #     #
##### ####### ### ### ##### ##### ### ### ####### ####### # # # # # # ### #####
#   # #       #   #     #   #     # # # # # #             # # #   # # #   #   #
# # # # ####### ### ### # ### ### # # # ### # ############# # ##### ### ### # #
# # #     #   #   # # #     # # # #       #   #   #       #   #     #   #   # #
# ######### # ### # # ####### # # ####### # # # # # ##### # ### ### # ### ### #
#   #   #   #     #   #       # # # # #   # # # # # #   # # #     # # #     # #
# # # # # ########### # ####### # # # # # # ### # # # # # # # ### # # # ### ###
# # # #   #         # #       # #   # # # #     # # # #   # #   # # #   # #   #
# # # ##### ####### # ####### # ##### # # ####### # ####### ##### ####### ### #
# # # #   #       # # #   #   #     #   # #       #               #   #     # #
### # # # ####### # ### # # ##### # # ### # ####### ########### ### # # # ### #
#   #   # #       #   # # # #     # # #   # #   #   #       #   #   # # #     #
# ####### # ######### # # # # ##### # ##### # ### ######### ##### ### # #######
#           #           #     #     #       #             #         #         #
###############################################################################
