###############################################################################
#   #       #       #         #         #         #   #     #             #   #
# # ##### # # ### ### # # ##### ##### # ##### ####### # ##### ####### # ### # #
# #       # # # #     # # #     #     # #     #     # #   #   # #   # #     # #
# ########### # ####### # # ##### ##### # ##### # # # ### # ### # ########### #
#         #   #       # # #     # #   # #   #   # # #       #   #     #     # #
# ####### # ### ### # # ####### # # ### ### # ### # ######### ####### ##### # #
#       #   #   # # # #         # #   #   # # #   #   #     #   #   #     # # #
####### ####### # # # ########### # # ### # # ####### # ### # # ### # ### # # #
#     # #       #   #     #   #   # #       #     # #   #     #   # #   #     #
# ### # # # ##### ####### ### # ################# # ##### ####### # # ##### ###
# # # # # # #   #       #     #   #               #   #         # #   #     # #
# # # ##### # ######### ##### ### # ########### ### ### ####### # ##### ##### #
# #   #     #       #   #     #   #     #       #   #   #     # #           # #
# ### # ########### # ### ##### ####### # ##### # # # ##### # # ########### # #
#   # #   #     #   # #   # #   #   #   # # #   # #   #     # #   #         # #
# # # ### # ### # ### # ### # ### # ####### # ### # ##### ### ##### ######### #
# # # # #   #   # #   #   # # #   #   #     #   # # #       # #     #         #
### # # ##### ### # ##### # # # # ### # # ### ### # # ####### ##### ### ##### #
#   #   #     #   # #   #   # # # # #   #   # #   #   # #     # #     # #     #
# ####### ####### # # # ### # ### # ####### # # ####### # ##### # ### ### ### #
#   #     # #     # # #     #     #   #     # # #       # #   #   # #     #   #
# # # ##### # ##### # ############# ### # ### # ##### # # # # ##### ####### ###
# #   #     #       # #         #   #   #     #     # # # # #         #     # #
# ### # ### ######### # ### ### ### # ############# ### # ####### # ####### # #
#   # # #   #   #   # #   #   #     # #   #   #   #     #       # # #       # #
# ### # # # # # # # # ### ### ####### ### # # # # # ########### # ######### # #
# #   # # #   # # # #   #   # #           # #   # # #       #   #     #   # # #
# # ### # ####### # ### ### # # ######### # ##### # # ####### ####### ### # # #
# #   # # #   #   # #     # #   # #   #   # #     # #       # #       #     # #
##### ### # # # ### # ##### ##### # # ##### ####### ####### # ### ### # ##### #
#     #   # # #   # # #     #     # #       #     # #     # #   # #   #   #   #
# ##### ### # ### # # # ##### ### # ### ##### ### # ### ### ### # ##### ##### #
# #   #     #     #   #   #   #   # #   #     #   #     #     # #     #   #   #
# # # ### ############### ##### # # ##### ##### # ##### # ### # # ### ### ### #
# # #   #   #   #   #   #     # # # #   #     # #     # # # #   # #   # #   # #
# # ### ##### # # # # # ##### # # # # # ##### # ####### # # ####### # # ### # #
#     #       #   #   #         # #   #       #         #           #     #   #
###############################################################################
