###############################################################################
# #                   #       #     #   #   #     #   #     #   #             #
# # ##### ########### ##### ### ### # # # # # ### # ### ### # ### ##### ##### #
# # # #   #         #     #   #   #   #   #   # # #     #   # #       #     # #
# # # # ######### ####### # # ### ############# # ####### ### # ########### ###
#     #         #       # # #   #   #         # #         #   # #         #   #
##### ### ##### ### # # # ##### ### # ####### # ########### ### # ####### ### #
#   # #   #   #   # # # #         #   #     # #     #           #       #   # #
# # ### ### # ### ### ############# ##### # # # # ### ##### ########### ### # #
# #   # #   # #   #   #     #     # #     # # # # #   #   #   #   #   #   #   #
# ### # # ### # ### # # ### # ### # ### # ### # # # ### # ### # # # # ### #####
# # #   # #   #   # # # # # # # # #     # #   # #     # # # #   # # #   #   # #
# # ##### # ##### # ### # ### # # ######### ### ####### # # ##### # # # ### # #
# #       #     # # #   # #   # #   #     # # #   #   # # #       # # #     # #
# ############# # # # ### # ### ### # ### # # # ### # # # ### ##### # ####### #
# #     #     #     # #   # #     #   # # # #   #   # # # # # # #   # #       #
# # ### # ### # ##### # ### # ### ##### # # ##### ### # # # # # # ### ### ### #
#     # # # # # #   # #   # #   #   #     #       #   # # # # # # #   #   #   #
####### # # ##### # # # # # ### ### # # ########### ### # # # # # # ### ### ###
#   #   # #   #   # # # #   #   # #   # #     #   #     # # # # # # #   #   # #
# # # ### # # # ### # ##### # ### ##### ##### # # # ##### # # # # # ### # ### #
# #     # # # #   # #     # # #     #         # # # #   #   #   # #     #     #
# ##### # # ### # # # ##### # ### # # ######### # ### # # ####### ########### #
# #   #   #     # #   #     #   # # #       #   #     #   #       #       #   #
# # # ####### # # ### ##### ### ### ####### # ############# ####### ##### # ###
#   # #       # #   #       # #   #     # # # #           #         #   # #   #
##### # # ##### ############# ### # ### # # # # ######### ######### # # # ### #
#     # #     # #   #   #       # #   #   # # # #       #   #     #   # #   # #
# ##### ##### # # ### # ### ##### ### ##### # # # ##### ### # ### ##### ### ###
#   # #   #   #   #   #   #       #   #     #   # #     # # #   #   # #   #   #
# # # ### ##### ### # ### ######### ### ### ##### # ##### # # # ### # ### ### #
# #     # #   # # # # # # # #         # # # #     #       # # # # # #   # #   #
# # ##### # # # # # # # # # # ####### ### # ##### ####### # # # # # # # # # ###
# # #     # #     # # #   #       #   #   #             # # # # #   # #   #   #
# # # # ### ####### # ### ######### ### # ####### ##### ### ### # ##### ### # #
# # # #   # #       #   #     #   #   # #       # #   #   #     # #   # #   # #
# # ##### # ### ######### ### # ### # # # ####### ### ### ### ### # # ### ### #
# #       #     #           #   #   #   #               #     #     #     #   #
###############################################################################
