###############################################################################
#     #   #       #   #           #   #   #   #     #                     #   #
# # # # # ### ### # # # ### ##### # # # # # # ### # # ############# ##### ### #
# # # # #     #   # # # # #     #   #   #   #   # #   #       #   #   #   #   #
### # # # ##### ##### # # ##### ############### ####### ##### # # ##### ### # #
#   #   # #   #     # # #         #       # #   #   #   #   #   #       #   # #
# ####### # # ##### # # ######### # ##### # # # # ### ### # ############# ### #
# #     # # #   # #   #       #   #   #   #   #   #       # #       #     # # #
# # ### ### ### # ### ####### # ##### # ### ### ####### ##### ##### # ##### # #
#     #       # #       #     #     # # #   #   #       #     #   # #   #     #
# ############# # ####### ########### # ##### ### ##### # ####### # # # ##### #
#   #         # #   #   #         #   #       # # #     # #       # # #     # #
# ### # ##### # ### # # ######### # ########### # # ##### # ##### # ### ### ###
# #   # #   # #   # # #     #     # #     #     # # #   # #     # #   #   #   #
# # # # # ### # # # # ##### # ### # ### ### ### # # # # # ##### ##### ####### #
# # # # #     # # # #     #   #   #   #       #   #   # # #       #   #       #
# # # # # ####### ############# ##### ##### ##### ####### # ##### # ### ##### #
# # # # # #       #           #     # #   # #   #   #   # #   # #   #   #     #
### # # # ##### ### ######### # ### ### # ### # ### # # # ### # ##### ### ### #
#   # # #       #   # #     # #   #     #     #   #   #     # #       #   #   #
# ### # ### ##### ### # # # # ### ####### ####### ### ####### # ####### ### ###
#   # #   # #     #     # # #   # #   #   # #   #   #   #   # #   #     # # # #
### # ### ### ##### ##### ##### ### # # ### # # ### ##### # # # # # ### # # # #
#   #   #         # #   #     #     #   #   # #   #       #   # # #   # # #   #
# ### # ############# # ##### ########### ### ### ############# # ### ### ### #
# #   #       #       #       #           #   # #       #     # # # #   #     #
# ########### # ############# # ##### # # # ### ### ### # ### ### # ### # #####
# #     #   # # #   #       # # #   # # # # #     #   #   # #     #   # # #   #
# ### # ### ### # # # # ##### ### # ### # # # ### ### # ### ######### # # # # #
#     # #       # #   #   #   #   # #   # # # #     # # # #         #   #   # #
# ##### # ####### ####### # ### ### # ##### # # ####### # # # ##### ######### #
#   #   #     #     #     #     #   #     # # #         #   # #     #       # #
### # ####### ####### ### ##### ### ##### # # ############### ####### ##### # #
# # #   #   #   #     #   #   #   #       # #   #           # # #     #   # # #
# # ### # # ### # ##### ### # ### ######### ### ####### ### # # # ####### # # #
# #   # # # #     #   # #   #   #         #   # #       # # # #   #       #   #
# ### # # ### ##### # # ##### # ######### ### # # ####### # # ##### ##### #####
#     #       #     #         #         #     #   #                 #         #
###############################################################################
