###############################################################################
# #   #     #     #   #   #   #     #       #   #                 #           #
# # # # ### ### # # # # # # # ### # # ### ### # # ### ########### # ####### # #
# # # #   #     # # #   # # #   # # #   #     #   #   #   #       # #       # #
# # # ### ####### ####### # ### ### ### ######### # ### # # ######### ####### #
# # #   # #       #       #   #   #             # # #   #   #     #   # #   # #
# # # ### ### ##### ######### ### ############# # ### ####### # # # ### # # # #
# # #       # #     #         # #     # #       #   # #     # # # #   #   # # #
# # ####### # ### # # # ####### ##### # # ######### # # # # # # ##### ##### # #
#   #   #   #   # #   # #           # #     #   # # # # # # # #           # # #
##### # # ##### ##### # # ######### # ##### # # # # # ### # ############# # # #
#     #   # # #     # # #         # #   #     #   # # #   #               #   #
# ######### # ##### ### ### ##### # ### ####### ### # # ################### ###
#       #   #     #     #   #   # #   # #     # #   #   #     #       #     # #
####### ### ##### # ##### ### # # ### # # ##### # ####### ### # # ##### ##### #
#     #   #     #   #   # #   # # #   #   #     # #   #   # #   #     # #     #
# ### ### ##### ##### ### # ### # # ### ######### # # # ### ######### # ##### #
#   #     #   #     # #   # # # # # #   #       # # #   #     #       #   #   #
### ####### # ### ### # ### # # ### # ### # ### # # ##### # ### ######### # # #
#       #   #     #   # #   #       #   # #   #   #       # #   #   #     # # #
# ##### # # ####### ##### ######### ### ##### # ########### # # # # # ##### # #
# #       # #     #   # #       #   # #     # # #     #     # # # #   #     # #
# ########### ### # ### # ##### # ### ##### # # # ### ##### # ### ######### # #
# #           # #     # #   #   # #   #       #   # #     # #               # #
# # ########### ##### # ### # ### ### # ########### # ### ######### ##### #####
#   # #         #   # # # # #   # #   # #     #   #   # #   #   #   #   # #   #
##### # ### ##### # # # # # ### # # ### # ####### # ### ### # ### ### # ### # #
#     #   #       # # # #   #   #   #   #   #     # #   #   # #     # # #   # #
# ### ### ##### ### # # ##### ##### # ##### ### ### # ### ### # ##### # # ### #
#   # #   #   #   #         #     # # #   #   # #   #   #     # #     # # # # #
### ### ##### ############# # ### # # # # ### # # ##### ### ##### ### # # # # #
#   #   #   #   #       #   #   # # #   # #   # # #     #   #   #   # #   #   #
# ### ### # ### # ##### # ##### # ####### # ### # # ##### ### # ##### ####### #
#     #   #   #   # #     #   # #       # # #     #         # #   #   #     # #
# ##### ### ### ### # ##### # # ####### # # # ######### ##### ### # ### ### # #
#       # # #   #     #     # # #     # #   #         # #     # # #     #   # #
######### # ##### ######### # # ### # # ############# ### ##### # ####### ### #
#               #         # #       # #                   #               #   #
###############################################################################
