###############################################################################
#           #             #   #     #     #     #     #                   #   #
# ##### ### # ##### ##### # # ##### # # ### # ### # ### ######### ####### # # #
#   # # #     #   # #   # # #   #   # # #   #     #     #         #     # # # #
### # # # ##### # # # # ### ### # ### # # ######### ##### ######### ### # # # #
# # # # # #   # #   # # #   #   # #   # # #     #   # #   #       # #   #   # #
# # # # # ### ####### # # ### ### # ### # # # ### ### # ####### ### # ####### #
# #   # # #     #   # #   #   #     #   # # #   #   # # #       #   #   #     #
# ### # # # ### # # # ####### ##### # ### # ### ### # # # ### # # ##### #######
#     # # #   #   #         # #   # #   # #   #       #     # # #     #       #
####### ##### ############# # # # ### # # ########### ##### # ####### ####### #
#       #     #   #     #   # # #   # #   #           #   # #       # # #     #
# ##### # ####### # # ### ### # ##### ##### ########### # # ### ### # # # #####
#   #   # #         # # # # # #     # #   #   #       # # #   # # # # #     # #
# # ### # ### ####### # # # # ##### ### # ### # ### ### # ### # # # # ##### # #
# #   # # #   #     # # # # #       #   #     # # #   # # #   #   # #     #   #
##### # # # ### ### # # ### ######### ######### # ### # # ##### ### ##### #####
#     # #   #     # # # #         #   #   #       #   # # #     #       #     #
# ############### # # # # ### ##### ### # # ##### # ### # ####### # ######### #
#   #             # # #   # #     #   # #   #   # #   # #     #   # #       # #
# # # # ### ####### # # ### ##### ### ####### # ##### # ##### # # ### ##### # #
# #   # # #       # # # #     # #   #   #   # # #   # #   #   # # #     #   # #
# ##### # ####### # # # ### # # ### ### # # # # # # # ### ### # ### ### # ### #
# #   #   # #     # # #   # #   #     # # #   #   #     #   #   #   # # #     #
# # # ### # # ####### ### # ### # ##### # ########### ##### ### # ### # #######
#   #   #   #         # # # #   #       # #   #     # #   #   # #   # # #     #
# ######### ########### # # ### ######### ### # ### # # # # # # ### # # # ### #
# #         #   #       # #   # #     # #   # #   #   # #   # # #   #   #   # #
### ########### # ### ### # # # # # # # # # # ### ##### ##### ### ### ### # # #
#   #           #   # #   # # # # # # #   # #     #   #   # # #   #   # # # # #
# ##### ########### # # ### # # ### # ##### # ##### # ### # # # ### ### # # # #
# #   #             #   #   # # #   # #     #   # # #     # # #   #   #   # # #
# # # ####### ####### ####### # # ### # ####### # # ####### # # # ### ##### ###
#   #       # #     # #     # #   #     #         # # #     # # #   #     #   #
######### # # # ### # # ### # ######### ######### # # # # ### ##### ##### ### #
# #       # # # #   #   #     #       # #       # # # # # #   #     #   #   # #
# ######### ### # ############# ##### ### ### # ### # # # # ### ##### # ### # #
#               #               #         #   #     #   #       #     #       #
###############################################################################
