###############################################################################
#               #     #                             #                 #     # #
# ######### ### ### # # ########################### # # ##### ####### # ### # #
#     #     # # #   # #     #         #   #         # #     # #   #   #   # # #
### ### ##### # # ### ##### # # ##### # ### ######### ##### ### # ### ### # # #
#   #   #     #   # #       # # #   # #   # # #       #   #   # #   #     #   #
# ### ### ### ##### # ####### ### # # ### # # # ######### ### # ### ######### #
# #   #   # #   # #   #   #       # #     #   #   #       # #     #     #   # #
### ### ### ### # # ### # ######### ##### ### ### # ##### # ########### # ### #
#   # #   #     # # #   #     #   #     # #   # #   #   # #   #         #     #
# ### # # ##### # # # ####### # # # ### # # ### ##### # # # ### ##### ####### #
# #     # #   #   # # #     #   # #   # # # #     #   # #   #   #   # #     # #
# # ##### # # ### # # # # ####### ### # ### ### # # ####### # ### # ### ### # #
# #   # #   # #   # # # #       # #   #         #   #     # #     #     # # # #
# ### # ##### ##### # ######### # ######### ######### # # # ############# # ###
# #   #     # #     #           # #       # #     #   # # #   #     #     #   #
# # ##### # # # ############### # # ##### ### ### # ### # ### # ### ### # ### #
# #       # #     #           # #   # #   #   # # # #   #   #   #       #   # #
# ####### ####### # ######### # ##### # ### ### # # # ######### ####### ##### #
# #   #   #   #   #   #   #   #     # #     #   #   #           #   #   #   # #
# # # ##### # # ##### # # # ####### # ####### # ################# # ##### # # #
#   #   #   # #     # # # #       # #   #     #   #   #         # #       #   #
# ##### # ### ##### # # ##### ##### # # # # ##### # # # ####### # ### #########
# # #   #   #   #   # #   #   #   # # #   #   #     # #   #       #   #   #   #
# # # ##### ### ### # # # # ### # # # ####### ####### ### # ########### ##### #
#   #       # #   # # # # #     #   #   #   #   #   # # # # #   #       #     #
### ######### ### # # # # ############# ### ### ### # # # # # # # ####### # # #
# # #   #       # # # # #       #     #     # #   # # # # #   # #   #   # # # #
# # # # # # ##### # # # # ####### # # ##### # ### # # # # ##### ### # # ### # #
#   # #   #     # # # # #   #     # # #       # # #     #   #   #   # # #   # #
# ### ######### # ### # ### # ##### ### ##### # # ##### ### # ### ### # # ### #
# #         #   #     #   #     # #     #   #   # #   #   # #   # #   #   #   #
# ########### ################# # ####### # ### # # # ### # ##### # # ##### ###
#       #   #             #   #       #   #   # #   # #   #       # # # #   # #
####### # # ######### ### # # ### ##### ##### ##### # # ############# # # ### #
# #   # # #   #       #   # # #   #     #   # #   # # # #       #     # #   # #
# # # # # ### # ####### ### # ##### ##### ### # # ### # ### ### ### ### ### # #
#   #     #     #           #       #           #     #     #       #         #
###############################################################################
