#######################################
# #         #         #     #   #   # #
# ######### ####### ##### ### ### ### #
#   #   # # # # # #   # # #     #     #
### ### # # # # # # ### # # ######### #
#     # #         # # # # # # #     # #
##### # ####### ### # # # # # ### ### #
#   #   # #   # #   #       #   #   # #
# ##### # ### # ### ####### # ### # # #
#   #   # #     #   # # #   #   # #   #
### # # # # ### ### # # # ### ### ### #
#   # #     #       #         #     # #
### ####### ##### ##### ####### ##### #
#   # #     #                       # #
# # # ##### ######### # # # ###########
# #   #     #         # # # #         #
# # # ######### ##### # ##### # #######
# # #           #     #       #     # #
# ### # ### ##### # # # # ##### ##### #
# #   # #   #     # # # # # # #       #
### # ##### ### ### # ### # # # #######
#   # #     #   #   # #       #       #
#######################################
