#######################################
# #   #   #   # #     # #   #   # #   #
# # ##### # ### # ##### # ### ### ### #
# # # # # # # #     # #           # # #
# # # # # # # ### ### # ########### # #
# #   # #   # # # # #   #     # # # # #
# # ### ### # # # # ### # ##### # # # #
# # #     # # # #         # # #       #
# # ##### # # # ### ####### # # #######
# # # #     #   # # # #       # #     #
# # # ##### # ### # # # ####### # #####
#   # # #   # # #   #         #       #
### # # ### # # # ### ######### # #####
#   # # # # #   #   # #   # # # #   # #
# # # # # # # ### ### # ### # # ##### #
# # #   #         #     #           # #
### ### ##### ##### ##### ########### #
# #   # # #                           #
# ### # # ### ##### ##### #############
#       # #     # #     #         #   #
# ##### # # ##### ##### ### ##### # # #
# #                   # #       #   # #
#######################################
