#######################################
#     #   # #       #     #   # # # # #
### # # ### # ### # # ##### ### # # # #
#   #       # # # # #     #   #   #   #
##### # ### # # ##### ##### ##### # # #
#     # #     #     #         # #   # #
# ### ####### ### ### ######### # #####
# #   #         #         #     # # # #
##### ### # # # # ########### ### # # #
#   # #   # # #   # # #   #   #       #
### ######### ### # # # ### ### ##### #
# #   #       #     # #             # #
# # ############# # # # # ######### ###
#                 #     #         #   #
################# # # ### ### ##### ###
#                 # #   #   #     #   #
### ####### ### # # ### ####### ##### #
#   #       #   # #   #       #   #   #
### ##### # # ### # ####### ### ##### #
#     #   # # #   # # #   # # # #   # #
# ####### ### # # # # ### ### # # #####
# #         # # # #           #       #
#######################################
