#######################################
#   # #                   #           #
# # # # ####### # # ####### ### ### # #
# #     # #     # #           #   # # #
# # ##### ### # # # ### ##### ### # ###
# # #         # # #   #     #   # #   #
# # ### ##### ### # # # ####### ##### #
# # #   #       # # # #       # #   # #
### # ##### # # # ### # # ####### #####
#   # #     # # #   # # #             #
####### ##### # # # # # # ### ### ### #
#       #     # # # # # #   #   #   # #
##### # ####### ### ### # ####### ### #
#     # #         #   # #       # # # #
# ##### ### # ##### ### # ### # ### # #
# #   # #   #     #   # #   # #     # #
##### ####### # # # ### # ### ### #####
# #           # # #   # #   #   #     #
# ##### # ### ####### # ### # # #######
#       # #         # #   # # #   #   #
# ### # # # # # # ##### ### # ##### # #
#   # # # # # # # #       # #       # #
#######################################
