#######################################
# # #           #       #       #     #
# # ### ##### # # # # ### ########### #
#   #       # #   # #   # #   #       #
# ##### # # ### ##### ### # ### #######
#   #   # #   #     #       #   #     #
# ##### ####### ### ######### ### #####
# #   # #     # # #         # # # #   #
# # ### # ####### ########### # # # ###
# #         # # #     # #   # #     # #
# # ####### # # # ##### # ### # # ### #
# # # #   # #     # # #   # # # #   # #
# # # # ####### # # # # ### # ### ### #
#   #   # # # # # # #     # # # #   # #
### # ### # # # ### # ##### # # # ### #
#   # # # #       #     #     # #     #
### # # # # ######### ### ##### # # ###
#   # # #   # # # #   #   #   # # #   #
### # # ### # # # # ##### ### # # ### #
# #   # # # # #     # # # # #       # #
# ### # # # # # ##### # # # # ##### ###
#                                 #   #
#######################################
