#######################################
#                 #         #         #
# ### ##### ### # ### # ##### ### #####
# #   #     #   #     # #       #     #
########### ####### # ### ####### #####
#           #       #           #     #
####### ### # ##### ### ### ####### # #
# # #   #   # #     #     #       # # #
# # ########### ### ### ######### ### #
#               #     #       # # #   #
######### ####### # # # ### # # ##### #
#         #       # # #   # #     #   #
# ### ### ##### # # # ### ### # # # # #
# #   # # #     # # #   # #   # # # # #
# ### # ####### # # # ####### # # # # #
# #   #         # # # # #   # # # # # #
### ### # # # ### # ### # ##### # #####
#   #   # # #   # #         #   #     #
# # ### # ### ### # # ### # ####### # #
# # #   # #   # # # #   # #   #   # # #
# ######### # # ### ### ### ### #######
#   #       # #       #   #           #
#######################################
