#######################################
#           #                     # # #
########### ############# ######### # #
# #                                   #
# ### ####### ####### # ########### ###
#     #       #       #           #   #
### # ####### ######### # ######### # #
#   # #       #     # # # #       # # #
### # ### # ####### # # # # ##### ### #
# # # #   # #           #     # #   # #
# ### ### # # # ### # # # # ### #######
#     #   # # # # # # # # #       # # #
##### ####### ### # # # # ##### ### # #
#     #       #     # # #     #     # #
# # ####### ####### # # ### ##### ### #
# # #       #       # #   #     #     #
# ### ##### # # # # # # # # ###########
# #   #     # # # # # # # #           #
######### # ######### # # ########### #
#   #     # #   # #   # #     #     # #
### ### ### ### # ### # # # ### #######
#       #   #         # # #           #
#######################################
