#######################################
#                                     #
# ####### # # # ##### ##### ### ### # #
#   #     # # #   #   #       #   # # #
### ####### ### # ### # ### ### #######
#   #   #     # # # # # # # #         #
# ##### # ####### # # # # # # # #######
# #             # #   # #   # #       #
####### # # ### # # ### ##### # ##### #
# #     # #   # # # #     #   #     # #
# ### ##### ### ######### ### # # # ###
#     #       # # # #       # # # #   #
### # # # # ##### # ### # # ####### ###
#   # # # # #           # # #         #
# ### ### # # ############# # # # # ###
# #   #   # # # #           # # # # # #
### ####### ### ##### # ####### ### # #
# # #       #         # #       #     #
# ### # ### ### ##### ### ####### # # #
#     # # # #   #     #   #       # # #
######### ### ##### ##### ##### ### # #
#             #     #       #   #   # #
#######################################
