#######################################
# #         # #     # # # # #   # # # #
# ####### ### ##### # # # # ### # # # #
#       # #   # # #     # # # #     # #
### ### # ### # # ##### # # # ##### # #
#     #   # #   # #   # #       #   # #
# # ##### # ### # ### # ####### ### # #
# # # #             # # #   # # #   # #
##### ########### # # # # ### # ### # #
#             # # #   #   #         # #
######### ### # ### ##### ######### # #
#       # #   # #             # # # # #
##### # ### ### ############# # # # # #
# #   #     #                       # #
# ######### ##### ####### ######### # #
#       #         #       #       # # #
### ### ########### ### # # ### # # # #
#   #               #   # # #   #   # #
# ################### ####### ##### # #
# #   # #             # #     #       #
##### # ####### # ##### # ########### #
#               # #       #           #
#######################################
