#######################################
# #         #   #   #       #       # #
# ######### # ### ### ####### ### # # #
# # #     # #   # #   #         # #   #
# # ##### # ### # # ### ####### #######
#               # #           #       #
# # ##### # # # # # # # ##### ### # ###
# # #     # # #     # # # # #   # #   #
######### # ##### ##### # # ####### ###
#         #   #       #           #   #
# # ### # # # # # # # # # ##### #######
# # #   # # # # # # # # #   #         #
# ### ### ##### ### # # # # ###########
#   # #   #     #   # # # #   # # # # #
# ### # ### ### ### # ### # ### # # # #
# #   # #   #     # #   # #   #   #   #
# # ### # # # ### ### # # # ### ### ###
# # #   # # # #     # # # #           #
####### ##### ### # ##### # ### # # ###
# # #   #     #   #     # # #   # #   #
# # ####### # # ### # # # ####### # ###
#           # # #   # # #       # #   #
#######################################
