#######################################
#       # #             # # #   # #   #
# ####### ####### # ### # # ### # ### #
# # # # # #       # # #   # #   # #   #
# # # # # ####### ### # # # ### # ### #
# #   # #         #     #   #       # #
# # ### ################### ####### # #
# #     #       #                 # # #
# # ### ####### ####### ######### # # #
# # #                   #         #   #
# ############### ### # ######### ### #
#                 #   # #             #
##### ### ##### ########### # ##### # #
#     #   #   # #         # #   #   # #
### ### ##### ### ### ### ### # # # # #
# # #   # #       #   #       # # # # #
# # ##### ##### ######### ##### ### ###
#   #       #   #     #   # #     #   #
### # # ### # ### ### ##### ### # # ###
#   # # #     #   #             # #   #
# ##### ############# ############# ###
# #     #             #               #
#######################################
