#######################################
#     # # # # # # #     #   # #       #
# ##### # # # # # ### ##### # ### #####
#   # # #         # #   # #         # #
### # # ##### ##### # ### ##### ##### #
#     # #           # #       #   #   #
# ### # ####### ##### # ######### ### #
# #           # # #   # # #   #   #   #
# ########### # # # ### # # ##### # ###
# #           # # # #   #   #     #   #
# ### ####### # # # # ### ### ##### ###
# #   #     #       # # # #   # #     #
# ### # # # ##### ### # # # ### # # ###
# #   # # #         # # # # #     # # #
# ### ### ### # # # # # # # # ### ### #
# #   #   #   # # #             #   # #
# ######### ### ##### # # # ### # ### #
# #         #   #     # # #   # #     #
# # ### ### ### ### # # # # ### # ### #
# # #   #   #   #   # # # #   # #   # #
####### # ### # # # # # # ####### # ###
#       #   # # # # # # #       # #   #
#######################################
