#######################################
#   # # #   #   #     # # #   #     # #
# # # # ### ### # ##### # # ### # ### #
# #           #   # # # #     # #     #
# # # # ##### # ### # # # ##### #######
# # # # # # # #   # #       # #   #   #
### ### # # # ### # # ####### # # # ###
#   #   #     #   #     # #     #     #
# ######### # ### # ##### # ###########
# #     #   #                 # #   # #
# # ### # ######### ####### # # # ### #
# # #     #     #         # #         #
# # # # ### ### ### ##### # # # #######
# # # # # # #       #   # # # # # #   #
# ####### ####### ### ######### # # ###
# #         #             #   # #     #
### ##### # ### # # # ### # ##### ### #
#   #     #     # # # #   #   #     # #
# ##### ### ##### # ##### # # # #######
# # # # #   #     #     #   #       # #
# # # # ### ### ### ##### ### # # ### #
# #     #   #     #     #   # # #     #
#######################################
