#######################################
# #   # #     # #   #     # # #     # #
# ### # # ##### ### # ##### # ##### # #
# # #   # # # # #         # # # #     #
# # # # # # # # ##### ### # # # # #####
# # # # # #             #     # # #   #
# # ### # ####### ####### ##### # # ###
#       #         # # #     #       # #
##### ### ### # ### # ### # # ####### #
#   #   # #   # # #   # # # #         #
### # ##### # ### ### # ##### ### ### #
# #         #     # #     # # #   # # #
# ##### # ### ##### # ##### # # ### # #
#       # #             #   # # #   # #
############# ### ### # # ### ##### ###
#     #         # #   #     #   #     #
### # ##### # ### ### ### ### ##### # #
#   #       # # #   #   #     # #   # #
### # # ### ### # # ########### # #####
#   # # #     #   #                 # #
# # # # ### # # ### # # ### ### ### # #
# # # # #   # # #   # #   # #     #   #
#######################################
