#######################################
# #   #   # # # #   # # #   #       # #
# ### # ### # # # ### # # ### # ### # #
# #     # #   #   #   #       #   #   #
# ##### # ### # ### ### ############# #
#   # #   # #   #       # # #     # # #
### # # ### # # # # ##### # # ##### ###
#         # # #   #   # #       #     #
####### ### # ######### # ####### ### #
#   #       #   #     # #   # # # # # #
### ####### # ### ##### # ### # # # ###
# #     #   #   # #   # #       #   # #
# ##### ### # ### # ### ### # ##### # #
#         #         #   # # # # # #   #
# # ##### # ######### ### # ### # # ###
# # #           # #   # #           # #
# ### ### # ##### ### # ### # ##### # #
# #   # # #             #   #     #   #
##### # # # # ####### ### # # ####### #
# # # #   # #       # #   # # #     # #
# # ####### # ### ### # # ### # # # # #
#           # #     #   #   #   # # # #
#######################################
