#######################################
#                           # #       #
# ####### ####### ########### # #######
# #     # #     #   #   # #           #
# # ### ### ######### ### # ###########
#   # #   # # #       #   #   #       #
# # # ##### # # ##### # ##### # #######
# #     # #         #     # # #     # #
# ####### # # ##### ####### # ### # # #
#     #   # #     #     # #       # # #
# # ### ### ##### # ##### # ######### #
# #           # # #       # #   # # # #
# # ### ####### ########### # ### # # #
# #   #           #     #             #
# # # # # ### ##### # # # # ### #######
# # # # #   # #     # #   #   #     # #
# ######### ### ##### # ### # ####### #
#   #   # #         # #   # # #       #
# ### ### ##################### #######
#     # #   #   # # #     #   #       #
# ##### # # # ### # # ##### ### #######
#         #                           #
#######################################
