#######################################
#               #                 #   #
####### ### # # # ### ### ##### ### ###
#         # # #   # #   #     #       #
##### ### ### # ### # # ######### ### #
#       #   # #     # #       # #   # #
# # ### ####### # ### ######### #######
# # #         # #   # #             # #
### # # ### ########### ##### # ### # #
#   # #   #                 # #   # # #
### # ##### ######### ### ######### # #
#   #   #         #   #         # #   #
##### # ### ##### # # ######### # #####
#     #   #     # # #   # # # #   #   #
# # ### # # # # # # ##### # # # ### ###
# # #   # # # # # # # #   #   # #     #
### # ### ##### # # # # ### ##### #####
#   #   #   #   # #         #   #     #
# ### ##### # ### ### ### # # ### #####
#   # #     #   #   # #   #           #
# ####### # # # # # ############# # # #
# #       # # # # #             # # # #
#######################################
