#######################################
#   # #   #             # #   #     # #
### # ### ### ########### # ### ##### #
#   # # # #       # #     #   # # #   #
### # # # # ##### # # ####### # # ### #
#       # # # #   #                   #
##### # # ### ### # ######### #########
# #   # #   #   # #     #   #       # #
# ##### # # ### # ### ##### ######### #
# #   # # #     # #   # # #         # #
# ### # ##### # # ### # # ### ### # # #
#         # # # # # #           # # # #
####### ### ### # # # ######### # ### #
#         #     #       #   # # #   # #
##### ### ##### ### ### # ### ####### #
#   # # #   # # #     # #       #   # #
### ### ### # # # ####### ####### ### #
#           #         #         #     #
##### ##### ### ####### ######### ### #
#     #                 # #         # #
##### ### ##### ##### # # # ### ### # #
#     #   #         # #       # #   # #
#######################################
