#######################################
# # #       # #   # #     # # # #   # #
# # ##### ### ### # ### ### # # # ### #
#         # # #   # #   # #         # #
######### # # ### # ### # # ######### #
# #       # # # # #   # #     #   # # #
# ####### # # # # ### # ### # # ### # #
#   # #   #   #     #       #   # #   #
### # # ##### # ##### ########### # ###
#   # #   # # #   #   # # # #     #   #
# ### # # # # # ### ### # # # ### # # #
#   #   #   #           #       # # # #
### ####### # ########### ##### ### ###
#       # #             # # # # #   # #
# ##### # ### ########### # # ##### # #
# #         # #     # # # #   #     # #
# # ####### # # ##### # # # ### ##### #
# # #           #   # #     # # #   # #
# ##### # ### ### ### # ##### # # ### #
# #   # # #   #                   # # #
# ### ####### # ######### ######### # #
# #                     #             #
#######################################
