#######################################
#   #                     # #   #     #
### ### ### ############# # # ### #####
#     # #   #   # # # #         #     #
# # # ### ##### # # # # ##### ### ### #
# # #     #   # #           #       # #
### ### ##### # ##### # # ####### ### #
# # #   # # #         # #     # # #   #
# ####### # # # ##### ### ### # ##### #
#     # # #   # #     #     #     #   #
# ### # # ####### # # # ### ### ##### #
# #   # #         # # # #     # # #   #
### ### ##### # # ### # # # ### # #####
# #           # # #   # # #   #     # #
# ########### # ##### ### ######### # #
#             # #       #     #       #
# ### ### ### # ### ### # ### # # #####
#   # #   #   # #   #   # # # # #     #
# ####### ### # ######### # ##### ### #
# #       #   #   #         # #     # #
### # # # ### ##### ### # ### ##### # #
#   # # # #     #   #   #       #   # #
#######################################
