#######################################
#           # #           #         # #
########### # # # ######### # # ##### #
#       #       #           # #       #
# ##### # # ##### ##### ##### #########
# # #     #     # # # #     #     #   #
# # ##### ### ##### # ##### ##### # ###
# #       #         #     #     # #   #
# # ### # ##### # ### # # # ####### ###
# # #   # #     #     # # #     #   # #
# ####### ### # ##### ### # ##### ### #
# # #       # #     #   # # #   #     #
### # ### # ### # # # ##### # ### #####
#     #   #   # # # #   #             #
####### # ##### ##### ### # # # #######
#       # #         # #   # # #       #
##### ##### # # ####### ##### # # ### #
# #   #     # #     # # #   # # #   # #
# ##### ### # # # # # # ### # # # # ###
#   #     # # # # #   # #     # # #   #
# ### # ####### ### # # ### # ### # # #
#     #     #   #   # #   # #   # # # #
#######################################
