#######################################
# #       #               #   #       #
# # ##### ######### ##### # ### #######
#   #     #     #   #     #   #     # #
### ### ##### ##### ### # # ### ##### #
#   # #   #       # #   #   # # #     #
# ### ### ##### ### ##### # # # # #####
#   #       #     # #     #           #
####### ### ### ########### ### #######
# # # # #                   #   # # # #
# # # ### # # ########### ##### # # # #
#         # # #             #       # #
# # # # ### ##### # ##### ##### # ### #
# # # # #   #     # #         # #     #
# ### ### ### ####### # # # # # # # # #
# #   #   # # # #     # # # # # # # # #
# # ##### # ### ##### # # ### # # #####
# # #     #         # # #   # # #     #
# ####### ### # ### ### ### # ### # ###
#   #   # #   # #     # #   #   # #   #
# ##### ### # # ### # # ### ######### #
# #         # #   # #   #         #   #
#######################################
