#######################################
# # # #   #     #       # #   #       #
# # # ### ### # ### ##### # ### #######
# #     # #   # # #   #       #       #
# ##### # ##### # # ### ####### #######
#   #     #   #   # #         #   # # #
### ##### # ### ### ### ####### ### # #
# #   #       # #   # #   #   # #     #
# ### ##### ### # ### # ##### # ##### #
#   # #   #   # #   #   #   # # #   # #
# ### ### # ### # ### ##### # # ### # #
# # # #     #   # #   # #   #         #
# # # ##### # ### # ### # ### ####### #
#   # #   # # #         #         #   #
# # # ### # # # ##### ### ##### # # # #
# # #               # #       # # # # #
### # # ### ######### # ####### # #####
# #   # #     #     #         # #   # #
# ######### ### ############# # ### # #
# # # # #     # # #     #   # #   # # #
# # # # # ##### # # ##### ####### ### #
#                             #       #
#######################################
