#######################################
# #         #       # # #       # # # #
# # ##### ### ####### # ### ##### # # #
#       #       #   #         # #   # #
### # # # ####### ####### ##### # ### #
# # # # # #   #         #   #   #   # #
# # ####### ### ######### ### ### ### #
# #   # # # #     #   #             # #
# ### # # # # ### # ##### ### ####### #
#     #       # #         # #         #
##### # ### ### ####### ### ######### #
#   #     #   #     # #     #     # # #
### # ##### # # ##### # ##### ##### ###
#         # #   #   # #   #     #     #
# # # # ##### ### ### ##### ##### #####
# # # #   #     # #                 # #
# # # # ######### # ########### ##### #
# # # #     #     # #         #     # #
# ######### # ##### # # # # # # ##### #
# #       #   # #     # # # # #       #
# # ########### # ### # ##### ### # ###
#                   # #     #   # #   #
#######################################
