#######################################
# #       # #   #   #       #       # #
# ### ### # ### ### ##### ### ####### #
#     #   # #             # # #     # #
### ##### # # ########### # # # ##### #
# # #   # # # # #           #   #   # #
# ##### # # ### ######### ##### # ### #
#     #           #       # # #     # #
### ### ### ##### ####### # # # ##### #
#       #   #   #         # #         #
### ##### # # # ######### # # ### #####
# # #   # # # #                 #     #
# ##### ################# ### # # #####
#         #   #         #   # # #     #
### ##### # ### ### # # # # # ####### #
#   #     # #   #   # #   # #       # #
# ##### # # ### ### # # # # ##### ### #
# #     #     # #   # # # #     #   # #
####### ### # # # ##### ### ### #######
#     # # # #   # #     # #   #       #
# ### ### # ########### # ### # # #####
# #             #           # # #     #
#######################################
