#######################################
#     #         #           #     #   #
##### ######### ##### # ######### # ###
# #   #       #       #     # # #     #
# # # ##### ##### ##### ##### # ### ###
#   #   # # #     # #         # #   # #
####### # # ####### ##### ##### ### # #
#   #   # # # #         # #   # #     #
# # ### # # # ##### # ### # ### # ### #
# #     # #   #     # # # #   # #   # #
####### # ### ####### # # # ### # #####
# #   #     #       #     #   # # #   #
# ### ##### ### ### ### ##### # # # # #
#     #   #   # #   #               # #
##### # ##### ### # # ######### # # ###
# #     #         # # #   #     # # # #
# ### # ### ####### ##### ### # # ### #
# # # #       #     #     #   # # #   #
# # ####### ### ### ##### # # # ### ###
# #         #   #     #     # #     # #
# # ####### ##### ### ### ### ##### # #
#   #       #     #         #     #   #
#######################################
