#######################################
#           #         #     #   #     #
########### ####### ### ##### ### #####
#   # #   #     #                     #
### # ### ##### # ##### ######### ### #
# # #   #           #         #     # #
# # ### # # # # ### # # ### # # # ### #
# #       # # # #   # # #   # # #   # #
# ##### ### # # ####### ### # # # #####
#   # #   # # #   #     #   # # #     #
### # # ### ### ### # ### # # ####### #
#         #   # #   # #   # # # #   # #
### # ### # # ### # # ### ### # # #####
#   # #   # # #   # # #   #           #
# ### # ##### ####### # # # ### ### # #
#   # #     #   #     # # #   # #   # #
# # ### ##### ### # ### # ##### ### ###
# # #     #   #   # #   #     #   #   #
### ### ### ############# # ### # # # #
# #   # # # #             #   # # # # #
# # # ### ### # # ### # ######### ### #
#   #     #   # # #   #         # #   #
#######################################
