#######################################
# #   #         #           #   #     #
# # ####### # ### ##### # ### ### #####
#           # #       # #         #   #
### ####### # # # ### ########### # ###
#   #       #   #   #     # # # #   # #
# ### # ##### ### ### ##### # # ##### #
# #   # #       #   #   #   #   #     #
### # ### ### # ####### # ### ### #####
#   # # #   # #     #   #     # # #   #
# ### # # ##### # # ##### ##### # # ###
#   # #       # # #           #       #
### # ### # # ### # # # # ### # # ### #
# # # #   # #   # # # # #   #   #   # #
# ##### # ### # # ### # ### # # #######
#       #   # # # #   # #   # #   #   #
##### ####### # # # # # # # ### ### ###
# #       #   # # # # # # #   #       #
# # # # ### # ### ### # # # ### # # ###
#   # # #   # # #   # # # #   # # # # #
# ### # # ##### ### ### # # # # # ### #
# #   # #         # #   # # # # #     #
#######################################
