#######################################
#                 # # #               #
# # ########### ### # # ##### #########
# # #                       #         #
# ### ######### ### # # ### ### ##### #
#   # # # # #     # # #   # #       # #
##### # # # # # ### # #################
# #   #       #   # #         #   #   #
# ######### # ##### ### # ##### ### ###
#           #   # # # # #     #     # #
# # ####### ### # # # ### # # # ### # #
# # #         #   #     # # #     # # #
### ### # ### # ################# # # #
#   #   #   # # #               # #   #
### ### # # ####### ##### # # ### #####
#     # # # #           # # #   #     #
# # # ### ### # ##### # # # # ### #####
# # # #       #   #   # # # #   #   # #
### # ####### ##### ####### ### # ### #
# # # #           #     #   # # #     #
# # ### # ### ########### ### ####### #
#   #   # #             #           # #
#######################################
