#######################################
#       # #                   # # #   #
##### ### # ######### ### # ### # # # #
# #   # # #     # # # #   # #     # # #
# ### # # # ##### # ####### # ### ### #
#     #       # # #       #     #   # #
# ### ### ##### # # ##### # # # ##### #
#   #         #         # # # # #   # #
# ##### # ##### ### ### ### # ### ### #
# # #   #         #   #   # #         #
### ##### # # # ##################### #
#     #   # # #             #     #   #
# ### # # # # ### # ##### ### ##### # #
# #     # # #   # #   # #     #   # # #
####### # # # # ### # # # # ### #######
# #     # # # # #   #   # #     #   # #
# # # # ##### ####### # ### # ### ### #
#   # #   #       #   #   # # #       #
# ##### # ### ##### ####### # # #######
#     # # #       # # # # # #     #   #
### # ### ##### ### # # # ########### #
#   # #   #     #                     #
#######################################
