#######################################
#             # #                 #   #
# ### # ### ### ### # # # ### # ##### #
#   # #   #         # # #   # #   # # #
# ##### ############### # # ##### # # #
#     #     #         # # # # # # #   #
# ### # ##### ### ### ### # # # ### ###
#   # #   # #   # # #   # #     #   # #
# ######### # ##### # # # ##### # # # #
#       #     #   # # # #   # #   #   #
# # ####### # # ### # # # ### #########
# # #       #   #   # # # #           #
# ### # # ### ### ####### # ##### #####
#     # # # #         # #       #     #
# # # # ### ##### ### # # # # # ### ###
# # # #         # # #   # # # #   #   #
# # # # ######### # # ##### ### #######
# # # #       #     #     #   #     # #
### # # # ### ########### # # ### ### #
#   # # #   #       #   # # #   #     #
# ##### # # ######### ### #############
#     # # #             #             #
#######################################
