#######################################
#       #         #       #         # #
####### ######### ####### ######### # #
#         #             # # #   #     #
######### ##### ### ### # # ### ##### #
#       #       # # #       # #   #   #
### ### ######### ### ##### # ### # ###
#     #   #       # # #   #           #
### # ### ####### # ### # ####### # # #
#   #   #           #   #   #     # # #
### ##### ### # ### ##### # ######### #
#     #   #   # #         #           #
# # ##################### ##### ### # #
# #     # #                 #   #   # #
# ####### ### ##### ##### # # # # # # #
#     # #     #     # #   # # # # # # #
# # # # ######### # # # ####### ### ###
# # # #           # #   #       #     #
# ############# ### # ### ##### ### ###
# #           # #   # #   #       # # #
######### ### ### # # # ####### ##### #
#         #       # # #   #           #
#######################################
