#######################################
#     #   # #     #     #         #   #
# # ##### # ### # ##### # # ####### ###
# #       #     #         #   # #     #
######### ##### # ##### # ##### # ### #
# #   #       # # #     #           # #
# # ### ### # # ##### # # ### # #######
#       #   #   #     # #   # #       #
# ##### # ########### ##### # ##### ###
#   #   # #               # # #       #
# # ######### ####### ######### ##### #
# # #       # #               # #     #
# ##### ### # # ##### ### ### # ##### #
#   #   #     # #       #   # #   #   #
# # # # ##### ### ### # # # # # ##### #
# # # # #   #   # #   # # # # # #     #
### ### # # ### # ### ##### # # ### # #
#   #   # #     # #       # # # #   # #
####### # ### ##### # # # ##### # #####
#       #   # #     # # # #   # #   # #
# # ##### # ##### ### ### ### ### ### #
# # #     #   #   #     #     #       #
#######################################
