#######################################
#         # #                     #   #
# ##### # # # ### ##### # ### # ##### #
# # # # #   # #   # #   #   # # # #   #
# # # ### # ##### # # ### # ##### # ###
# #   # # #   #   # #   # #       #   #
# ### # ### ### ### # ### ########### #
#   #   #   # #   # # #   #         # #
####### ### # # ### ##### # ######### #
#           # # #   #   #           # #
######### ### # # ### ############### #
#   #   # #   #         # #   # # #   #
### ### # ### # ######### # ### # ### #
# #   #           # #   # #   # #   # #
# # # ####### # ### # ### # ### # ### #
# # #   #     # #       # # #     #   #
# ##### ### # ### ####### # # ##### ###
#   #       # #     #         #       #
# ########### # ##### # # # ### # # ###
#   #                 # # # #   # #   #
### ######### # ### # ##### # ### ### #
#             #   # #     #     # #   #
#######################################
