#######################################
# #               #     #             #
# # ### ### # ##### ### # # # ####### #
#     #   # # #     # #   # #   #   # #
# # ##### ### # ##### ############# ###
# #     #   #                 #   # # #
# # ####### # # # ####### ### # ### # #
# # # # #   # # #     #   #       #   #
# # # # # ### # ####### ### ##### # ###
# #     # #   #     #   #   #   #   # #
# # # ### # # # # ##### ##### ####### #
# # #   # # # # #     #           # # #
# ### # ######### # ##### # ### # # # #
#   # #     # #   #   #   # #   #     #
# ##### ##### ### ######### # ### ### #
#     # # #     #       #   #   #   # #
# ### ### # ####### ########### # ### #
# # #   #         #   # #     # # #   #
# # ##### ######### ### # ####### # # #
#           #   # # #           # # # #
# # ##### # # ### ### ### # # # ##### #
# #   #   #             # # # #   #   #
#######################################
