#######################################
# #         # # # #   #   #       #   #
# ### # ##### # # # ##### # ### # # # #
# #   # #   # # # #   #     # # #   # #
# ### ### ### # # # ### ##### ### #####
#       #   #     # #       # # # #   #
# ##### ### ### ### ### ##### # ### # #
# #   #   #         # #       #     # #
##### # ####### ### # # ####### #######
#   # #   #   #   # # #       #       #
# ### # ##### # ##### # ##### # # #####
# #   # # # # #   #     # # #   #     #
# # ### # # # # ### ##### # # # ### ###
# #   #   #     #           # # #     #
# # ### ##### ##### ############# #####
# # # #   #   # #   # #         #     #
# # # # ##### # # ### # ###############
#     #       #   # #             # # #
##### # ######### # # ####### ##### # #
#         # # # #     # # # #         #
# # ### ### # # ### ### # # ### #######
# #   #                       #       #
#######################################
