#######################################
#   #           #         # # # # # # #
### # ### ### ### # ##### # # # # # # #
#   # #     # # # # #     # #   #     #
### ######### # # ####### # # ### #####
# #     # #   # # # # # #   #   #     #
# # ##### # ### ### # # # ### # # # ###
#                 #   # # # # #   #   #
# ########### ### ### # # # ##### #####
# #           #     # # # #   # # #   #
# ##### ####### ### # # # # ### # # ###
# #   # #       #   # # #             #
### # ############# # # # ### ##### # #
# # # # # #     # # #       #   # # # #
# # ### # ##### # # # ########### #####
#   # # #   #   #       # #   #       #
# ### # # ### # ####### # # ### ##### #
# #   # # #   #       #   #   #     # #
# ### # # ######### # # # ### # #######
# #     #       #   #   #       #     #
# ##### ##### # # ##### # ### ### #####
#             #   #     #   #         #
#######################################
