#######################################
#   #         # #       #         #   #
### ######### # ### # ### # ######### #
#         #   # # # #   # # #   #   # #
# ### ### ### # # ### ### ### ##### # #
# #     #   #   # # # #   # #   # # # #
##### # ### ### # # # # ### ### # # # #
# #   # #       #   # # #     #     # #
# ### ######### # ### # # ##### # ### #
#     #                   # #   #     #
# ##### # ### # ######### # # #########
# #     # #   #         #   # # #   # #
# ####### ### # ### # # ##### # # ### #
# #       # # # #   # #               #
# ######### ### ### # ### # # #########
#   #           #   # #   # #         #
##### ######### ####### ##### #########
#   # #           #         #       # #
# # # ##### # ### ##### # # ### ##### #
# #   # # # #   # #     # #   #       #
####### # ### # ### # ##### # # ##### #
#             #   # #     # # #     # #
#######################################
