#######################################
# #   #   # #         #     #       # #
# ### # # # # ######### ####### ### # #
# #   # # # # # # #       #     # # # #
# # # # ### # # # ### ##### ##### ### #
#   #     # # #   # #         # #     #
####### ### # ### # # ######### ### ###
#   #   #   # #     #   # #   # #   # #
# # ### # # # # ##### ### # # # # ### #
# #       #   #       #     #       # #
######### ### # # ##### # # # ####### #
# # #       #   #       # # #     #   #
# # ### # # # # ### ####### ####### ###
# # #   # # # #   #       # #   #     #
# # ######### ### ### ### ### ### #####
#         #     #   #   #   #     # # #
### ### # ### ### # ### ### # ##### # #
#   # # #     #   #   #   #     #     #
# ### ### ### ##### # ########### # # #
#       # #   #     #             # # #
# ##### ##### # ### ### # ### # ##### #
#   #       # #   # #   #   # #   #   #
#######################################
