#######################################
#   #   #   #     # # #         #     #
### ### ### ##### # # # ######### #####
#     # #       #     #   #     #   # #
### ### ##### # ##### # ### # ### ### #
#   #     #   # #       #   #       # #
# # ##### # # ##### ### ##### ##### # #
# #       # #   # #   #           #   #
### ##### # ##### # ########### # #####
# # #       #   #             # #   # #
# ####### ### ### # # ######### ##### #
#   #         #   # # #       #       #
# ##### # # # # ### ### ####### # # # #
#   #   # # #     # #     # #   # # # #
# # ##### # ##### ### ##### ######### #
# #       #     # # #     # #     #   #
# ####### # # # # # ### ### # # ### ###
#   #     # # # #             # # #   #
# ### # # # # ####### ####### ### ### #
# #   # # # #       #   #   #       # #
# ##### ######### # # # # # # ####### #
# #         #     # # #   # #       # #
#######################################
