#######################################
#         #   # #           # #   # # #
### # # ##### # # ### ### # # # ### # #
#   # #     #       #   # # # # #     #
# ### # # ### # ### # ### ### # # #####
# #   # #     #   # # #       # #     #
# # # ### ############### # # # # ### #
# # #   # #             # # #       # #
# # ### ### # ### # # # ### # ##### ###
# #   #     # #   # # # #   #     #   #
### ### ##### ####### # ###############
#     #     #       # # #           # #
##### # ### # # ######### ### ####### #
#     #   # # #           # #     #   #
# ### # ### ##### ##### ### # ##### # #
# #   # #   #   #     # #   # #     # #
# # ### # ##### ####### # # ### ### ###
# # #   #     #   # #     #     # # # #
# ### # # # ### ### # ##### # # # ### #
# #   # # #   #     #   #   # #       #
######### ####### # ##### #############
#                 #     #             #
#######################################
