#######################################
#   #             #     # #           #
# ### # ####### ####### # # ### ##### #
# # # #     # #   #   #   # # #     # #
# # ### ##### ####### # # # # ####### #
#   #     # #   # # # # #   #     # # #
# ### ##### # ### # # # ######### # ###
# # #       #     #   # #   #   # # # #
# # # ### ##### ### ### # ### ### # # #
# # # # # # # #   # # # #       #     #
# # # # ### # # ### # # # ### ##### # #
# # #     #     #   # #   #     # # # #
# # ### ### ##### ### ### # ##### ### #
#   # #           # # #   # #     # # #
# ### # ### ####### # # ##### ##### # #
#     #   # #         # #     #       #
# ##### ##### ######### ### ### #######
# # # #   #   # #             # #     #
# # # # ### ### # ############# ### # #
#   #     # #             #       # # #
# ### # ### # # ########### # # ### ###
#     #       #             # #       #
#######################################
