#######################################
#                       #   #   #   # #
### ####### ####### ### # ### ### # # #
#         #       # #     #     # # # #
### # ### ######### ### ### ##### ### #
#   #   #       # # # #     #   #   # #
# ##### ### ### # # # # ####### # ### #
#   #     # #     # #               # #
### # ### # ### # # # # # ##### ### # #
#   #   # #   # # # # # #     #   #   #
# # # ### # ### # ### ##### # ##### ###
# # #   # #   # # #       # #     #   #
# # ####### ### ### # ### ### ### ### #
# #   # #   # #   # # #   #     #   # #
# ### # ### # # # # # # # # ###########
#   #     #   # # # # # # #         # #
# ########### ##### ##### # ### ##### #
#           #   # # # # # #   #   # # #
# # # ### ### # # ### # # ####### # # #
# # # #   # # #         #       #     #
# ##### ### ### ### ######### # ### ###
#     #     #     #       #   #   #   #
#######################################
