#######################################
#     #   #         #         #       #
### # # # ######### # ######### #######
# # # # # #     #         # # #   #   #
# ### ### # # ####### # ### # # ### # #
#   # # # # # #   # # # #   # # #   # #
### # # # # ##### # # ### ### # # # ###
# # #   # #     #       #     # # # # #
# # ### # ##### # ##### # ### # # ### #
# # #   # # # #   # # # #   #       # #
# # # ### # # ##### # # # ########### #
#           #     # #         #     # #
### ##### # ##### # ##### # ### ##### #
#   #   # # # # # # #   # #     # #   #
# ### # ### # # # # ### # ### # # ### #
# #   #     #     #       #   #   #   #
# ### ##### ### # # ### ### ### ##### #
# #   #     #   # # # # # #   #       #
# # ####### ##### # # ### ### # ### # #
# # #   #                   # # #   # #
# ##### ##### # # ### ######### ##### #
# #           # #   #         #   #   #
#######################################
