#######################################
#   #       # #     #   #       # #   #
# ### ####### # ##### ### # ##### # # #
#   #             #     # #   #     # #
# ##### # ######### # ### ####### #####
# #     # #         #     # # #   #   #
# ### ##### ### ##### # # # # # ### ###
#   #   #     #     # # # #         # #
### ### # ################# # ### ### #
#       # # # #         # # # #   #   #
# # ### # # # ### ####### ### ##### ###
# #   #           #   #   # # #   #   #
### ### # ######### ### ### # # # # # #
#   # # #     # #           #   #   # #
# # # ### ##### # ####### # # ##### ###
# # #                 #   #       #   #
######### ##### ######### # # ### ### #
#   #     #   #       #   # #   #   # #
# ##### ### ### ######### ### # #######
#   # #       #         # #   #       #
### # # # ####### # ### # # ### ### ###
#       #     #   #   # # #   # #     #
#######################################
