#######################################
#   #     # # # #   #           # #   #
# ### ##### # # ### # ########### # ###
# # # #     # #   #   #   # #   #     #
# # # ##### # # ##### # ### ### # ### #
#   #       # #     #   #   # #   # # #
### ####### # # # # # ### ### ##### # #
#       # #   # # #           # #   # #
# ### # # # # # # # ########### ### # #
# #   # #   #   # # #     #     #   # #
# ##### ##### # ####### ### ##### # # #
# # #     #   # #   #     #   #   #   #
### ##### # ### # ### ##### ### ##### #
#       # #   # # #             #     #
####### # ##### # # ############### ###
#               #           # #   #   #
####### # # ### # # # ### ### # ### # #
#   # # # # #     # #   #         # # #
### # # # ### ### # # # ####### # # # #
# #     #   #   # # # #   #   # # # # #
# ### # # ####### # ### # ### ##### # #
#     # #       # #   # #       #   # #
#######################################
