#######################################
#     # #   #   #       #             #
### # # # # # ####### # ### # # ##### #
# # # #   # #   #     # #   # # # #   #
# ### ##### ### # ### # ### ##### # # #
#   # # #     #   #   #       #     # #
# ### # ##### ##### ######### ####### #
#     #   # #       #       # #       #
##### ### # ##### ##### # # # # # # ###
# #         #     #   # # #   # # #   #
# ##### ##### ####### ######### # ### #
#   # # #   # #   #             #   # #
# ### # ### ##### ### ### ### ### # # #
# #     # #             # #     # # # #
# ### ### ### ####### # # ### # # # # #
# # #   #     #       # # #   # # # # #
# # # ####### ### # # ### # # # # ### #
#   #     #   #   # #   # # # # # #   #
### ##### ### # ### # ### # ### # # # #
# #     #   # #   # #   # #   # # # # #
# # ### ### # ######### # ### # # # ###
#     #         #       # #   # # #   #
#######################################
