#######################################
# # #           # #   #   #         # #
# # # # ####### # ### # # ##### ### # #
# #   # #       # #   # # #     # #   #
# ########### # # ### ### # # ### ### #
#   #         # #           # #     # #
### ######### # ######### ######### # #
#             # #   #       #         #
####### # # # ### # ######### ####### #
# #     # # # #   #     #   # # # # # #
# ####### ### ######### ### ### # # # #
#   # #   #     #     #         #     #
### # # ####### # ### ######### ### ###
#       # #     # #           # # # # #
# ##### # # ### ############# # # # # #
#     # #   # # #   #     #   #   # # #
# ### # ##### # # ####### ### ### # # #
#   # # # #       #     #         #   #
# # # ### ##### # ##### ##### ### # ###
# # #   #     # #         # #   #     #
# # ####### ########### # # ####### ###
# # #                   #             #
#######################################
