#######################################
#     #   #     # #               #   #
### ### ####### # # ######### ### # ###
#     # # #   # # # #   # # #   # #   #
##### # # ### # # # # ### # ######### #
#         # #   # # # # # #     #     #
# ####### # # ### # # # # ### ### #####
# #   #                               #
# # ##### # # ##### ### # # # # ### ###
#   #     # #   #     # # # # #   #   #
### ######### # ### ### ##### ### # # #
#   #         # #     #   #   #   # # #
# ### # ### # ### ### ### ####### ### #
# #   #   # # # # # #   #     #     # #
# # # # # # ### ### ########### ##### #
# # # # # #                   #     # #
### ####### # # # ### ##### # # #######
#     #     # # #   #     # # #   #   #
# ######### ### ##### # # ### # # ### #
# # #   #   #   #     # #   # # #   # #
# # ### ##### ### # # ##### # ##### # #
#   #         #   # # #     #     #   #
#######################################
