#######################################
# # # #                 #   #     #   #
# # # ##### # ### # ### ### ##### # # #
#           #   # #   #   # # #   # # #
# ######### ##### ##### ### # # # # ###
# #     #       #   #     #   # #   # #
# ##### ### # # ### ##### # # ### ### #
# #         # # # #     #   #         #
# ### ### # # ### ### ######### # ### #
# #   #   # #     # #     # # # # # # #
# ### ##### ### ### ####### # ##### # #
#   #   #     # #   #   #       #   # #
########### ##### ##### # ####### #####
#       #       #             #   #   #
# ### # # ### ### # ######### # ### ###
# #   #   #   #   #         # #       #
# # ##### ### # ### ####### ### ### ###
# #   #   #       #   # #       #     #
# ####### ### # ### # # ####### # ### #
# #       #   #   # #   #   # # #   # #
# ######### # ####### ##### # ### #####
#     #     #       #         #       #
#######################################
