#######################################
#       # #   #         #     # #     #
# ####### # ##### # ##### ##### ##### #
#     # # # # # # #     #         #   #
# # ### # # # # # ##### # ######### ###
# #     # # # # #     #   # # #   # # #
# ##### # # # # # ######### # # # # # #
# # #   #     # #   # # # #     # # # #
### # # ##### # # ### # # # ##### # # #
# #   #           # #           #   # #
# # # # ### ##### # ##### ########### #
#   # # #   #   # #       #   # #     #
### ##### # ### # # ####### ### # #####
#     #   # # #     #       #     #   #
##### # # ### # # ### ####### ##### ###
#   # # # #     #                     #
# # ##### ### # ### ####### ### ##### #
# #   #   #   #   #   #   #   #     # #
# # ### ### # # # ### # ########### # #
# #     #   # # # #           # #   # #
########### # ##### # ### ##### # #####
#           # #     #   #       #     #
#######################################
