#######################################
#         #     # # # #     # # #     #
# ####### ### # # # # ### ### # # #####
# #     #     #   # # #       # #     #
# ### # ### # ### # # ##### # # # #####
# #   #     # # #   # #     # #   #   #
# ### ######### ### # ####### # ### ###
# #   #         # #   # # # #     #   #
# ##### # ##### # # ### # # ##### ### #
# # #   #   # # #   #     # #   #   # #
# # ######### # ### ### ### ### # ### #
# #           #   # #   # # # # #   # #
# # ##### ### # # # ### # # # # # ### #
# #   #     # # #   # # # #     #     #
# ### ### ### ##### # # # # ##### #####
#   # #   #           # #   #     #   #
####### ######### ### # # ### ### # ###
#     # #         #       # #   #     #
##### ########### ##### # # # #########
#   # #   #     # #     #   #       # #
# ### # # # # # ######### ### ####### #
#       #   # #                       #
#######################################
