#######################################
# #         #   #     #       #       #
# # ### ### # ### ########### # #######
#   # #   # # # #                     #
# ### # ##### # # # ####### ######### #
# # # #       #   #       #   # #     #
### # # ### ##### # ##### # # # #######
#         #   #   # #   # # #       # #
# # ######### # ### # # ##### # ##### #
# #         #     #   #   # # #       #
# ### ####### # # ####### # # # ### ###
#   #     # # # #       # # # #   #   #
# ####### # # # ########### # # ##### #
#       #   # #             # # # #   #
##### # ################# # ##### # ###
#     #   #   # #     # # #     #   # #
##### # ##### # # ##### ############# #
#   # #       #     #   # #     #   # #
# # # # ####### ##### ### # ##### ### #
# #   #             #   #   #   # # # #
####### # # # ##### # # # ### ### # # #
#       # # #     #   #               #
#######################################
