#######################################
#   # # # #   #   #   #     #   #   # #
# ### # # # ### ##### # ### # # ### # #
#   # #     # # # # #   #   # # # # # #
### # ##### # # # # # ####### ### # # #
#       # # #   # #   #     #   #   # #
# ##### # # # ### # ####### ### # ### #
# #       #   #   #   # #   #   # #   #
# # # # ##### # ##### # # ##### # # ###
# # # #   #       #   # # # # #       #
##### ### # ####### ### # # # # #######
# #   #     # #   # # # #       #   # #
# ####### # # # ### # # # ####### # # #
#         #   # # # #   # # #   # #   #
########### ### # # # ### # # ### # # #
#         # # #     # #           # # #
######### # # # ### # # ### # #########
#   #     # #     # #     # #   # # # #
### ##### # ### ##### ##### ##### # # #
# #       #               #   #   # # #
# ##### # ####### ### ####### # ### # #
#       #           #     #           #
#######################################
