#######################################
# # #   #       #   #   #         #   #
# # # ####### # ### ### # ####### ### #
#       #     #   #   # #       #     #
# ### ### ### ### ### # # ########### #
# #       # #   #     # # #   #       #
# # ####### ##### ##### # ### ##### # #
# # #     #   #       #       #   # # #
### ### ##### ####### # # ### # # # # #
#   #   #   #           #   # # # # # #
##### ##### ######### # # # ### ### ###
# #         #     # # # # # #     # # #
# # ##### # ##### # ### # ### ####### #
# # # # # #           # #             #
# ### # # ######### ### # ### # ##### #
#         #             #   # # #   # #
# # ############# # # ### ######### # #
# # #       #     # #   #         #   #
##### ##### # ##### ####### ######### #
#   #     #     #       #   #       # #
# # ##### ##### ### ### # ##### ##### #
# #       #     #   #   #     #       #
#######################################
