#######################################
#                             #       #
##### # ##### # # ######### # # #######
#     # # #   # #       #   # #   #   #
### ##### ### ### ### ####### ### # # #
#   #         #     #   # #       # # #
##### ### # ### ### ##### ########### #
# #   #   # #     #   #   #     #     #
# ### ##### # # # ##### # # # # ##### #
#     #     # # #       #   # # #   # #
############# # # # # ### ####### # # #
# #   #       # # # # #   #   #   # # #
# # # # # # ### ### ### # # ##### # # #
#   #   # #   #   #   # # #     # #   #
### ### # ##### # # # # ### # ### ### #
# #   # # #   # # # # #     #     #   #
# # ### # # ####### # ##### ### # # ###
#   #   #   # #     # #     #   # #   #
######### # # ### # ### # ########### #
# #     # # #     # #   # # #   #   # #
# ### ### # ####### ##### # # ### # # #
#         # #       #             # # #
#######################################
