#######################################
#       # #   #   #     #     # #     #
##### # # # ##### # # ####### # ##### #
# #   #   # # # #   #     #     #     #
# ### ### # # # # # ####### # # # ### #
# # # # # #     # # # #     # #   #   #
# # # # ### ####### # # # #############
# # # #   #   # #   # # #   # # # #   #
# # # ### ### # # ### # ### # # # # ###
# # # #   # #       # #   #   #   #   #
# # # ### # # ####### ### # # # ### ###
# # #           #     # # # #   # #   #
# # ######### ### ##### # ### ### # # #
#         #   #   #       # # #   # # #
# ##### # # ##### # ### ### ### ##### #
#   #   # # #     # #   # #   #   # # #
# # ##### # ### ### ##### ### ### # # #
# #   # #             # # # #   #   # #
####### ### ### ####### # # # ### ### #
#       #   #           # #       #   #
# ########### ######### # # # ####### #
#                     #     #         #
#######################################
