#######################################
#     # #             #   #   #       #
# ##### # ##### # ####### # ### ##### #
#   # # #   #   # #   # #           # #
### # # # ######### ### # ####### ### #
#           #     # # #         # #   #
### ##### ### # ### # # ### # ### ### #
#   #         # #         # #   # #   #
### ### # ### ### # # # # ### ##### # #
# #   # #   #     # # # # #   #   # # #
# ### # # ####### # ####### ##### # ###
#     # #       # #       #     # # # #
# # # ### ########### ####### ### # # #
# # #   #           #   #   #     # # #
# ### # # ### ##### ####### # ##### # #
# #   # #   #     # #   # # # #   #   #
### ### ### # ##### # ### # # # #######
#   # # #   # # # # # # # # #   #     #
# # # # ####### # ### # # # ##### # ###
# # #     #       #     # #     # #   #
##### ### ####### # ### # # # ### #####
#     #               #     #         #
#######################################
