#######################################
#     #         #   # #         #     #
##### ### ##### # ### # ######### #####
# # #   # #   #     # # # #       #   #
# # ### ### # # ### # # # # # ##### ###
#           #     #         #     #   #
####### ####### # # ############### ###
#   #         # # #           #       #
# # # # # ##### ### # ##### # # # #####
# #   # #   #   #   # #     #   #   # #
# # ### ##### # # ##### # # # ##### # #
# # # #     # # # #     # # # #   #   #
### # # ##### ##### ### ### ### # ### #
#   #       #   #   #     #     # #   #
####### ##### # ##### ### ### ### #####
# #         # # #   # #   #     #     #
# ### # ####### ### # # # # # ### ### #
#     #     # # #     # # # # #   # # #
##### # # ### # ### ### ### ####### # #
#     # # #   #   # # # # # #         #
##### ### # ##### # # ### # ####### ###
#       #       # #   #       #       #
#######################################
