#######################################
#     #       #               #       #
# # ### ### # # ########### # # #######
# #     # # #     #       # #         #
# ##### # ##### # # ### ####### #######
# #     #       #     #       #       #
######### # # # # # # ######### # #####
#         # # # # # #         # # #   #
### ########### ### ### ########### # #
# # #             #   #   #     # # # #
# ##### ##### ### ### ##### # # # # ###
#         #   #     #       # #   #   #
### ### ### # # # ### # # ########### #
#   #   #   # # # #   # #   #     # # #
# ####### # ##### ##### ####### ### # #
#     #   # #     #                   #
# # ##### # ### # # ##### ##### #######
# # #     # # # # # #         #       #
##### ### ### ### # # # # #############
#   #   # #       # # # #   #   # # # #
# # # # ### ############# # # # # # # #
# #   # #   #             #   #       #
#######################################
