#######################################
#   #         #             # # # #   #
# ### ####### ######### # ### # # # # #
#     #     #   #     # # # # #     # #
######### # ### ##### ### # # # # ### #
#       # #       # #       #   # #   #
# # ##### ##### ### ####### # # ##### #
# # #   # #                   #     # #
### # ####### ####### # # ### # ##### #
#             # #     # # #   #     # #
########### ### ### # # # ##### ### # #
#     # #   #       # # #     # #   # #
# ##### ### ### # ##### # # # ### # # #
#   #   #   #   # #     # # # #   # # #
# ### ############### # # # # ##### # #
#               # #   # # # #   #   # #
### ####### # # # ### # # # ##### # # #
#     #     # #       # # #     # # # #
####### # ### # ### ##### ### ##### ###
#     # # #   # #   #       #   # # # #
# ### # ##### # # # # # ####### # # # #
#   #     #   # # # # #   #     #     #
#######################################
