#######################################
#             # #     #           #   #
# # ### ### ### # # ### ######### ### #
# # #     #     # # #     # #       # #
### # # ######### ####### # ######### #
#   # #     #         #   # #         #
# # # # ##### # ### ### # # # ### #####
# # # #       # # #   # #   #   #   # #
# # # ### # # ### # ### ####### ### # #
# # #   # # #     #   # #   #     #   #
### ### # # # ##### # # # ### ### # ###
#     # # # #     # #       # # # # # #
### # ### ####### ### ### ### # ##### #
#   #   #       #   #   #             #
# # ##### ##### ######### ### ### ### #
# # #     #   #   # # #   #   #   # # #
### ##### ### # ### # # # # ### ### ###
#   #         #       # # # #       # #
### # ### ##### # # # # ### # ##### # #
#   # # # #     # # # # #   #     #   #
# ##### ##### ##### ### # # ### ##### #
#     #       #     #   # #   #     # #
#######################################
