#######################################
# #         #     #               # # #
# # # # # ### # # # ##### # # ### # # #
# # # # #     # #   #     # # #     # #
# ##### # ### ################### ### #
#   # # # # # #             #         #
# ### # ### # ### ### # # # # ##### # #
#       #       # #   # # #     #   # #
# # ### ### # ####### # ### # ### ### #
# #   # #   # #       # #   #   # #   #
# # ### # ##### # # ### ############# #
# # #   #     # # #   # #   #         #
# # ### # ##### # # ##### # ######### #
# # #   #     # # #     # # #   #     #
# # # # ######### # # # ### ### # #####
# # # # #         # # # #             #
# ######### ### ################# # # #
# #       # #   #   #   #         # # #
### ##### # ####### ### ##### # # #####
# #     #   # #               # # #   #
# # ######### ##### ######### ### # # #
#   #                 #       #     # #
#######################################
