#######################################
#         # # #   # #   #   #         #
# # ####### # # # # # # # ##### #######
# # # # # # #   #   # # #       #     #
# ### # # # ### ####### ### ####### ###
# # #       # # #     #   # # #   #   #
# # ##### # # # # ##### ### # # # ### #
#   #   # #   #   #     # #   # #   # #
### # ### ##### ####### # # ####### # #
#   #   #     # # #   #       #       #
# # ### # ##### # ### ### ### # ##### #
# #     #   #   # # #   #   #   #   # #
### ### ### ### # # ### ### ##### # ###
# # # #         # #   #       # # #   #
# ### ####### # # # ######### # # ### #
#             # #   # #             # #
### # ######### # ### ##### # # ##### #
#   # #                     # #     # #
# # # # ####### # # # ### # # # ### ###
# # # # # #     # # #   # # # #   #   #
### # ### ### ### ############# # ### #
#   #   #       #             # # #   #
#######################################
