#######################################
#                           #     # # #
##### ### # ##### ############# # # # #
#   # #   # # #     #     #     #   # #
### ### ##### ####### # # # ######### #
# # # # # # # #     # # # #         # #
# # # # # # # # ##### # ##### ##### # #
# #   #       #       # #     #   # # #
# # ####### ##### ####### ##### # # # #
#   #   #             #       # # # # #
# ##### ### ####### ##### ### # # ### #
#   #     #       #         #   #     #
### ##### ### ############### ### #####
# #   #     #   #     #     # # # #   #
# # ##### ### # # ##### ####### # # # #
#             # #     #     # # # # # #
### ##### # ##### ##### ##### # ### # #
#       # #           # #           # #
# # # # ############### # # ### # #####
# # # #         #   # # # #   # #     #
# # # ### ##### # # # # # ########### #
# # #   #   #     #               #   #
#######################################
