#######################################
#     #   #   #       #         #     #
# ### ### ### # # ####### ##### # ### #
# #   #       # # # #   #   #     #   #
##### # ##### ### # ### # # ###########
#       #       #     #   #     #     #
# ### ######### ##### # # ##### ##### #
# #   #         # #     #   # # #   # #
# ############# # ### ####### # # ### #
#   #   # #             # #   #     # #
### # ### ### ##### ### # # ######### #
#   # # #   # #       # #         #   #
##### # ### # ### # # # # ### ##### ###
#             #   # # # # #   #     # #
# ### ### ### ######### # # ### ##### #
#   # #   #     # # #     #   #   #   #
### ### ### ### # # ### ######### # ###
# # #   #   # # # #         #       # #
# # ### # # # ### # # # ### # ####### #
#     # # # # #     # # #       #     #
# ##### # # # ##### # # # ####### #####
#   #   # # #       # # #             #
#######################################
