#######################################
#           #     #   #   #     #     #
# ####### ### # ### ### ### # ##### ###
# # #       # # #   # #     #   # #   #
### ##### # ### ### # # ######### ### #
# #   #   #   #   # # #             # #
# # ### ### ### ### # ##### ##### ### #
#   #   # #       #   # #   #   # #   #
# ### ### ### ##### ### # # # # ##### #
# #   #   # # # #     # # # # #     # #
# # # ### # ### # ##### ### # # ### # #
# # # #     #   #           # #   #   #
# # ### ##### ##### ####### # ### #####
#         # # #           #   #   #   #
# # ### ### # # ######### # # ####### #
# #   #             # # # # #   # #   #
### ######### ####### # # # ### # # ###
#           # #   #     # # # #   #   #
# ##### ### # # # # ##### # # ##### # #
#     #   # #   # #     # # #       # #
### # ############# # ### ### #########
#   #               #   #             #
#######################################
