#######################################
#     # #           #               # #
### ### # ########### ### # # # ##### #
#   #         #   # #   # # # #     # #
# ### # ####### ### # # ####### ### # #
# # # #         #     #     #   #   # #
# # ### ######### ######### # # # ### #
#                         # # # # #   #
# # # # # ##### ######### ##### ### # #
# # # # #   #     #     #   #   # # # #
# # # # ##### ##### # ##### # ### ### #
# # # #     #       #     # #     #   #
### # # # # ### ######### # ### # # ###
#   # # # # #       # # # # #   #     #
# ### # ##### ### ### # # ####### #####
# #   # #   #   #     # # #     #     #
# ##### # # ##### # ### # # ####### ###
#     # # # #     #   # # # #     #   #
# ####### # # ####### # ### # # # ### #
#         # #   #   #     # # # # #   #
##### # ### ##### ####### # # ### #####
#     #   #             #       #     #
#######################################
