#######################################
#     #               #       # #     #
##### ### # ##### ##### ##### # # ### #
#       # # #   #           #   # # # #
# ############# ### ####### # # # # ###
#         # #     # #   # # # # #   # #
######### # ##### # # # # ####### ### #
#         #           #   # # #       #
# ####### ############### # # ### ### #
# # #         # #   # # #   #       # #
# # ####### # # ### # # # # ##### # ###
#   #   #   # #       #   #     # #   #
####### # ### ####### ### ####### ### #
#       # #   # # # # # #   # # #   # #
# # ####### # # # # # # # ### # # ### #
# # # #   # # # #   # #           # # #
# # # # ##### # ### # ### ####### # ###
# # #   # #   #   #     #       #   # #
# # ### # # # ### ### ### # # ####### #
# # # #     # # # #   #   # #   #     #
# # # ### # # # # # # # # # ### # #####
# #       # #       #   # #   #       #
#######################################
