#######################################
#   # # #       #   #       #         #
# ### # ##### # ### ### ### # # ##### #
# #     #   # #         #   # #     # #
# # ##### ####### ######### # #########
#       # # #   # # #   #   #     #   #
##### ### # ### ### ### ### # ####### #
#   # # # # #   #       # # #       # #
# ### # # # ### # ##### # # ### ##### #
# #   # # #   # # #         # #   #   #
# # ### # # ### ### ##### ### # ### # #
# #     #       #   # #     # # # # # #
# ### ####### ##### # ### # # # # # ###
#     #         #   # #   # # #       #
### # ##### ### # ### ### # # # ##### #
#   #   # # # #   #   #   #   #   #   #
# ### ### ### ####### # ######### # ###
# #       #   #     # # #     #   #   #
### ### # # ####### # # # ##### ##### #
#   #   #             #   # #   #   # #
# # # # # ### ####### ### # # # # ### #
# # # # # #   #               #   #   #
#######################################
