#######################################
#       #   #     # #   #     #   #   #
# ######### ##### # # ### ### ### # # #
# #   # #   # # # #       # #   # # # #
# # ### ### # # # # ####### ### # # # #
# #     # # #   #   # #     #     # # #
# ##### # # # ### ### # ############# #
#           #   # #   #   # #       # #
# # ### ####### # # # # ### ####### # #
# # #   #   # # # # # #     #   #     #
####### # # # # # # ### ####### # # ###
# # #     #           #           #   #
# # # ##### ##### ####### ### ##### # #
#   # #     #   #   #   # #   #     # #
### ####### # ####### # # ### # # ### #
#                 # # # #   # # # #   #
# ##### # ### ##### # ### ### # ### ###
# #     # # # #   #   #   #   #   # # #
### # # ### # # ### ### # ##### # # # #
# # # #   #   #         #   # # # #   #
# # # ### # ### ##### ####### ##### # #
#   # #   #     #             #     # #
#######################################
