#######################################
# #   #                   # # #     # #
# ### # ##### ### ### ### # # # # ### #
# #         # # # #   # #     # # # # #
# # ##### ### # ####### ##### # ### # #
#     #     # # #   #   #     #       #
# # ### ####### # ### ### ####### #####
# # #     # #   #     # #   # #   #   #
# ####### # # # # ### # ### # ### # ###
# #     #   # # # #         # # #     #
### # # # ##### ##### ### ### # ### ###
#   # #     # #       #           #   #
# ### ####### # # ####### # ### ### ###
#   # #   #     #   #   # # #   # #   #
### ##### # ######### ##### # # # # # #
# # #       #   # # # #   # # #     # #
# # ########### # # # # ####### # ### #
#   # # #   # #     #           #   # #
##### # ### # # ### ##### ### # # # # #
#   # # # #   # #         #   # # # # #
### # # # ### # # ### ### # ####### ###
#               #   # #   # #         #
#######################################
