#######################################
#           #             # #         #
##### # ### # ####### # ### ####### ###
#     # #         #   #       #   #   #
# # ##### # ### ### ##### ##### ##### #
# #     # #   #   #     #     # #     #
# # ### # ### # ### ##### ##### # #####
# # #   # #   #   # #   # #     #     #
### # ### ### ### ### ##### ### # ### #
#   #   # #   #     #     # # # # # # #
# ##### ### # # # # # ##### # ### # # #
#     #   # # # # # #             # # #
# # ### ### ##### ### ### ### # ### # #
# # #   #   #   #     # # # # #     # #
# # # # # ##### # # # # # # ### ##### #
# # # # # #       # #   # # #   #   # #
# # # ### ##### ######### # ##### ### #
# # # #   #         # #       #   # # #
# ##### # ########### # ####### ### # #
# #     #       #       #   #       # #
### # ####### ##### ##### # ### ##### #
#   #       # #           #       #   #
#######################################
