#######################################
#         #   #   #   #     # #   #   #
# ##### ##### # # ### ### # # ### # # #
#     # #     # # #       # # #     # #
##### ### ### # ######### ### # ##### #
# #   #   # #               # # #     #
# # # # ### ### # # ######### # ### # #
#   #   #       # #       #   # # # # #
# ### ### # ######### # # # # # # ### #
#   # #   # # #     # # #   #   # #   #
# # # ####### ##### ##### # # ### #####
# # # # # # #     # #     # # # # #   #
### ### # # ##### # ### ### ### # # # #
#   # #     #     #   # # #     # # # #
# # # ##### ##### ### ### # ##### ### #
# # # #   # #       #   # #   # # #   #
# ### # # # ####### # ### # ### # # ###
# #   # # #           # #   # # # #   #
# # ##### # # # # ### # # ### # # ### #
# # #     # # # # #     #           # #
# # # ### # # # ####### # ######### # #
# #   #     # # #                 #   #
#######################################
