#######################################
# #   #   #       # # #     # #   #   #
# # ### # # ### ### # ### # # # ### # #
#   #   # # #   #   # #   # #       # #
### ##### ### # # # # ### ##### ### ###
#   #   #     #   #   # # # #     #   #
### ### # ### ####### # # # # # ### # #
# #   #   #   #     #   #     # #   # #
# # # ######### ### ### ### # # # ### #
#   #     #     #           # # #   # #
# # ### # ### ### ##### ##### ### ### #
# # # # #   # # #     #     #   # #   #
# ### ##### # # ######### # # # ### # #
#   #   # #   #           # # #   # # #
### # # # ##### ######### ### ### ### #
# # # # # #     # #       #     #   # #
# ### # # # ##### # ####### # ### # ###
#     #   # #     #   #   # # #   # # #
####### ##### ### ### # # # # ####### #
#   #       # # #     # # # # # #     #
# # # # # # ### ####### ### ### # ### #
# #   # # #                       #   #
#######################################
