#######################################
#   # #   # # #   #     #   #   #     #
# ### ### # # # ##### ### ### ##### # #
# # # #     # #     # #       #     # #
# # # ##### # # ##### # ### # # ##### #
#   #             # # #   # # # #   # #
### ####### ##### # # # ##### # ### # #
#               #   # # # # # #   #   #
# ### ####### ####### # # # # ####### #
# #     # #           #   # # # #   # #
### # ### # # ######### ### # # ### # #
#   # # #   # #     #   #   #   #   # #
### ### ### ##### # # ### ####### # # #
#   #         # # #       # # #   # # #
# ####### ##### # ####### # # # # ### #
#     #         #       # # #   # #   #
# ####### # # ### ######### ##### # ###
# #       # #       #                 #
# ######### ####### ### ############# #
#   # #   #     #     #         #   # #
# # # ### ### ### # # # ### ##### ### #
# #   #       #   # #     #       #   #
#######################################
