#######################################
#     #         #             #     # #
# # ########### ### # ### ### # ### # #
# # #     #         # #     # #   #   #
# ### # ### ##### ### ### # # # #######
#   # # #   # #     # #   # # #   #   #
### # # ### # # ### # ####### # # # # #
#   # #       # #   #     #     #   # #
# # ######### # ### ### # ##### ### ###
# #   # #     # #   #   #     #   #   #
### ### ######### ####### # ######### #
#     # #       #     #   #     #     #
# ##### # ### ##### ##### # # # # #####
#     #   #         # #   # # # #     #
##### ########### # # ### ### #########
#   #       #     #   #   #     #     #
# ####### # # ##### # # # ### ### ### #
# # #   # #   #     # # #   #       # #
# # ### # ##### ### # # ### ### ### ###
# #   #       #   # # # #     # # # # #
# # # ### ### # # ##### # # # # # # # #
#   #       # # #     # # # # #   #   #
#######################################
