#######################################
#       #       #     #       #     # #
# ##### # ##### ### ### ##### ### # # #
# #   #   #   #     #   # #     # # # #
##### # ### # # ######### # ####### # #
# #   # #   #     #     #   # # #   # #
# # # ### ### ### # ### ### # # # ### #
#   # #   #   #   # # #   #   #   #   #
# ### # ##### # ##### ### ### # ### ###
#   # # #     #     # # #   # #       #
### ### ######### ### # ### # # #######
# # #       # #   # # #   #   #   #   #
# # # ### ### ### # # ### # # ### # ###
# #   # # #             #   #   # # # #
# # ### ########### ####### ##### # # #
# # #   #     # #   # # # #   #   #   #
# ### ### # # # ### # # # ### ### ### #
# # #     # #     #   # # # #   # #   #
# # ### # ##### # ### # # # # ### # ###
#   # # # #     # #   #   #           #
# ### ##### ##### # ### # ##### # ### #
#           #           #       # #   #
#######################################
