#######################################
#     # #         #     #   #         #
### ### ##### ##### ### ### # #########
# #   #   #         #   # # #   #     #
# ### ### # # ####### ### # # # # ### #
#   #   #   # # #   # #     # #   #   #
### ### # ##### ### ####### ####### ###
#     # #   #   #   #       # #   #   #
# ##### ### # ### ### ####### # ##### #
#   #   #     # # # #     #     #     #
# # # # # ### # # # ##### # # ### ### #
# # # # #   #   #     #   # #   #   # #
### # ##### # ##### ### # # # # # # # #
# #     # # #       #   # # # #   # # #
# # ##### # ### # # # ##### # ####### #
# #   #   #   # # #   #     #     #   #
# ### # ##### ##### ### # #############
#       # #       #     #     #   #   #
##### # # # # ####### # # # ### # ### #
# #   # # # #     # # # # # #   #     #
# # ### # ### ##### # # # # # ### ### #
#   #               # # # #     #   # #
#######################################
