#######################################
# #   #       #     #     # # # #     #
# # ### ##### # ##### ##### # # ### ###
#     # #       #     #   #       #   #
# ### # # ### # ##### ### ####### # ###
#   #   # # # #   #   #   #     #     #
####### # # ##### # ### # ##### # #####
#       #   #       # # #     # #   # #
# ######### ##### ### ##### # # # ### #
# #     #     #     # #     #   # #   #
####### ####### ### # ####### # # # ###
#   # #     #   #         #   # # #   #
# # # ##### # # ### # ### ### # # # ###
# # # #     # # # # # #       #     # #
### # ### # ### # # ########### # ### #
#   # #   # # # #     # #   #   #   # #
# ### ##### # # ####### ### ##### # # #
#         #   #   #               #   #
# ####### # ##### # # # ##### ### ### #
#     # # #   #   # # # # #   #     # #
# ##### # ### ####### ### # ### # # ###
#     #                 #   #   # #   #
#######################################
