#######################################
#       #   #     #   #   #     #     #
# ##### # # ### ### # ### # ##### ### #
# # # #   #         # # #   #     # # #
### # ######### ##### # ### # ##### ###
#       # #     #               #     #
# # # # # # ### ### # ### # # # # #####
# # # #     #   #   #   # # # #       #
# ### ################### # ######### #
#   #   #   #             #       # # #
### ### # # ### ##### ####### # ### ###
#   #   # # # # #           # #   #   #
##### ### ### ### # # # # ### ### ### #
# #     # #       # # # # #   #   #   #
# ####### ######### # # # ### # ### # #
#     #   # # #     # # #   # #     # #
# ####### # # ### # # # # ### # ##### #
#       #         # # # # #   #     # #
# ##### ### # ####### # ########### # #
# #   #     # #       #       # # # # #
# # ### # ########### # ####### # ### #
# #     #     #       #           #   #
#######################################
