#######################################
#     #   #     # #       # #       # #
### # ### # # ### # ### ### # ##### # #
# # #     # # #       #     #     #   #
# ### ### # # # ##### ######### # ### #
# # # # # # # # # # # # # # # # # #   #
# # ### # ### # # # ### # # # # ##### #
#       # #   #     #   #   # #     # #
# ####### ### # # ### ### ### ### #####
# #     #   #   #   #     #   # # #   #
# # ### ### # ### ### ##### ### # # # #
# # #           #       # #   #   # # #
# ##### ##### # # ### # # # ### ### ###
#       #     # #   # #   #       #   #
# ##### # ########### ### ### ### # # #
#     # # #   #     # #         #   # #
# ##### # ### # ### # # # # # ##### # #
#   # # #   #     #   # # # #     # # #
# # # # # ########### ### ### # # ### #
# # # # #   #           # #   # # #   #
##### # ############# ############# # #
#       #                     #     # #
#######################################
