#######################################
#       #   #     #   #       #     # #
####### # ### ##### ##### ##### ### # #
# #     #         #     #     #   # # #
# ##### # ####### ##### # ### ### # # #
# # # # # #     #       #   #     # # #
# # # # # # # ############# # ##### # #
# # #       # # # #   #     #   # # # #
# # ##### ##### # # ### ######### # # #
#   # # #       #     #   #     #     #
# ### # # ##### ### ##### # ### # ### #
#   #         #       # # # #   #   # #
### ### ############### # # ####### # #
#   #     #       #     # # #   #   # #
# ### # ##### # ### ##### # ### ##### #
#   # #   #   # #       # #   #     # #
# ##### # # ### # ### ### ### ##### ###
#       # #   #   #     #   # # #   # #
# # ########### ####### # # # # # ### #
# #           #       #   #     #   # #
### # # ######### ##### ##### ### # # #
#   # #               #   #       #   #
#######################################
