#######################################
# # #   #       #     #     #     #   #
# # ### # ### ####### ### ### ### # ###
#     #   #     # # # #     # # #     #
### ### ##### # # # # ##### ### # #####
# # #   # #   # #           #     # # #
# # # ### # ### # # # # # # # ##### # #
#   # #   # #     # # # # #       #   #
# # ### # # # ### # ### # ##### ##### #
# #     # # #   # # #   #   #       # #
# ### ### ##### # # ##### ##### ##### #
# # # #     #   # # #     # #         #
# # ####### ### # ##### # # ##### # ###
#   # #         #   #   #       # #   #
### # ################# ### ### ### ###
#     #           #       # #   #     #
# ### ########### # # ### # # # # ### #
# #   # # #   #   # # #   # # # # #   #
# ### # # ### # ### ### ####### ##### #
# # #   #         # #     # #   #     #
### ### ### ##### # ##### # ##### ### #
#         # #           # #       #   #
#######################################
