#######################################
#       #   #     #   # #   #         #
### # ### ##### # ### # # ####### # # #
# # #   #     # #     # # # # # # # # #
# # ##### ### ####### # # # # # # #####
# # #   # #   #                   #   #
# # ### # # ##### # ####### ### # # ###
# #   # # # # # # # #         # #     #
# ### # # ### # ### ### # # ### # # ###
# #     # #         #   # # #   # #   #
# ##### # ########### ### # ### # ### #
#         #           #   # #   # #   #
######### # ######### ### # # ### # # #
# #         #       # #   # # # # # # #
# # ### ##### ### # ### # # # # ### ###
#   #   #   #   # #     # # #   #     #
# ### # ### ### # ####### # ####### # #
# # # #   #     # #     # #       # # #
# # # ### ### ### # ### # ##### ### # #
#   #   #   # # # # #       # # #   # #
### ##### ### # # ### ### ### # # #####
#   #     #   #     #   #     # #     #
#######################################
