#######################################
#         # # #   #           # #     #
### ##### # # ### # ### ### # # # ### #
#       #   #   #   # #   # # #   # # #
# ############# ### # ### # ####### # #
#     #   #   # # # # #   # #     # # #
### # # ##### # # ### # ######### # # #
#   #     # # #     # # #     # #   # #
# ##### ### # # ##### # # ### # ### # #
# #   #     #     #   #   #   #     # #
##### ##### # ##### ### ######### # # #
#   #     #   #   #   #   #       #   #
### # ### ### # ##### # ### ##### #####
#   # # #         #   #     # # #     #
# ##### ####### ### ##### ### # ##### #
# #         # #     #   #   # #     # #
# # ### ### # # ### # ##### # ### ### #
#   # # # # # # #   #     # #   # #   #
### # ### ### # # # # ##### ### # ### #
#       #   #   # #   #   #   #     # #
# ### ##### ### # ##### # # # # ##### #
# #             #       #   #       # #
#######################################
