#######################################
#     #             #   #           # #
# ##### ##### ### ### # ### # ### ### #
#   #     #   # # #   #     # # # #   #
### # ######### ### ########### # ### #
#     #                 #       #     #
# ##### # # ### ####### # ##### # #####
# #   # # #   #     # #     #   # #   #
# # ### ### ##### ### # ### ### ##### #
# #     #     #   # # # # #   #     # #
# # ##### ##### ### # ### # # ### ### #
#       # #     # #       # # #   #   #
# ##### # ####### ### # ########### ###
#   #   #       #     #               #
# # ##### ### # # # ####### ### # #####
# #     #   # #   #   #   #   # #     #
# ### ##### # ####### # # ### ##### # #
# # #     # #   #   #   #   #     # # #
# # # # # ### # # # # # # ####### ### #
# # # # #   # # # #   # # #   #   #   #
### ##### # ##### ####### # ### ##### #
#         #     #     #   #         # #
#######################################
