#######################################
#     # #     # #                   # #
# ##### # ##### ### # ####### ####### #
# #   # #     #     #       #   #     #
# # # # ##### ##### # # ### # ### # # #
# # #               # # # # #     # # #
# ######### # ######### # ### ### # # #
#     #   # # # #       #     #   # # #
# ### ### ##### # ######### # # # #####
# #     #     #         #   # # #     #
# ### # ### # ### ### # # ### # ##### #
# #   # #   #   # #   # # #   #   #   #
##### ######### # ### # ### # ### # ###
#   #     # # #   # # # # # # # # #   #
# ####### # # ##### ##### ### # # # # #
# # #       #     #   #     # #   # # #
# # # # ######### ### ### ### # ##### #
#     #   #             # #   #   #   #
######### # ##### ##### # ### ### # ###
#   #     # #     # #     #   #   #   #
# # ##### # ##### # # ### # # ### #####
# #         #     #     #   #   #     #
#######################################
