#######################################
#   #     # #     # #           #     #
# ### # ### ### # # ####### ### ### # #
#     #   #     # # #   #   #       # #
# ####### ##### # # ### ######### # ###
# #       #   # #     #     #     # # #
# # ### ##### # ##### ##### ####### # #
# #   #   #   #   #   #   #   #     # #
# # ### # # ####### ### ##### ### ### #
# # #   #               #         #   #
### ### ### ### ########### ######### #
#   # # #   # #         #   # # # # # #
# ### # ##### ##### ### ### # # # # # #
# #   # #       # # #   # #   # # #   #
# # # # # ### ### ##### # # ### # ### #
#   # #     # #   # # #       # #     #
# # ####### ##### # # ### ##### ##### #
# # # # # # #   #   #                 #
# # # # # ##### # # ####### ##### # ###
# # # # #     #   #   # #     #   #   #
# ### # # ### ### ### # ### ### ##### #
#   #     #         #       #   #     #
#######################################
