#######################################
#     #         # #               #   #
# ### # ### ### # ### ### ### ##### # #
# # #   #   #         #   #     # # # #
# # ##### ### ### # ### # # # ### # # #
#   #       # #   #   # # # #     # # #
### # ########### ##### ####### ### # #
#   #   # #     # #     #       # # # #
####### # # # ############# ##### ### #
#       #   #   #           #     #   #
######### ### # ####### ### ### ### ###
# # # #   #   #         # #     #     #
# # # # ########### ### # # ### # # ###
#       #   # #   # #   #   #     #   #
# ####### # # # # ######### # # ### ###
#   #     #   # #     #     # # #   # #
### ##### ### # ########### ##### ### #
#   #     # #   #     #       # # # # #
### # ##### ### # ####### ##### # # # #
# # #   #   #   # #       #       #   #
# ### ### # # # # ####### # ### ### ###
#     #   #   #           # #         #
#######################################
