#######################################
#   #                         #       #
# ### # # # ####### ##### ### ##### ###
# # # # # #   #   # #   #   #       # #
# # # # ### # # # # ### # # # ### ### #
#     # # # # # #     # # # # # # # # #
######### ##### ####### ### ### ### # #
#               #             #       #
# ### ####### # # ####### # ### # # ###
#   #       # # # # #     #     # # # #
# ######### # ### # # # ### ### ##### #
# #   #   # # #   #   # # # #         #
# ### # # # ### ### # ### ##### # ### #
# #     #   #     # #   #       #   # #
# ### ##### # # ####### ##### # #######
# #   #     # #   #         # #   #   #
### ### ### ### # # # ##### ### ### # #
#     # #     # # # # #   #   #     # #
##### ##### # ### ### ### # # #########
#   # #     # # # # # # #   #         #
# ### ### ### # # # # # ####### # ### #
#     #   #     #   #   #       # #   #
#######################################
