#######################################
#   #   #   #                   #     #
# ##### # # # ### ##### ############# #
#     # # # # #   #   #     #       # #
### ### # # ### ##### # ######### ### #
#   # #   #     #   # #   #   #       #
### # ### ### # ### # ### # # # ##### #
# #   #   # # # #   # # # # # # #   # #
# ### ##### ####### # # # # ### # ### #
#   # #   #       # # #     # #   #   #
### # # # ### ### # # ### ### # ### # #
# #     #     #       #     #   #   # #
# # ### ### ### # ### # ##### # ##### #
# #   # # # #   #   #         #   #   #
# ####### ### # ### ### # ####### ### #
#             # # # #   #       #   # #
# # # ##### ##### # # # ### # ##### # #
# # # # # #     #   # #   # # #   # # #
# ### # # ########### # # # # # ### # #
#   #     #     # #   # # # #     # # #
############# # # ##### # #############
#             #         #             #
#######################################
