#######################################
#   #   #     #       #     #         #
# ### ### ### ### # # ##### # ####### #
#   #     #       # #       #   #   # #
# # ### # # ### ####### ### ### ### ###
# #     # # #       #     # #   # #   #
# # ############# ######### # ### # ###
# # # #   #               #   # #   # #
### # # ################# ##### # # # #
#   #   #       #   # #   # #   # #   #
# ##### ##### # ### # ### # # ##### ###
#   #         #   # #   #     #   #   #
##### # ### ##### # ### ### # ### ### #
#   # #   #   # # #   # #   # # #   # #
# ##### ##### # ### ### # ##### # ### #
#     # # #   # #       #   #   #   # #
# # # # # # ### ####### # # ### # # # #
# # #   #   #   #   #     # # #   # # #
####### # ##### ### ### ##### ##### # #
#       #           #   #   #   #   # #
# ######### ### # ##### # ### # ### # #
# #         #   #             #       #
#######################################
