#######################################
#                         #       #   #
# ##### ### ### ##### ####### ### ### #
# #       #   #   # #         #     # #
# ### ######### ### ####### ####### # #
#   # #     # # #       # # #     # # #
# # ### ##### # # ####### ### ### # # #
# #     #     #   #       # #   # # # #
# ### ### ##### ### ### ### # # # # # #
# #       # #   #   #     #   # # #   #
# ####### # # ### ##### # # ### # # ###
#   #   #   #   # #   # #     # # #   #
# ### # # # # # # # ####### ### # # ###
#     # # # # #         # # #   # # # #
# # ### # ### # # # ### # ######### # #
# #   # #   # # # # # # #       #     #
# # ############# # # ####### # ### # #
# # #   #     #   #     #   # #   # # #
# ### # # ### # ### ####### # # # #####
#   # #     # #   # #         # # #   #
##### ##### # ### ### ### # ### # # # #
#     #     #         #   #   # #   # #
#######################################
