#######################################
#         #   #                       #
### # # ### # # # ##### # ##### # ### #
# # # # #   #   #   #   #     # # #   #
# ### # # # # ####### ######### ##### #
#     #   # #       # #       #     # #
# ####### ### ### ####### ### ####### #
#     #     # # #   #     # #     # # #
### # ### ##### # ### ### # ### # # # #
#   # #     #   #   # #   #     # #   #
# ### ####### ### ### ##### # ##### ###
#   # # #   #   #         # # # #   # #
# # ### # ### # # ### ### # ### ##### #
# # #     #   #     # #   # #     #   #
# # ### ### ### ########### # # # # # #
# #   # #   #           #   # # #   # #
### # # ### ### # ######### ### #######
#   #   #   #   #   #     #     #     #
# # ####### ### ### ##### ##### # #####
# # # # #     #   #   #       # # #   #
### # # ##### ####### # ######### # # #
#     #         #                   # #
#######################################
