#######################################
#   #         #     #   # #           #
# # # ######### # ### # # # ### #######
# # # #     # # #     #   # # # # #   #
### # # ##### ##### # ##### # ### # # #
#   # # #     # # # #   #   #     # # #
# ### # # # # # # # ##### ### ####### #
# # #   # # # #   # # #   #         # #
# # # # ### ### ### # # ### ####### # #
# #   # # #     #     #   #       #   #
# ### # # ### ### ##### # ### #########
#   # # #     #       # # #   #       #
# ### # # ### ##### # # ### ### # #####
#   # # # #         # # #       # #   #
# ### # # # # # ####### # ### # ### # #
#     #   # # # #         # # # #   # #
# # ### # ### # # # ### ### # ####### #
# # #   #   # #   #   # # # # #     # #
# # ####### # ##### ##### # # # ### # #
# #   #   # #     #       #     # # # #
# ####### # ####### # # ### # ### # # #
# #             #   # # #   # #       #
#######################################
