#######################################
#       # #             #     #   #   #
####### # ########### ### ### # # # # #
# #   # #     #       # # # # # #   # #
# # # # ##### # ### ### # # ######### #
# # # #   # #     #       #   # #   # #
# ### # ### ############# # ### ### # #
#     # #   # #     # #   #     #   # #
# ##### ### # ##### # ### # ##### # # #
# #   # #   # # #   #     #   #   # # #
# # ### ### # # # # ### ##### # ##### #
# #     #       # #   # #   #   #     #
# ##### # ##### ### # # ### # ####### #
#   #     # # # #   # #     #     # # #
### # ##### # # ##### # ######### # # #
#         #   # #   # # #   #   # # # #
### ######### # ### # # ### # ### # # #
# # #   #       # # # # #     # #     #
# # # # # # ### # # # # ### ### ##### #
#   # #   # #   #         # # #     # #
# ### # ### ### ######### # # ### # # #
# #   #   #   #                   #   #
#######################################
