#######################################
#   #   # #             #     #   #   #
# # # # # # # ### ####### ### ### # ###
# #   # # # # # #   #   # #     # # # #
# ### ### # # # # ### # ### ##### # # #
# # # # # # # #   #   # # #         # #
# # # # # # ####### ### # ##### ##### #
#   # # # #     # #   #       # # #   #
##### # # # ##### ### ### ##### # ### #
#         #     #   #   # #         # #
# # ####### ##### # ##### # # ##### # #
# #   #     #     #         # #       #
### ### ##### ### ### # ####### ##### #
#         #     #   # #     # # #     #
### ##### ### # ##### # ##### # ### ###
#       #     #     # #   #   # #   # #
# ### # # # ######### ##### # # # ### #
# #   # # # #       # # #   #   #     #
# # ##### # # # ####### ##### ##### ###
# #     # #   #       #   # # #   # # #
# ####### ########### ### # # # # ### #
#   #               #       #   #     #
#######################################
