#######################################
# #   # # #     # #   #     #         #
# # ### # # # ### ### ### # # ### ### #
#   #   # # # # # #   # # # # #   #   #
# ##### # # ### # # ### # # ### # #####
#     #           #       #     # #   #
# ### # ####### ##### ### ### # ### ###
# #       #   #     # #   # # #       #
# # ##### # # ### # # ##### ######### #
# # #     # # #   # # #     #     # # #
######### # ##### # # # ### ##### # ###
#   #     # # #   # # # #   #     #   #
# ### ### # # # ##### # # ### ####### #
# # # #       #       # #           # #
# # ##### ### ######### ############# #
# # # #   #   #                 # #   #
# # # ##### ### ##### ### # ##### # # #
# # #   #     #     # #   # #     # # #
# # ### # ####### # ### ### # # ### ###
# # #   #         #   #   # # #   #   #
# # # ### ######### ##### ### # ##### #
#               #     #       #       #
#######################################
