#######################################
#   #     #           # #   #   #     #
# # # # ##### ### ### # # # # # # # ###
# #   # #       # # # #   #   # # #   #
# ####### ##### # # ######### # # ### #
#     # # #   # # #       # # #   #   #
# ### # ##### ### ##### ### ######### #
# #     #   #     #   #   #   # #     #
# ####### # ##### ### ### ### # # #####
# #       #       #   # #   #     # # #
# # # ##### # ##### # # ### # ##### # #
#   #   #   #       #   #   #   #     #
# ################# # ### # ### ### ###
#     #   #     #   # #   # #         #
# ### # # ##### # ##### ### # # # # # #
# # #   #   #     #     #     # # # # #
### # ##### # # # ### ####### ### # ###
#   #     # # # #   #   #     #   #   #
# ################# ####### ### # ### #
#       #     #       #       # #   # #
### ### # # # ### # # ####### # #######
#     #   # #     # #         #       #
#######################################
