#######################################
#   # # #       #   #   #     #     # #
# # # # # ####### # ### ##### ### ### #
# # #   #     #   # #   #   #   #     #
# ### ####### ##### ### # ##### # #####
# #   #   #     #   # #       # #     #
# # ##### ##### # ### # ####### # ### #
#       # #   #     #         #   #   #
### ### # # ##### # ### # ####### # ###
# # #   # #   # # #     # #   #   # # #
# ##### # # # # # ####### # # # ##### #
# # #   # # # # # #   # # # # #   #   #
# # ### # ### # # # ### ### ### # # ###
# #   # #   #     #   #   # # # # # # #
# ### # ### # ##### ##### # # # ### # #
#   #   #     #   #             #   # #
### ### # ####### ### ########### # # #
# #   # #     # # # # # #       # # # #
# ### # # ### # # # # # # ### # ### # #
# # # #     # #       # #   # #     # #
# # # # ##### # # ##### ### ##### ### #
#           #   #             #       #
#######################################
