#######################################
#       #   #   #     #           #   #
####### # # # # ### # ### # ### ### ###
#   #   # # # # # # #     # # #   #   #
# ### ### # # # # # ##### ### ### ### #
#   #     # # # # #   # # #   #       #
# # ### ##### ### ##### ### ### # # ###
# #   #               # #   #   # # # #
# ### ##### ### ##### # ### ####### # #
#   #   # # #   # #     # # # #   # # #
### ### # ####### # # ### # # # # # # #
# # #   #           # # # # # # #     #
# ### ########### ### # # # # # # #####
#   #     #       #           # #     #
### ##### ######### # ##### ##### ### #
#           #   #   # # #     #     # #
# ######### # # # # ### ### ### # # ###
# #   # #     # # # #           # # # #
# # # # ####### ### ######### ##### # #
#   # #   #   #     #   #         #   #
# ### # # # ####### # # ### ###########
#   #   #   #       # #               #
#######################################
