#######################################
#   #       #   #           #       # #
# ### ##### # ### ### # # # # ##### # #
# #   #       #     # # # # #   #     #
# # # # ### ### # # ####### ### ##### #
#   # #   #     # # # #   #   # # #   #
# # ### # ######### # ### ##### # # ###
# #   # #   #   #   #   #       # #   #
# ######### ### # ### # ##### # # #####
#   # #       # # #   # #   # # #     #
### # # ##### # ####### # ### ####### #
#     #     #   #         #   #   # # #
# ##### # # ### ### # ##### ### # # # #
# #     # #   #   # #     #   # #   # #
# # # ### ### ### # ######### # # ### #
# # # #     # # #   #   # #   # #   # #
# # # ####### # # ### ### # ### # ### #
# # #   # #   #         #   # # #     #
# ### ### # ### # # ##### ### # #######
# # #     # #   # #       # # # # # # #
# # ##### ####### # # # ### # # # # # #
#       # #       # # #               #
#######################################
