#######################################
#   #     #   #           #     #   # #
# # # ### # ##### ######### ##### ### #
# #   # #     # # #     #   #         #
# ##### ####### # # ### # # # ##### # #
#     #       #       # # # # #   # # #
# ##### # # ##### ### ### # # # # ### #
#       # #       # #   # # #   #   # #
# ### # ##### ##### # ### # # ### ### #
# #   #     # #     #   # #   #   #   #
### # ##### ##### ##### # # # # ##### #
# # # # #         #     # # # #   #   #
# # # # ############# ### ### ##### ###
# # #   #   #       #   # #   #   #   #
# # ####### ##### ##### # # ### ##### #
#     #   #     #         #   # #   # #
# # ### ####### ##### ### # ### # # ###
# #         # #       # # # #     #   #
# ########### # ### ### ### ### ##### #
#         #   # #       # #   # #   # #
# ### ### # ### ######### ### ### # # #
# #     #   #         #           #   #
#######################################
