#######################################
#     #   #         #       #   #   # #
# # ### # # ##### ### ##### # ### ### #
# #   # # # # #   #   #     # # # #   #
# ### # # ### # ##### # ##### # # # ###
#   # # # #     #     #       #   #   #
# ### # # # ####### # ##### # ### # ###
#   #   #   #       # #     #   #     #
# ##### # ##### ### # # ##### # ### ###
# #     #       #   # # #     # #     #
### # ##### ####### # ### # # ####### #
# # # #   # #   #   #   # # # #   #   #
# # # ### ##### ####### ### # # ##### #
#   #         #           # #         #
################### ####### # # ##### #
#           #     #     #   # # #     #
# ### ##### # ### ##### ### # ### #####
# # # #     # # #       #   # #   #   #
# # # # # ### # ##### # ####### # # ###
#   # # #     #       #   #     # #   #
### ##### ####### # ### # ### ### ### #
#       # #       # #   #   # #       #
#######################################
