#######################################
#     #                               #
### ### # ######### ##### ########### #
# #     #     #   # #   # #     #     #
# ########### # ### # ### # ### # ### #
#   #   #   #   # # # #   #   # #   # #
# # # ##### # ### # # # ####### ##### #
# # # #   #     # # #         # #   # #
### # # # ##### # # ######### # ### # #
#     # #   #   # # # # #       # # # #
# ##### ##### # # # # # ######### # # #
#     # #     # #   #     #   #   #   #
##### # # # ##### ##### # # # ### ### #
# #     # #   #   # #   #   #     # # #
# # ##### ### ### # # ### ####### # ###
#   #   #   # #   #     # # # #   #   #
# ### # ### ####### ##### # # # ### # #
# # # #             #   # # # #   # # #
# # ### # # ### # ### ### # # ### # # #
# # # # # #   # #       #   #   #   # #
# # # # # ### ############### # ##### #
#       #   #               # #       #
#######################################
