#######################################
#       #                     #       #
# ############# ### ####### # ### #####
# #   #     # # # #     #   # #   #   #
# # # ##### # ### ### # # # ### ### # #
#   #       #       # # # # #       # #
##### ##### ### ### ##### # ####### ###
#   #     #       #   #   #           #
# # ############### # ####### ####### #
# # #         #     #     #       # # #
# # # ### ##### ######### ##### # # # #
# #   # #     #       #     #   #   # #
# ##### # ### ############# ### # ### #
# #   # #   #     #     #       #   # #
# # # # # ##### # ##### ######### #####
# # # # # #     # #   #   #   #   # # #
### # # # ####### ### # ### # ### # # #
# # #       # #   #         #   #   # #
# ### ##### # ##### ########### ### # #
# #   #   #   #   # #           #   # #
# ### # # # ### # # ########### # ### #
#     # #       #         #           #
#######################################
