#######################################
# #           #       #     #         #
# ####### ### # ####### # ### ### ### #
# #     #   #   #     # #   #   # # # #
# # # # ### ##### ### ### ##### # # ###
#   # #       #   #   #   # # # # # # #
##### # ##### # ### ### ### # # ### # #
# #   # #   #     #       #   #     # #
# # ### ### ##### ##### # # # ##### # #
#   #   #       #   # # #   #   # # # #
# ### ### ##### ##### # # ##### # # # #
# #   # # #   # # #     #   #     # # #
### ### # # ### # ##### ######### # # #
#   #   #   #           #   # #   #   #
# ##### ######### ### ##### # # ### # #
#     #   #   #   #     #   # # # # # #
##### # ### ########### # ### ### # # #
#     #   #     #   #               # #
##### ### ### ### # # #################
#   # #   # # #   #   # #       #   # #
### # # # # # # ##### # # ##### # # # #
#       # #     #         #       #   #
#######################################
