#######################################
#     #   #       #         #   #   # #
# ##### # # ##### # # ### ### # # # # #
# # #   # #     # # #   # #   #   # # #
# # # ####### ### ##### # # ######### #
#       # #   #       # #     #     # #
####### # # ### ### ### ##### # ### # #
# #   # # # # #   #     #   # #   #   #
# # ### # ### ### ### ##### # # ##### #
#         # #   # #         #       # #
# ##### # # ### ### ####### ####### # #
# #   # #         #     # # # #   # # #
# # # # # # ### # ### # # # # # ### # #
#   # # # #   # #     # # #     #   # #
# ### # # # # # ####### # ####### #####
# #   # # # # # # #   #   #   # #     #
# ####### # # # # # # # ### # # ##### #
#   #     # # #   # #   #   # # #   # #
# # # # ##### ####### ####### # # # ###
# # # #   #   # #   #     #     # # # #
# # # ### ##### ### ### # # ### # # # #
# # #   #         #     #     #   #   #
#######################################
