#######################################
#       #   #     #     #     #       #
# # ##### # # ### # # ##### # # ##### #
# #       #   #   # #   #   #       # #
########### # # ####### # #############
#   # # #   # # # #             #     #
# # # # # # # ### ### ### # ### # ### #
# #       # # #   #     # # # #   #   #
# ### ######### ### ### ### # # ##### #
#   #               #   #     # #   # #
# # # # # ####### ####### # ### ### # #
# # # # #   #   #   # # # # # # # # # #
# ### # ### # ##### # # ### # # # # # #
# #   #   #     # #   #   # #   #     #
# # # # # ### # # # ### ######### ### #
# # # # #   # # #   #   #   # # # #   #
# ######### ##### ##### # ### # ##### #
#     #   #     #     # #   #       # #
### # ### ##### # # ### # # ####### # #
#   #     #   # # # #   # # #     # # #
########### # # # ### # # # ##### # # #
#           #   #     #   #       #   #
#######################################
