#######################################
#   #       #   #   #   #   # # #     #
# # # ##### ### # ### ### # # # ##### #
# #   # # #     # #   #   # #         #
# ##### # # ##### ### ### ####### # ###
#   # #     # # #   #   # # #   # # # #
### # ### # # # ### # # # # # # # ### #
#   #     # # # #     #     # #       #
# ##### ### # # ### # ####### # #######
# #   #   #   #   # #     #   #   #   #
### # # ####### # # ####### # ##### # #
#   # #         #     #   # # # # # # #
##### ####### # # # # # # # ### # # # #
#   #     #   # # # #   #       # # # #
# # ##### ######### # ####### ### # ###
# # #   #     #     #     #     # #   #
# ### # ### # ### ### ######### # ### #
# #   # # # #     #   #     # # #   # #
# # ### # # # # ### # # ### # # # # # #
#   # #   # # # # # # #   #   #   # # #
# ### ### # ### # ### ### ######### # #
#       #   #   #                 #   #
#######################################
