#######################################
#   #     # # #             #     #   #
### ##### # # # ########### # ####### #
# #   #   #     #   #     #   #       #
# ### # ### ### # ### ########### ### #
#     #   # # #     #     #     #   # #
# # ##### # # ####### ### # ### ### # #
# # # #   #     #   #   #     #     # #
# ### # ### ### ### # # ###############
# #     #   #   #   # # #     #   #   #
# # ##### ##### # ##### # ##### # # # #
#   #     #   # # #     #       # # # #
### # # ### # ### # ########### ### # #
# #   #     #     #     #   # #     # #
# # ### # ######### # ### ### ####### #
#   #   #       #   # #               #
# # ####### ### # ##### ### ####### ###
# #     #   # #     #     #   #       #
### ### # # # ##### # ####### # ##### #
#   #   # # #     #     #     # # # # #
# ##### ##### ### # # ##### ##### # # #
#     #         # # #     #     #     #
#######################################
