#######################################
#       #     # #   #   #   #       # #
# ##### # ##### # # # # ### ##### ### #
# #     #   #   # #   #     #         #
# # ####### # ### ####### ####### ### #
# #   #     # #         #         #   #
##### # ##### # ####### ### ######### #
#     #       # #     #   # #         #
# ##### ### # ### # # # ### ######### #
#   #   #   #     # #   #       #   # #
### ##### # # # ######### # ##### # # #
#   #     # # #       #   # #     # # #
# ######### # ####### # ### ##### # # #
#         # # #     # # #   #   # #   #
####### # # # ### # # ### ### ### #####
#       # # #   # #   # #   #   #     #
######### ####### ##### ### # # ### # #
# #     #   #       #   # # # # #   # #
# ##### ### ### ##### # # ### # # ### #
#   #     #   #   #   # #     #   # # #
# # # ### ### ### # ### ### ####### # #
# #     #         # #       #         #
#######################################
