#######################################
# #     #     #   #     #   #       # #
# # ### ### # # # # ##### # ##### ### #
# #   #     #   #   #   # #     #     #
# ### ### ##### ##### ##### ####### ###
#   #   # # #   #     #     #   #     #
# ##### ### ##### ######### ### # ### #
#     # # #   #   #           #   #   #
##### # # ### # # ######### # # ### ###
#   #           #   # #     #   # #   #
# # ### ##### ##### # # # ####### # # #
# # # #   #   # #     # # # # #     # #
# # # ### # ### ### ##### # # ####### #
# # #     #       # #   #   #         #
# # # ####### ####### ######### # ### #
# # #   #           #       #   #   # #
### # ### # # ### # ####### ####### ###
#   # #   # #   # #       #   #       #
# ### # ### # ########### ### # ##### #
# #   #   # #   #       #   # # #     #
# ####### ### ### ### # # # # ### # ###
#         #   #   #   #   #       #   #
#######################################
