#######################################
#   #   #                   #     #   #
# ##### ##### ####### # ### ### # ### #
#   # #     # #     # #   #     #     #
# ### ##### # # ### ### ###############
#   #     # #   # #   #             # #
# ##### # # ### # # ########### # ### #
# #   # #       #   #         # #     #
# # # ##### # # ### # ##### # #########
#   #     # # #   # # #   # #   #     #
##### ### ####### # # ### # ### # ### #
# #   #     # #   #   #   # #     #   #
# # ### ##### # # ### # ##### ### # ###
# # #   #   # # #   #   #   #   # #   #
# # # # # # # # # # ### ### ### ##### #
# # # #   #     # # #   # #     # #   #
# # # ### ### ##### # ### ### # # # ###
#   #   # #     #   #   #   # # # #   #
### ####### ### # # # ##### # # # ### #
# #   #   # # # # # #     # # # #     #
# ### ### ### # ### # # ### ### ### # #
#             #   # # #   #       # # #
#######################################
