#######################################
# #       #         #           #     #
# # # ### # ######### ##### # # ### # #
#   #   #   #     # # #   # # #     # #
# ##### ####### ### # # # # # ####### #
#     #   # #   #   # # # # #       # #
####### # # # ##### ### # ######### ###
#   #   # #   #     # # # #   #   #   #
# # ### # # ####### # ### # ##### ### #
# #     #         #     # # #       # #
# ######### # ### # # ### # # ####### #
#   #       # # #   # #   #         # #
# # # # # ### # ##### ### ##### ### # #
# # # # # #     #     # #     #   #   #
# # # # ##### ##### ### # ##### ### ###
# # # # #   #   #     #   #     # #   #
### ### # # ### ### # ### ### ### ### #
#   #   # # #   #   # # #       #   # #
# # ##### # # # ### # # ### # # # # ###
# # #     # # # # # #   #   # #   #   #
# ### # ### ##### # ### # ##### ##### #
#     # #         #   #   #         # #
#######################################
