#######################################
# #       #     #                   # #
# # # ##### ### # ### ####### ####### #
# # #       #   # # #   #           # #
# # ##### ### # # # ############### # #
# # #   # # # # #     #   #         # #
# ##### ### # # # # ### # # ##### ### #
#     #       #   #   # # # #         #
# ### ### # # # # ### ### ### #########
# #     # # # # # #     #           # #
# # ##### ### ##### # # ######### # # #
# #         # #     # #   #       #   #
######### ### ### ### # # ########### #
# #   #   # # # # #   # #     #       #
# # # # ### # # # ### # ####### ##### #
#   # #     # #   #   #       #     # #
# # ##### ### ##### ##### ### ##### # #
# #       # #   #     #   #   # #   # #
# ### ##### ### # ##### ### ### ##### #
#   #   #   #   # #   # #   #   #     #
### ### # ####### # # # # ### ### #####
#   #     #       # #   #   #         #
#######################################
