#######################################
# #   #     #       #       #     #   #
# # # ### ### ### # # # # # ##### # ###
#   #     #     # # # # # # #         #
##### ##### # ### ######### # # ##### #
#     #     # #   #       #   # #     #
# ##### ### ### ### ##### ##### # #####
# #   #   # #   #   # # #       # #   #
# # # ### # # # # # # # ######### # # #
#   # # # # # #   # #   #           # #
# ### # # # ######### ### # ##### ### #
# # #     #   #   # #   # # #       # #
### ##### # # ### # # # ### ### ### # #
#     #   # #     # # #     #   #   # #
# ### # # ####### # ####### ###########
#   # # # #   #   #   #         #     #
### # # ##### # ### # ##### ### ##### #
# # #         # #   #         # #     #
# # # ########### # ######### ### # # #
#   # #     # # # # #     #       # # #
# ### ### # # # # ### ### # # #########
#   #     #   #   #   #     #         #
#######################################
