#######################################
# #           #               #       #
# # ####### # # # ######### # # ### # #
# #   #   # #   # # # #     #     # # #
# # ### # # ####### # # ####### # #####
#   # # # # #   #   #   #       #     #
# ### # ##### ##### ### ### ##### ### #
# # # #   # #     #   # #   #     #   #
# # # ### # # ####### ##### ######### #
# #     # # #   #     #   # # #       #
####### # # ### # ##### # # # ### # ###
#   #                   #   # #   #   #
# ##### ##### ### ### ##### # # # # ###
# #   #     #   # #   #     #   # #   #
# # # ##### ### ### ####### # # # #####
# # # #     # # # #   #   # # # #     #
# # # # ### # # # ### # # ### ##### ###
# # #   # #   #   # # # # #     # # # #
# # ### # ### ##### # # ##### ### # # #
#   # # #   #     # #   #     # #     #
# ### # # # ##### # ##### ##### ##### #
#     #   #     #       #           # #
#######################################
