#######################################
#   #         #   #     #       #     #
# # ##### ### # ### ########### ### ###
# #   #     # # #           #     # # #
# ### # ##### # ########### # # ### # #
# #   #   # #     #         # # #     #
# ### # ### ##### # ####### # ##### # #
#   # # #     # # #       # #   # # # #
### # ####### # # ##### ### # ### ### #
#   # #               #   #     #     #
# ### # ### # ######### ##### # # #####
#   #   #   #     #   # #   # # #   # #
# ##### # # # ### # # # # # # # ### # #
# #     # # #   #   #   # # # #     # #
# # # ### ### # ########### ### # ### #
# # # #   #   #     # #   # #   # #   #
# ##### ### ####### # # # # # ##### ###
# #     #   #     # #   # #   #       #
# ####### ### ########### ### # ##### #
# # #   # #   #   #         #   #     #
# # # # # ### # ### ##### # # ### #####
#   # #       #     #     #     #     #
#######################################
