#######################################
#         #           # #   # #   # # #
# ### ### ##### # ### # ### # # # # # #
#   #   # #   # # # # #   #     # #   #
##### # ### # # ### # # ####### # ### #
#   # #     #   #   # #         #     #
# # ############# # # # ######### ### #
# # #       #     #     #     #   # # #
### # ##### ########### ##### # # # # #
#   #     #             #   #   #   # #
# ##### ######### ### # ### ### # # ###
#     # #         #   #     # # # #   #
### ######### ### # ####### # # # ### #
# #           #   #       #   # # #   #
# ##### ####### # # # ### ##### # # ###
#       # #   # # # # #     #   # # # #
### ##### ### # # # # # ####### # ### #
# #       # # # # # # # #       #   # #
# ##### ### # ####### # # # # ### # # #
#     # # # #         # # # # #   #   #
# ##### # # # ####### ### # ### ### ###
#       #         #   #   #   # #     #
#######################################
