#######################################
#   # #       #   #       #   #       #
# ### # ####### # # # ##### ### ##### #
#     #         #   #   #       #     #
##### ##### ### ####### ####### # # ###
# #   # #   # # #     #       # # #   #
# # ### ##### # ##### ##### # ### ### #
# #   #   # #   #   #     # #     # # #
# ### # ### # ### ### ### ####### # ###
#       # #       #   #   #   # # #   #
# ##### # ### ##### # ### # # # ##### #
# #     #   #   #   #   #   # #   #   #
##### ##### # # # ### # ### ### # # # #
#   #       # # #   # # # # #   #   # #
# # ### ### ### # ####### # ##### ### #
# # #   #     # #       # # #   # #   #
# ######### # # # # # ### # # ##### # #
# #         #     # # #   #         # #
# # ### # # # ########### #############
# # #   # # #     #     #             #
# ##### ### ### # # ### # ##### ##### #
#       #   #   #   #     #     #     #
#######################################
