#######################################
# #             #     # #   #         #
# # ######### ### ### # # ####### # ###
#   #   #     #   #   # # #       #   #
# ##### # ##### ### ### # # # ####### #
#     # #     # #     #   # #   #     #
##### # ##### # ####### # # ##### #####
#     #     #   #   #   # # #   # #   #
####### # ##### # ####### ##### # # # #
#   #   #   #   #       #       #   # #
# ### ##### # ### ####### ######### # #
#     #   #     # #   # #       # # # #
# ##### # ### # # ### # # ##### # # ###
#   #   # #   # # #   # # #   # # #   #
##### ### ##### # # # # # # ### # ### #
#     #   #   # # # # # # # # # # #   #
# ##### ### ### # # ### ### # # # # # #
#   #     #   #   #   #   #         # #
### ### ##### ### ### ### ### ##### ###
# #   #     #   #   #   #         #   #
# ### ##### ### # # ### ##### ##### # #
#     #           #           #     # #
#######################################
