#######################################
#     #     # #     #   #   #   # #   #
# # ### ### # ##### # # # # # ### ### #
# # #   #   #   #     #   #           #
# ### ### # ### # ######### ##### #####
#     # # # #   #   # #     #   # #   #
# ##### # # ### ### # ### ### ### # # #
#     #   #             # # #     # # #
##### ### ####### ####### # # ####### #
#   # # # #     # #         #         #
# ### # ### # # # # ##### ########### #
#     #     # # # # #         # #     #
# ##### ### # # # # ######### # # # # #
#   # # #   # #   #     #   #   # # # #
### # # # ### ####### # # ########### #
# #   # #   #   #     # # #     #     #
# ### # # # ### # ### # # # ######### #
#     # # #   # # #   #         #   # #
### ### ######### ####### ##### # ### #
# # #   #   #   #   #   #     # # #   #
# ### ### # ### ### # # ####### # ### #
#         #       # # #         #     #
#######################################
