#######################################
#   #     #       #   # #     # #     #
# # # ### ### ##### ### # ### # ### # #
# # # #     # #   #   #   #   #   # # #
# ### ### ### # ##### # ### ##### # ###
#   #   #     # #     # #     # # # # #
### ##### # ### ##### ### # # # # # # #
#     # # # #     # # #   # #         #
# ##### ### # # ### # # # ########### #
#     #       #   #   # #   #       # #
# ### ####### ### # ### ##### ##### ###
# #   #       #   # # #     #   # # # #
### ##### # # ### # # # ##### # # # # #
#   #     # # #       #     # #   # # #
# ### ####### ##### ##### # # ### # # #
# # #   #     #   #   #   # #   # #   #
# # ### # # ### # ##### ####### ##### #
# #   # # #   # # #   # #   #   #   # #
# # ##### ### # ### # # # # # ### # # #
# #     #   # #     # #   # #   # # # #
# # # # # # # # ### ### ### # # ### # #
#   # #   # #     #     #     #     # #
#######################################
