#######################################
#   #             # #           #     #
# ### # # ##### ### ### ######### # ###
#     # #   #   #   #   #     #   # # #
# ####### ####### # # ####### # ##### #
#   #             #   # #         #   #
# ### # ### ####### ### # ######### # #
# #   # # # #   #   #   #       #   # #
# ##### # # # # # ### ##### ### ### ###
#   #   # # # #     # #   #   # #   # #
##### ### # ####### # # ####### # ### #
#       #   #   #       #         #   #
# # ### ##### # ##### ### ######### ###
# #   #     # #   #       # #     #   #
##### ##### ### # # ### ### # # ##### #
#   # #   #   # # #   #       #       #
# ##### ##### # # ### # ##### ##### ###
#       #     # #     #     #     # # #
# ### ######### # ######### ##### ### #
# # # #         #   #     #   #       #
# # # ######### ### # # ############# #
#   #             #   #             # #
#######################################
