#######################################
#                 #       #           #
# ### # ### ######### # # # ######### #
# # # #   # #     # # # #   #   #   # #
### ####### # ### # ### ##### # ### # #
# #       #   # # #   #       # #   # #
# ### ### ### # # # ########### # # # #
# #   # #       #   #     #     # #   #
# ### # ############# ### # ##### #####
#   #     # #     #   # # #   # #   # #
# # ##### # # ##### # # # # ### ### # #
# # #       # #     #   # #   # #   # #
### # ####### # # ########### # # ### #
#   #           #   #     #   #       #
# ############# ##### ##### ######### #
# #   #   #   #   #   # #           # #
# # # # # # # ### # ### # # ##### ### #
#   #   # # #     #   # # # #   # #   #
# ####### # ### ##### # # # # # ##### #
#     #   # # #     #     #   #     # #
# ### # ##### # ##### ####### ####### #
# #   #               #       #       #
#######################################
