#######################################
#         #   #           #   #   #   #
# ####### ### ### # ##### # # # # ### #
#   #     # #   # #     #   #   #   # #
# ### ##### # ##### ############# # # #
# # #   # # #     #   #   # #     # # #
### # ### # # ####### # # # # ####### #
#   # #   # #   #     # #   #   #     #
# # # # ### # # ### ### ### # # ##### #
# # #   #     #   # #   # # # #     # #
### ### # ####### # # ### ### ##### # #
# #       #   #       #         #   # #
# ####### # ##### # ############# ### #
#           #   # # #     #   #     # #
####### # ### ####### ##### ### ### # #
#       #   #   #           # #   # # #
# ### ### # # # # ##### ##### ### ### #
#   #   # #   # # #   #   #   #       #
##### # ##### # ### ##### # # #########
#   # #     # # #         # # # #     #
# # ##### ### # # ####### # ### ### # #
# #       #   #     #               # #
#######################################
