#######################################
# #                     # #         # #
# ### ############### # # # ####### # #
#   # #             # #   #     #     #
# # ### ######### # ### ####### #######
# #     # #     # # #   #     #       #
# ####### # # # # ### ### ### # # ### #
#     # #   # #   # #       #   # #   #
### ### ### # # ### ####### ####### ###
#   # #   # # # #   # #   #   #       #
# ### ### # ### # # # # # ##### ##### #
# # #     # #     # #   # #     #   # #
# # ##### ### ##### # # ##### ### ### #
#   #   #     #       #   #   #     # #
### # # # ##### ##### ############# # #
# # # #   #         # #             # #
# # # # ### ##### ######### # # # # # #
#   # # #       # # # #     # # # #   #
# ##### # # # # # # # ### # # #########
# #     # # # # #   #     # #       # #
##### ##### # ### ### ##### ####### # #
#       #   #   #         # #         #
#######################################
