#######################################
#       #   #         #   #       # # #
##### ### # # ##### # # ### ####### # #
#   #     # #     # # #   #   # #   # #
# # ####### # ### # # ### ### # ### # #
# #       # # #   # #       #     #   #
# # ##### # # # # # ############# # ###
# # #   #   # # # #   # #     #       #
# ### # ####### # ### # ### # ####### #
#     #   #     # #       # #   #   # #
# ####### # ##### ######### # ##### # #
# #     #   # # # #         #     #   #
### ##### ### # # # ############# # # #
# #       #   # # #     # #       # # #
# ####### # ### # ### ### ######### ###
# #     #   #     # # #   # # #   #   #
# # ### ##### ### # # # # # # ### ### #
#     # #       #   # # # #       #   #
####### # ##### ### # ### ### ##### ###
#       # #   #   # #   #   #   #     #
# # ##### ### ### ### # ### ### ##### #
# #         #         #               #
#######################################
