#######################################
#           #   #           #       # #
##### ### # # ### ### ####### ##### # #
#   #   # # #       #   #     #     # #
# ##### # # ####### ### # # ### # ### #
#     # # #   #   # # #   # #   #     #
# ### ### ##### # # # ##### # ####### #
#   #   #   #   # #     # # # # #   # #
# ##### ### ##### ### ### # # # ### # #
# # # #   # # # #   # # #   #     # # #
### # # # # # # # ##### ##### ### # # #
#   #   # # #   #   #         # # #   #
# ### # ### # ##### ##### ##### #######
#   # # #   #   # #   # #     #     # #
### ### # # # # # # # # # ######### # #
# #   #   #   #     #               # #
# ### ##### ### ### ### # ### # ### # #
#       #     # #     # #   # #   # # #
# ##### ########### # # ####### # # # #
#   #         #     # #       # # # # #
# ####### # ######### # ### # ##### # #
# #       #           #   # # #       #
#######################################
