#######################################
# #         # #   #     #           # #
# # ### # ### # # # # ### ##### ### # #
#   # # # #     # # #   # # # # #   # #
# ### # ####### # # # # # # # # # ### #
# #   #   #   # # # # #   # # # # #   #
### # ### # # ### # # ##### # # # ### #
#   # # #   #   # # # #       # #     #
# # ### # # # # # ### # ### ### ##### #
# # # #   # # # #   # # #     #   #   #
# # # ### # # ##### # ### ####### # ###
# # #     # # #         # #     # # # #
### # ### # ##### # ### # ##### ### # #
#   # #   #       # # # # #   #   # # #
### ### # ######### # ### # # ### # # #
# #     # #     #   # # #   # # #   # #
# ####### ### # # ### # ### ### # ### #
#         #   # #     # #   #   #   # #
####### ####### ##### # # ### ##### # #
#   #   #     #           #   #     # #
# # ### ### ### ### ######### # ##### #
# #       #       #           #       #
#######################################
