#######################################
# # # #   #   #           # #       # #
# # # # # # # ########### # # # ### # #
#     # #   #           # # # # #     #
### ##### ######### ### # # # # #######
#     #   #   #   # # #   #   # # #   #
##### ##### # # ### # # ### ##### # # #
#   # #     #   #     #     # # #   # #
# # # # # ##### # ##### ### # # # ### #
# #   # #     # #     #   # # #     # #
### ### ####### ######### ### ####### #
#       # #               #       #   #
# ##### # # # # ####### # # ### # # ###
# #   #   # # #     #   #     # #   # #
# ### ####### ### # # ####### # ##### #
#           # # # # # #     # #   # # #
# # ########### ### ### ### ### ### # #
# #         #     # #   #   # #   #   #
# ##### ### # # ### # ### ### ### # ###
#     # #   # #   # # # # #   # #   # #
### # # ### ##### # # # # # # # ##### #
#   # #   #       #   #     #         #
#######################################
