#######################################
#   #               #     # #     #   #
### # ### ### ####### ##### # ### # # #
#   # #     #           #     #     # #
# # ### # ##### ##### ### ### ####### #
# #     # #   #     #     #   #   # # #
# ######### # # ### # # ### # # # # # #
# #         # # # # # # # # # # # # # #
# ### ####### # # # # ### ### # ### # #
#   # # #         # #       # #   #   #
### # # # ### # ########### ##### #####
# # # #   #   #   #       #   #       #
# ### # ####### # # ### ##### # ##### #
#     #   # #   #   # # #     # #     #
####### ### # # # ### # ######### #####
# #     # # # # #     # #         #   #
# # ### # # # # ##### ### ######### # #
#   #   #     #     #       # #     # #
##### ### ### # ######### ### # ##### #
#     # # #   #     #   #       #     #
# ##### # # ######### # ####### # #####
#   #     #       #   #         #     #
#######################################
