#######################################
#                 #         #         #
# # # ##### ######### ####### ####### #
# # # #   #   #     #   #   #   #   # #
# # # # # ### # ### ### # # ### # # ###
# # # # # # #   # #   #   # #     #   #
### # # # # ##### ### ##### # ####### #
#   # # #       # #     #   #       # #
# ##### ##### ### ##### # # ####### # #
#   #   #     #   # #     # # #     # #
### # # ####### # # ### # ### ##### # #
# #   #       # # #     # #   #   # # #
# ########### ### ### # ### # # ### # #
# # # #       #   #   #     # # #   # #
# # # ######### ##### # ##### # # #####
#   #   # #     #     #     # # # #   #
### # # # # # ######### ####### # # # #
#   # #   # #                   #   # #
# ### # ##### ##### ### ##### # # #####
#   # #         #     #   #   # #     #
### ##### # ### # ##### ### ######### #
#         #   # #   #     #           #
#######################################
