#######################################
#       #   #           #   #   #     #
### # ### # # ######### # # ### ##### #
# # #   # #   #       # # # #     # # #
# # ### # ##### ####### ### ##### # # #
# #   #   #         # #       # #   # #
# ### ##### ####### # # ### ### # # # #
#   # #   # # # #   #     #   #   #   #
# ### # ### # # # ### ####### # #######
#     #       # # #   #   #   #       #
# ### ######### # ####### ### # #######
#   #     #         #   #     #       #
######### # ####### ### ##### ### ### #
#       # # #     #   # #         #   #
# ##### # ### ####### # ##### ##### ###
# #   #   # # #   #   # #   #   #   # #
# ### ##### # # ### # # # # ### ##### #
#   #     # #   # # # #   #   #     # #
### # # ### # # # # ######### # ##### #
#   # #   # # #   #                 # #
# ####### # ### # # ### # ####### ### #
#         #     #   #   # #           #
#######################################
