#######################################
#   #     #       #   #     #         #
# ### # ### ##### ### # ### # ### ### #
#     #     #   # #   # #   #   # #   #
### ####### # ### # # # # # ### # # ###
#   #     # #   #   # # # # #   # # # #
# ##### # # ### ### # # # ### ### # # #
# #   # # #   # # # # # #   #   # #   #
# # # # # ##### # # # ### # ### # ### #
#   #   #   # #   # #     #     #   # #
# ######### # ### # ##### ######### ###
#   #     #   #   #     # #         # #
# # # ### ##### # ##### ##### ####### #
# #   # # #     #   # #     #         #
# ##### # # ####### # # ### ###########
# #     #     #   #   # #         #   #
### ####### # # ### ### # ####### # # #
#           # # #   #   # # #   # # # #
# ####### # # # # ### # ### ### # ### #
# #   #   # # #     # # # #   # #     #
##### ##### # ########### # # # ### ###
#           #               #     #   #
#######################################
