#######################################
#   #           #   #   #         #   #
# ####### ####### # ### # ##### # # ###
#       # #       #       #   # # # # #
### ##### # ####### ### ### # ### # # #
# #       # # #   # #   #   #     #   #
# ####### # # # # ### ### ##### ##### #
#         # # # #     #       # #     #
# ### # ### # # ####### ##### ##### # #
# # # #     # # #         # #     # # #
# # ####### # ##### ##### # # ### ### #
# #     #   #       #   # # # # #   # #
####### ####### ##### # # # # # ### # #
#       #   #     #   #     # #     # #
# ####### # # ### # # # # ##### ##### #
# #       # # #   # # # #     #     # #
# # # ##### # ### ##### # # # ### # # #
# # #     #   # # # #   # # # #   #   #
# # # ### # ### # # ### # # ### # #####
# # # #   #     #   #   # # # # #     #
# ### # ############### # ### ####### #
#     #               # # #           #
#######################################
