#######################################
# #                 #       #   #     #
# # ### ##### ### ### ##### # # # # ###
#   #   #   # # #       # #   # # #   #
# ####### ### # # ### ### ##### ##### #
#   #       #   # #       #   #   #   #
##### # ######### ##### ### ######### #
#     #   #       #     #     #     # #
# ### ### # ### ########### # # ### # #
# #     #     #     #     # #   #   # #
# # ### ####### # ### ### ##### # ### #
# # #     #     #     # #     # # #   #
# # # ##### ### ####### # ### ### # # #
# # # #   #   # # #     # #         # #
### # # ####### # # ### # ########### #
#   # #       # #   #     # # #       #
##### # ####### ### # # # # # ### #####
#     #           # # # # #     # #   #
# ####### # ### ####### # ##### # # ###
#       # # # #     #   #     # # #   #
######### ### ##### # ### ##### # ### #
#               #   # #         #     #
#######################################
