#######################################
# #                 # #             # #
# # ####### ##### ### # ##### ##### # #
#     # #   # # #   # # #     #   #   #
# ### # # ### # ### # # # ### # ##### #
# # #   # #   #   # # # #   #   #     #
# # ##### # # ### # # ##### ##### #####
# #     # # #     #       #   #   #   #
####### # ####### ### # # ### ##### # #
#       #         #   # #   # #     # #
# ### ########### # ##### # # # ##### #
#   # #         # #   #   #     #   # #
# # # # ########### ### # ######### # #
# # # # #       #   #   #   # #     # #
### ### # ##### # ### ### # # ### # # #
#         #     # # # #   #     # #   #
# ################# # # ##### ### # ###
# #     #   #   #     #     # #   #   #
# ##### # ##### ##################### #
# #     # #   # #   #   #       #     #
# # # ### # # # ### ### # ##### ### ###
#   #       #                 #       #
#######################################
