#######################################
#   #           # #       #   # #   # #
# # # ######### # # ##### # # # # # # #
# #   #   #   #   # # # #   #     #   #
# ### # # ### ### # # # # ##### ### # #
# #   # #           # #     # # # # # #
# ##### ### ######### ##### # # # ### #
#     # #       #           # # #   # #
### # ############# # ####### # # # # #
#   #   #   #   #   # #       #   # # #
# ##### # # # # # ### # ##### # # # ###
#   #   # # # #   #   # #       # # # #
### ##### # # ##### ##### # ##### ### #
# #       # #     #   #   #     #     #
# ####### ##### # ### # ##### #########
# #     # #     # #   #     # #       #
# # ### # ########### ### # # ### ### #
# #   # #     #     # #   # #     #   #
# ### # ##### ##### ### # ####### ### #
#   # # #     #   #     # # #   #   # #
# # # # # ##### ####### ### # # ### # #
# #   #   #             #     #     # #
#######################################
