#######################################
#   #   #       #                     #
# ##### ### # # # ####### ########### #
#         # # # # #       #   # #     #
######### ### ##### ### ### ### ##### #
#     # # #   # #   #         #     # #
# # ### # # ### ### # # ### # # ### # #
# #       # # #     # #   # #   #   # #
# # ####### # ### ### ############# # #
# # #   #   #     # #   # #     #   # #
# # ### # ####### # ##### # ### # ### #
# # #       #             # #   # # # #
### # ##### # # ############# ### # # #
#   # #   # # #   #   #     #     #   #
# ####### # # ### # # ### # ####### ###
# #   # #     # # # #   # # #   #   # #
# # ### # ### # # # ### # # # ### ### #
# # #     #   # #   # #   #   #       #
# # ##### # ### # ### ########### #####
#   #   # #     # # #       #   # #   #
# # ### # # # ### # ### # ### ####### #
# #       # #   #       #             #
#######################################
