#######################################
#           #   # #     # #       #   #
##### ####### # # # ##### # ##### # # #
#     #       # #   #       #       # #
# ############# ### # ####### ####### #
#   #         #   #         #     #   #
### ####### # # ####### ### # ### # ###
#   #       # #     #   # # #   # #   #
# # # ############# ##### ### ### ### #
# # # #           #         # #   # # #
# ### # ######### ### # # # # ##### # #
# #   #   #         # # # #   #   #   #
# # ##### # ####### # # ####### # # ###
#         #     #   # # #   #   # # # #
# ######### ##### ### # # ####### # # #
# #       #   #     # #   #       #   #
# # ####### ### ### # # ##### ####### #
# #       # #   # #   # #     #       #
# ####### # # ### ### ### # ### #######
#   #   #   # #   #   #   # #   #     #
### # # ##### # ### ### # ### ##### # #
#     # #     #     #   #           # #
#######################################
