#######################################
# #               #       #   #       #
# # ##### ##### ### ### # # # # ### ###
# # # #   #   # #   #   # # # #   #   #
# # # # ### # ####### ### ### ### ### #
#     #     #       # # # # # #   #   #
# ### ### ####### ### # # # # # #######
# # #   # #   #   #   # #   # #   #   #
# # ##### # # ### # ### ### # ### # # #
# # #     # # #         # # #   # # # #
# # ####### # # # ### ### ##### # ### #
# # #   #   #   # #     #             #
# # # # ######### ##### ##### # #######
# # # #       # #   #     #   # #     #
### # ####### # ### ##### ##### ### # #
#   # #       # # #     # #     #   # #
# ### ### ##### # # ### # # ##### #####
#       # # #   #     # #   #         #
# ##### ### ### # ##### ##### ####### #
# #       #       #   # #     #     # #
# # ### ### ##### # # # ######### # # #
# #   #         #   # #           #   #
#######################################
