#######################################
#   #     #   #   #         #   #     #
# # # ### ### # # ##### ### ### ### ###
# # #   #     # # #   #   #     # # # #
### ### ######### # ##### # ### # # # #
# #       #   # # #     # # #   # # # #
# # ##### # # # # ### # ### # ### # # #
# # # # #   #   # #   #     #     # # #
# # # # # ### # # # ##### ######### # #
#   #   #   # # # # #     #     # # # #
# ### # ### # ### # # ##### ### # # # #
# #   #     #   #   # #     #     #   #
# # ### ##### ##### # ##### ##### ### #
# # #     #         #     #   #   #   #
### ######### ########### ### ##### ###
#   #     #         #   # #           #
# ### # ### ##### # # # # # # ### #####
#   # #   #     # #   # #   #   #     #
### ##### ####### ### ######### ##### #
# # #       #       # #   #   # #   # #
# # # ##### # ##### ### # ### ### # # #
#         # #   #       #         # # #
#######################################
