#######################################
#         #     #           # #       #
# ### ### ### # # ### ##### # # ##### #
# # #   #     # #   # #   #   # #     #
# # ### ########### # # ######### #####
# #   #   #         #     #   # #     #
# # ### # ########### ### ### # ### # #
# #   # #           # #       #   # # #
##### ##### ####### # # ### ##### # ###
#   #     # #       # #   # #   # #   #
# # ### ### # ########### ##### # # # #
# #     #   # #     #     # # # #   # #
# ####### ### # ### # ### # # # ##### #
#           # #   # #   # #   #     # #
### ##### ### ### ##### ### ##### # # #
# #     # #     # #   #   #       # # #
# ##### # ##### # # # # ### ### ### # #
#     # #   #     # # #     # # #     #
### # # ### ####### # ### ### # # #####
#   # # #   #       # # # #     # # # #
# ##### # ### ##### # # ### ####### # #
#       #     #     #                 #
#######################################
