#######################################
#       #     #   #     #         #   #
# # ### # ### # # # # # # ####### ### #
# #   #     #   #   # #   #       #   #
# ### ####### # ##### ##### ### ### # #
# #   #     # # #   # #   # #   #   # #
# # ### ### ### # ### # # ### ### ### #
# #       # # # #     # #   # # # #   #
### ####### # ### ##### # ### # # # ###
#   #     # #   #   #   # #   #   #   #
# ### ### ##### ### # ### # ### ##### #
# #     #   # #       #   # #   #   # #
# # # # ### # # ####### # # # ##### # #
#   # #   # #   #     # # # #       # #
# ####### # ##### # ### ### # ##### ###
#       # #       #   #   # #   #   # #
### ### ### # ####### ### # ### ### # #
# # # # # # #   #   #   # #   #   # # #
# # # ### # # # # ##### # ##### # # # #
# # #       # #   #   # #     # # # # #
# # ######### # ##### # ##### ### # # #
#     #       # #       #         #   #
#######################################
