#######################################
#   #               #                 #
# ##### ##### ##### # ######### ##### #
# #     #   #     # # #       # #   # #
# ### ##### ########### ### # # # ### #
#   # #       #   # #     # #   #   # #
### # ### ### ### # ##### ##### # # # #
#   # #   #   #   # #   #     # # #   #
# ### # ##### # ### # # ####### # #####
# #   #     # # # #   #         # #   #
# ### # ####### # ### ####### # # ### #
# #     #         # #   # # # # #     #
# # ##### ######### ##### # ### ##### #
#   #     #   #     #   #     # #   # #
# ####### # # ##### ### ##### # # # ###
#     #     # #     #       #   # #   #
##### # ##### # ########### ### # ### #
#   #   #     # #         #   #   # # #
# # ##### ##### ### ### ##### ##### # #
# #         #     #   #   #   #   #   #
# ### ####### ### ### # ### # ### # # #
#   #         #       #     #       # #
#######################################
