#######################################
#     #   #   #     #     #         # #
# # ### # # # # ### # # ##### ##### # #
# #     # # # # # #   #   #   # #     #
# ####### ### ### # # ##### ### #######
# # #       #   #   #     #     #     #
### # # ####### # ####### ##### # ### #
#     #         # #       #   # #   # #
# ############### # ### ### # # ### # #
# #         #     #   #     # # #   # #
# ######### # ############# ### # ### #
#         #   #         #         #   #
######### # ####### ### # # # #########
# #     #   # #       # # # #         #
# # ### ##### # # ##### # # ### #######
#   # # #   #   #   #     #   #     # #
# ### # # # # ####### ####### # # # # #
#     #   #   #       #       # # #   #
##### ##### ####### ### ### ##### ### #
#   #   #   #     #   # # # #   #   # #
# # ### # ##### ######### ### # ### ###
# #     #               #     #       #
#######################################
