#######################################
#     # #       #     # #   #       # #
### # # # # ##### ### # ### ### ### # #
#   #   # #   #   # #   # #   #   #   #
# ##### # ### # ### # ### # ##### #####
# #   # # #   # #     # # # #   #     #
# # # ### ### # ### # # # # # # # #####
# # #       # #   # # # # #   # # #   #
# ######### # ### ### # # # ### # # ###
#       #   #       #   # # #   # #   #
# ####### ########### ### # # ### ### #
#         #         #       #   # # # #
### ######### # ### ### # # ##### # # #
#   #     #   #   #     # #         # #
# ####### # # ### ##### ### ######### #
# #     # # # # # #     #   #     # # #
# # ##### ### # # # ##### # ### # # # #
# # #     #   #   # #     # #   # #   #
# # # ### # ### ##### ### # # # ##### #
#   # #   # # # # #   #   #   #   #   #
# ### # ### # # # ####### # ##### # # #
#     # #     #         # #     #   # #
#######################################
