#######################################
#                 #           #   # # #
##### ### ######### ### # ### ### # # #
#   #   # #     #   #   #   #   # #   #
# ####### # # ##### # ##### ### # # ###
#       # # # # #   #   #   #     #   #
### ##### # ### ##### # # # # ##### # #
#   #     # # #       # # # # #   # # #
# # ##### # # ####### # ### # # ### ###
# # #     # # #   #   # #   #       # #
# ### ### # # # ### # # # ### ##### # #
#   #   #     # #   # # # #   # #   # #
### ### ####### # # # ### ##### # # # #
#       # #       # # #   #       #   #
# ####### # ######### # ############# #
#   #   #   #         #             # #
# ### # # ####### ### # ########### # #
# #   # #       # # # # # # #   # # # #
# # ### ########### # ### # # # # ### #
#   #   #       #     # # #   #   #   #
# ##### # # # # # # ### # ### ##### ###
#     #   # # #   #     #             #
#######################################
