#######################################
#         #     #   #   # #   #       #
##### ##### ### ### # # # # # ##### ###
#   # #     # # #   # # #   # #       #
# # # # ##### # # # # ### # ### ##### #
# #   #       #   # #   # # #   #     #
# ####### # # ##### # # # # # ####### #
#   #   # # #     #   #   # # # #     #
# # # # # # # # ### ####### # # # #####
# # # #   # # # #   # #   #   # #     #
### ####### # ### ### ### # ### ##### #
#     #     # # #   #   # #   #   #   #
# ### # ##### # ### # # # ### # # ### #
#   # # # #   # #   # # # #     #   # #
##### ### ##### # ### # # # ####### ###
#   #   # #   # # #   # #   #     #   #
# ##### # # # # # ### # ### ##### ### #
# #         # #   # # #   #     #     #
# ########### ### # ### ####### # #####
# #   # #       #   #   #   #   #   # #
# # # # # # ####### # ### # # ##### # #
#   #     #         #     #       #   #
#######################################
