#######################################
#   #     #           #         #   # #
# ### ### ######### ### # ### ### # # #
#     # #           #   # # # #   #   #
# ##### ##### ### ### ### # # # # #####
#   #   #   # # # #   #   #   # #     #
### # # # # # # ####### ####### ##### #
# # # # # #   # #     #         #   # #
# # # # # # # # # ### ##### ####### # #
# # # # # # # #   #       #   #   #   #
# ### # # # ####### ### # # ### # ### #
#   # #   #   # #   #   # # #   # #   #
# ### ####### # # ####### ####### # ###
#     #   #   # #   #     #   #   #   #
# ### ### # ### ### # # ### # # # ### #
# #     # #   # #   # # #   # # # # # #
# ##### # ### # # ### # # # # ### # # #
#   #   # #     # # # #   # #   # # # #
### # ### # ### # # ####### ### # # # #
#   #   # #   # # #   #       #       #
##### ### ### # ### # ####### ### #####
#     #       #     #           #     #
#######################################
