#######################################
#     #     #     # #   #       #     #
# # # # ####### # # ### ##### # ### # #
# # # #   #     # #         # #     # #
# ### ### # ##### ##### ### # ### #####
#   #     # #           #   # #   #   #
### ######### ######### # ### ##### # #
#   #     #   #     # # #   # #     # #
# ### # ### # # # # # ##### # # ##### #
#   # # #   # # # # #     # #       # #
### # # ### # # # # ### # # ####### # #
#     # #   # # # #     # # #     # # #
# ####### ### ### ######### # ### # # #
#       # #   #   #     #   #   # # # #
# ### # # ##### ### ### # ##### # ### #
# #   #       #   # # # # #     #   # #
# ########### ### # # # # # # ##### # #
#   #         #   # # #   # # #     # #
##### ### ##### ### # ####### # ##### #
#     #   #     #   #       # #   #   #
# ### # ### ##### ####### # # ### ### #
# #   #     #             #   #       #
#######################################
