#######################################
#     # #     #       #             # #
##### # # ### # ##### # # ######### # #
#   # # # # #       # # #   #         #
# # # # # # ######### ### # ### #######
# # # # #   # #     #     #   #   #   #
# # # # ### # ##### ######### ##### # #
# # # #       #     #             # # #
# ### ######### ##### ### ### ##### ###
# #   #   #     #   # #   # #   # #   #
# # ### ### ##### ##### ### ### # ### #
#   #   #   #     #           # # #   #
# ### # # # # # ### ##### ### # # # ###
# #   # # #   #   #   #   # # # #     #
# # # ### # # ### ### # ### # ####### #
#   # #   # # # # #   #     #   #     #
# ### # ### # # ######### ### # # #####
# #   #   # # # #   # # # #   # #     #
# # ##### # # # ### # # # # ### ##### #
# # #   # # #   # # #   # # # #     # #
# ### # # # ### # # # # ### # ### # # #
#     #   #   #       #     #     #   #
#######################################
