#######################################
#         #     #                 #   #
##### ### # ### ### ############# ### #
#   # #   # # #   #   #       # #     #
# # # # ### # ### # # # # ### # ##### #
# # # # #   #     # #   # # # #       #
# # ### ######### ####### # # #########
# #       #     #       # #   #       #
# ############# ####### # ### ####### #
#         #   # #   # #   # #     #   #
######### # ### # # # # ### # ##### # #
#     #   #       #   #   # # #     # #
# ### # ##### # ##### ##### # # ### # #
#   #   #   # # #       # #   # #   # #
# # ####### ### ##### ### ### # # ### #
# # #               # #   #   # #   # #
# # ####### ######### # ### ### ### ###
# # #       # #         # #   # # #   #
### # ####### ##### ### # ### # # ### #
#   # #         #   #       #   # #   #
# ### # ######### ##### ##### ### # # #
#     #               #           # # #
#######################################
