#######################################
#   #   #   # #           #       #   #
# ### ### # # # ### # # ### ##### ### #
#   #   # # #   #   # #   # # # #     #
# # ### ### ##### ### ### # # # ##### #
# #   # #     #   # # #     #   #     #
# ### # # ### # ### ### ##### #########
# #   #     # # #     #         #     #
# # ### ##### ##### # ####### # # ### #
# #     #     #     #   #     # # #   #
# ####### ### # # ##### # ####### #####
# # #     # #   #   # # # #     #   # #
# # ####### ####### # ### ### # # # # #
# #   #           #           #   # # #
### ### ####### # # ### ##### # ##### #
#     # # #   # #   #   #     #     # #
##### # # # # ####### ### ### # ### # #
#     #   # # # #     #   #   #   #   #
# # ### ### # # ### ####### ##### #####
# # #   #   #       #       #         #
# ### ### ### ####### ##### # #########
#     #     #   #         # #         #
#######################################
