#######################################
# #         #     #   #         #     #
# # ####### ##### # ####### ##### ### #
# #     #   #   # # #             # # #
# ######### # ### # # ####### ##### # #
# #     #   #       # #     # #     # #
# # ### # ### ### ### # ##### # ##### #
# #   # # #     # #   #         #     #
# ### # # # ##### # ####### ### # ### #
# #   # #   #   # # # #     #   # #   #
# # ### ##### # # # # # ##### ### ### #
#   #   #     # #   #     #   #     # #
##### ### ##### ### ### ### # ##### # #
#     #     #   #   #   # # #   #   # #
# ### ##### ### # ### ### # ### ##### #
# # # #   #   # # # # #     #   #     #
# # # # # # # ### # # ####### ##### ###
# #   # # # #       # #     #     #   #
# # ### # ######### # ##### ### #######
# # #   # #     #   #     #     #     #
# ### ### # ### ######### ########### #
#       #     #                       #
#######################################
