#######################################
# #       #     #           #     #   #
# # # ######### ##### ### ### ### # # #
# # #         # # # # #       # # # # #
# # ### # ### # # # ### ####### # # # #
# # #   # # # #               # #   # #
# # # ### # # ### # # ####### # ##### #
#   #   #   # #   # #   #     #     # #
# ##### ### # ### # ########### ### # #
# #   # #   #   # #   #     #   # # # #
### # ### ### ####### # ######### # # #
#   # #   #     #   #   #       # #   #
# ### # ### ##### # ### ### ##### ### #
# #   #   # #   # #   #     #   #   # #
### ##### # # # ##### # # ### # # ### #
#   #   # #   #   # # # #     #   # # #
# ### # # ####### # # # ##### # ### # #
#     #   # #   # # # # #   # # #     #
########### # ### # # # # # # # ### ###
#           #         #   # # #   #   #
# ######### ######### ##### # ### ### #
#   #                       #   # #   #
#######################################
