#######################################
#   #             #   #       #       #
# # ### ### ##### # ### ######### #####
# #   # #   #     # #     #     #     #
# ####### ### ##### # ### # # ##### # #
#       # #   #     # #   # # #   # # #
# ##### # # ### ##### # ### # # # # # #
#   #     #     #     #   # # # # # # #
### # ########### # ##### # ### # ### #
# # #       #     # #     # #   #     #
# ####### # # ####### ##### # ####### #
# #       #         #   # #         # #
# # ################### # ######### # #
#   #       #   #   #   #           # #
##### ### ### # # # ### ### # ####### #
#     #   #   #   #     #   #   #   # #
# # ####### ##### ####### ### ### #####
# #         # #   #   #   # #   #     #
# ########### # ##### # # # # ####### #
#       #     #       # # #         # #
### ##### ### ####### # # ######### # #
#   #       #           #     #       #
#######################################
