#######################################
#   #       #     #   #   #     #     #
# # # ##### ### ### # # # ### ### # # #
# # #   # #   #     # # #   #     # # #
# # ### # ### # ####### ##### ##### # #
# # #   #   # #   #     #     #   # # #
### # ##### # ### ### ### ##### ### # #
#   #   #   #   #   # #         #   # #
# ##### # ### ### # # ########### ### #
# #     #       # #       #     #   # #
# ####### ##### ######### # ### ### ###
#   #   # #               # # #   #   #
### # # # ########### ##### # ### ### #
#   # #   #         #       #   # #   #
# ### ##### ####### ####### # # # # ###
# #   # # # #   # # # #     # #   #   #
# ### # # # # # # # # ############### #
#   # #   #   #   # #         #       #
# # # # ### ##### # # ##### # # ### # #
# #   #         # # #   #   # # #   # #
# ##### # ####### ####### ### ### ### #
#       #       #         #       #   #
#######################################
