#######################################
#     #                       # #     #
# # ### ######### # ##### ### # # # # #
# #   #       #   # #     #     # # # #
# ### # ####### ### ### ### ##### # # #
#   # # #       # #   # #   #     # # #
# ### ### ####### ### # # ### ##### # #
# #     # # #       # # #   #   #   # #
# # ### # # # ### ##### ### ### ### ###
# #   # # #     # #     # #   #   #   #
# ### ### ####### ####### # # ### ### #
# # #     #     #       #   #   #   # #
# # ##### # ### ##### # ### ### ##### #
#   #   # # #         # #   # #     # #
# # # # # # ############# ### ##### # #
# #   # # #               # #   #     #
# # ##### ####### ######### ### # #####
# # # #   #     #   #     #   # # #   #
# ### # ### ### ### # ### ### # # # # #
#     #     # # #   #   #       #   # #
### ######### # # ### # ############# #
#   #           # #   #               #
#######################################
