#######################################
#                   #   #       # #   #
# ##### # ########### ### # ##### ### #
#   # # # #     #       # #   # #   # #
# # # # # ##### # ########### # ### # #
# # # # #   #   #           # # #   # #
# # # # ### # # ### ####### # # # # # #
# # #   #   # # #     #   #     # #   #
# # # ##### # ### ####### ####### ### #
# # #     # # #     #   #     #     # #
# # ##### ### # ### # # # ### ##### ###
# # #   #   # #   #   #   # # #   #   #
# # # # ### # ### # ####### # # ### # #
# #   # #       # # #   #   # # #   # #
####### ########### # # # # # # # ### #
#     #           # # # # #   # #   # #
# ### # ######### # # # ####### ##### #
# # # # #       # #   #         #   # #
# # # # # ##### # # # ########### # # #
#   #   # #   # # # # #           # # #
# # ##### # ### # ### ####### ##### # #
# #       #     #             #       #
#######################################
