#######################################
#     #               #       #       #
# ##### ##### # # ##### ### # # ### # #
#     # # #   # # #   # # # #   #   # #
# ### # # # ### ### # # # # ##### ### #
# # #     #   #     # # #   #   # #   #
# # ######### ####### # ##### # # #####
# #   # #   # #     #   #     #   #   #
# # # # # # # ### ####### # # ### ### #
#   #   # #   #           # # # # #   #
####### # ##### ### # ##### # # ### ###
#     # #   # # # # # #   # # # #   # #
# ### ##### # # # ##### ### # # # ### #
# # #       #   # #     #   # # #     #
# # ########### # # # # # ### # # ### #
#     # #   #   # # # # #   #       # #
##### # # # # ### # # ##### ##### # # #
#   # #   #       # #     # #     # # #
# ### # ####### ### ##### # ### ### ###
#   # #   #   # # # #   #     #   #   #
# # # ### # # ### # ### ######### # ###
# #   #     #   #     #           #   #
#######################################
