#######################################
#   #             #       #         # #
### # ################# ### ####### # #
#   #   #   #         #       #     # #
# # ### # ### # ##### ####### # # ### #
# #     # #   #     #       # # # #   #
# ####### ### ### # ####### # ### # # #
# # #   #   # #   #     # #     # # # #
# # # # # # # ### ##### # ##### # # # #
#     # # # # # # #   #       # #   # #
# ##### ### # # # # ##### ########### #
# #         #   # #   #   #           #
# ### ####### # ### # ##### ###########
#   #         # #   #     #   #       #
### ##### ########### ### ### ####### #
#   #         #     # # #   # #     # #
# ########### # ### # # ### # # ### # #
#       #     #   # # #   # # #   # # #
####### # ### ### # # # ### # ### # # #
#     # # # # #   #   #   # #     #   #
# ### # ### # ##### ### # # ##### ### #
#   #       #       #   #       # #   #
#######################################
