#######################################
#       #   #   #       #             #
# ####### # # # # # ##### ########### #
# #       # # #   #   #   #         # #
# # ##### ########### # ### ######### #
#   #   #             # #   #         #
##### # # ####### # ### # ### #########
#     # # # #     # #   # #           #
# ##### # # # ####### ### # ######### #
# #   # # #   #       #   # #       # #
# ### ### ##### ####### ### ### # ### #
#         # #   #       # #   # # #   #
# ######### ##### ### ### ### ### #####
#     #     #       # #   #     #     #
# ### # ##### # ### # # ####### # #####
# #   # #   # # # # #   #   #   #     #
# ##### # # # ### # ##### # # ####### #
# #   #   #   #   #     # # #         #
# ### # ####### # ##### # # ####### ###
#     #         # # #   # #   #   #   #
# ### ### ### ### # # ### # ### # # # #
#   #     #     #   #     #     #   # #
#######################################
