#######################################
#   # #         #       #         # # #
# # # # # ### ### # ##### # ####### # #
# # # # #   # #   # #   # #     #   # #
# # # # # # ### ### # # # ##### # ### #
# #   # # # #     #   #   #   #     # #
# ##### # # # # # # ######### # ### # #
# #     # #   # # # #   #         #   #
# # ##### # ### # # # # # ########### #
# # #   # # # # # # # #   #     #     #
# ### # # # # # # # # ##### # # # #####
#     # # #   # # # #       # # #   # #
### ##### ##### # # ######### ##### # #
#   #   #   #   # #         # #   #   #
# ### # ### # ### # ######### ### #####
# #   #   # # #   # #     #   #   #   #
# # ##### ### ####### ### # ### ##### #
# #   # #     #   #   #   #   #     # #
# ### # ####### ####### ### # # ### # #
#     #           #     # # # #   #   #
# ############### # ### # # # ### ### #
#                 #   #     #     #   #
#######################################
