#######################################
#     #             #         # #     #
##### # ########### ### ##### # # #####
#   #   #     #         #   #   # #   #
# # # ### ### # ##### ### # ##### # # #
# # # #   #   # #     #   #     #   # #
# ### ### ##### # ##### ####### ##### #
# #       #     # # #   #     #   #   #
# ### ##### ##### # ### ##### ### # ###
#   # #   #   #     # # #   # #   # # #
# # ### # # # ####### # # ### # # # # #
# # #   #   #   #     # # #   # # #   #
### # ######### # ##### # # ### # ### #
#   # #       #       #   #   # # #   #
# ### ##### # # ##### ####### # # # # #
#     #     # #   #   #     #   # # # #
# ##### ##### ### ### # ### ##### # ###
#       #   #   # # #   #         #   #
######### ##### # # ##### ##### # ### #
#     #   #     #     #       # # #   #
# ### # # # ##### # # ######### ### ###
#   #   #       # # #         #       #
#######################################
