#######################################
#   #       #           #   #     #   #
### # ##### ### ####### # # # ### ### #
# # #     #   #       # # #   # #   # #
# # ####### # ### ### ### # ### # # # #
# #     #   #   #   #     #   #   #   #
# ##### # ##### ####### ############# #
#     # #   # #         #         #   #
##### # ### # # # ########### ### # ###
#     #     #   #   #       # #   # # #
# ### # ##### # ### # ##### # # ### # #
# #   # #   # # #   #     # # # #   # #
# ##### # ##### ### ### ### # # # ### #
# #     #     #   #   # #   # # # #   #
# # ######### ### ### ### ### # ### # #
# #   #   #     #   #     #   # #   # #
# ### # # # ####### ##### ### # # #####
#   # # #   #   #   #   #     # # #   #
# ### # ####### # # # ######### # # # #
#   #   #       # # #   #   #   #   # #
# # # ####### ### ### # # # # ####### #
# #         #     #   #   #           #
#######################################
