#######################################
#           #     #     #     #       #
##### ### ### ### # ### # # # # ### # #
#     # # #   # #   #   # # # # #   # #
# ##### # # ### ##### ### # ### # ### #
#     #   # #       # #   #   # # #   #
# ### ##### # # ##### # ### # ### # ###
#   #   #   # #       # #   #   # #   #
# # ##### ### ########### # ### # ### #
# #         #   #         # #     #   #
# ####### # ### # ######### ####### ###
# #   #   #   # #   #     #     # #   #
# # # ####### # ### # # # ##### # ### #
#   # # #   # #   #   # #     # #     #
##### # # # # ######### ##### # ### ###
#   #   # # #     #   #   #   #   # # #
### ### ### ### ### # # ### ####### # #
#     # # # #   #   #   #       #   # #
# ##### # # ### # ####### ##### ### # #
#       # #   #         # #   #   # # #
# ####### ### ####### ##### # ### # # #
#               #           #   # #   #
#######################################
