#######################################
# #   #       #     #     #     #     #
# ### # # ### ### # # ### ##### # # # #
#     # # #       # #   #     #   # # #
# ####### ######### # # ####### ### ###
# #     #   #       # #       # # #   #
# # # # ### # ########### ### # # ### #
# # # #     #   #   #     #   #     # #
# # ######### # # # # ##### ### ##### #
# #   # # #   # # #   #   #   # #     #
# # # # # ### # # ##### # ### # # ### #
#   # # #   # #   #     #     # # #   #
##### # ### # ################### #####
#   # #   # #                   #     #
### # ### # ################### ##### #
#   # #   #     #             # # #   #
# # # # # ##### ####### ### # # # # # #
# # #   #     #       # # # # #   # # #
# # ####### # ##### # ### # # ### # ###
# #   #     #   # # #     # #   # #   #
# ##### ##### # # # ### ### ### # ### #
#           # #     #   #     #       #
#######################################
