#######################################
#       # #     #     #   #   #   # # #
# ### ### # ### # ### # # # # ### # # #
# #   #       #     #   #   #     # # #
# # ################### ######### # # #
# #   #   #     #       #       # # # #
##### # # # ### # ####### ######### # #
#     # #   #   # #   #   #         # #
# # ### ##### ### # # # # # ######### #
# # #   #     #   # #   #   #         #
# ### ##### ### ### ######### ##### ###
# #   #   # #   #   #   #         #   #
# # ### # # ### # ### ##### ####### # #
#   #   #       # #   #   # #       # #
# ### ########### # ### # ### ####### #
# #   #         #     # #     #   #   #
# ##### ####### # ##### ######### # ###
# #     #     #         #     #   # # #
# # ### # ### # ####### # ### # # # # #
#   # # #   #   #   # #   # # # # # # #
##### # ######### ### ##### # # ### # #
#                 #           #       #
#######################################
