#######################################
#   #   #       #       #   #     #   #
# # ### # ##### # ##### ### ### # # # #
# # # #   #   #   # #     # #   # # # #
# # # ### # # ### # ##### # # ### # # #
# #       # # #   #     # # #   #   # #
# # # ##### # # # # ### # # # # #######
# # # #   # #   # #   # #   # #       #
# # ##### # ##### ### # ### ##### ### #
# #     #   #   #   # #   # #   # #   #
# ##### # # # # ##### ### ### # ### # #
# #     # #   #       # #     # #   # #
# # ############# ##### ######### ### #
# #       #   #       #     #     #   #
# ##### ### # # ##### # ### # # ##### #
# #     #   # #     # # #   # # #   # #
# ##### ### ####### # # # ### ### # ###
#   #   #   #   #   # # # #       #   #
### ##### # # # # ##### # ########### #
#   #     # # # #       #     #   #   #
# ### ##### ### ##### ####### # # # # #
#     #           #   #         #   # #
#######################################
