#######################################
#   #         # #     #               #
### # ##### # # # ### # ### ####### # #
#   # #   # #   #   #   #   # #   # # #
# # ##### # ### ### ##### ### ### ### #
# #   #   #   # #   #       #   # #   #
# ##### ##### # # ############# # # ###
# #     #     # # #             #     #
# # # ### ### ### # ########### #######
# # #   #   # #         #   #   # #   #
# ##### ### ### ####### ### # # # ### #
# #   #   #   #     # #   #   # # #   #
# ### ### ### ### ### ### # # # # # # #
# #           #     # #   # # # # # # #
# # ######### # ### # # ##### ### # ###
#     #   #     # #   #     #     #   #
# ### ### # ##### ### ##### ##### # # #
# #   # #     #     # #   #   #   # # #
# # ### ##### # ####### ##### # ##### #
# # #       # #         #   # #   #   #
### ####### ### ##### ### # # # ### ###
#           #     #       #   #       #
#######################################
