#######################################
#       #   #         #       # #   # #
##### ##### # ####### # ##### # # # # #
#   #       # #     # #   #   #   # # #
# # # ##### # # ### # ### # ### ### # #
# #   #   # #     # # #   # # # #   # #
# ##### # ######### # # ### # # # ### #
# #     #           # # # # #   #     #
# ### ####### ######### # # # ##### # #
#   #   #   #     #     # # #     # # #
# ### # # ####### # ##### # ####### # #
#     #   #   #   #     #           # #
####### ##### # ##### # ####### ##### #
# #     #     #     # #   #   # #     #
# # ### # # ########### # ### # # #####
# # #   # #             #   # # # #   #
# # # ############# ######### ### ### #
# # # #       #     #   #       #     #
# # # # ##### # ####### # ### ####### #
# # # # #   #   #       #   #       # #
# ### # # ####### # ####### ####### # #
#       #         #               #   #
#######################################
