#######################################
#       #   #         #   #           #
# ##### # ### ### ##### ####### # #####
# # #   # #   #   #   #   #   # #     #
# # # ### ##### # # # # # # # ### ### #
# # #     #   # # # #   #   #   # # # #
# # ##### # # # ### # ####### # # # # #
#   #   # # # #     #   # #   # #   # #
# ### ### # # ### ##### # ########### #
# #     #   #   #   # # # #           #
# ##### ########### # # # # ##### #####
#     #     #       # #   #   # # #   #
# ### # ### # ####### ##### # # ### # #
# #   # #     #   #     #   # #     # #
### ##### # ### # # ### # ### # ##### #
#   #     # #   #     # #   #       # #
### # ####### ####### ### ########### #
# # #   #   # #       # # #         # #
# # # ### ### # ####### # # ####### # #
#     #   #   #   #       # #     # # #
### ##### # ##### ######### # # ### # #
#           #               # #       #
#######################################
