#######################################
#   # #         #     #   #         # #
# # # # ####### # ### ### # ### ### # #
# # # #     # #   # #         #   #   #
# # # ### # # ##### ######### # # ### #
# # #     # #             #   # #   # #
# ####### # # ######### ### ####### ###
#       # #     #       #   # #   #   #
# # ### # # ##### ####### ### # ##### #
# # #   # # #   #       # #   #   # # #
# # ##### ### # ####### # ### # # # # #
# #   #   #   # #   #   #       # #   #
# ### ### # ### # # ### ##### ##### ###
# #     #   # #   # # # #   #     #   #
### ### ##### ##### # # # ####### ### #
#   # #           #   # #     #   # # #
# ### ##### ##### ##### ### ### ### # #
# #     #   #   # #   #   # #   #     #
# ### # # ### # ### # ### # ### ##### #
#   # #     # #     #     #   #     # #
# # ######### ############# # ##### # #
# #                         #   #   # #
#######################################
