#######################################
#     # #   #   #       #         #   #
# ### # ### # # ### # ### ####### # # #
# #       #   # #   # #   #     # # # #
# ####### # ### # # ### ##### # # ### #
#   #     # #     # #   #     # #   # #
# # ####### ######### ### ######### # #
# #       # #       # #           #   #
# ####### # ### ### # ### ####### #####
# #     #       #   #   # #     #   # #
# ### # ####### # ### # # # # # ### # #
#   # #   #     #     #   # # #   # # #
### # ### # ############### # ### # # #
#   #   # #       #       # # #     # #
####### # ### ### # ####### # ####### #
#   #   #     #     #     # #   #     #
# # ####### ### ##### # # # ### # # ###
# #     #     #     # # # # #   # #   #
# ##### # ######### # # ### ### ##### #
# #   #   #         # # # #   #   #   #
# # # ##### ########### # ### ### # # #
#   #     #             #     #     # #
#######################################
