#######################################
#       #   #     #         #       # #
##### # # # # ### # # ####### ### ### #
#   # #   #   # # # #   #   # # # #   #
# ######### ### # ##### # # # # ##### #
#   #   #   #   #       # #   # #   # #
### # # # ### # # ### ### # ### # # # #
# # # # # #   # # # #   # # #   # #   #
# # # # # # ##### # ### # # # ### ### #
#   # #   #   #   #     # #   # #   # #
### # ### # # # ### # ### ### # # # ###
# #     # # #   #   #     # #   # #   #
# ####### # ##### ### ##### ##### ### #
#         #     # # #   #     #   #   #
########### ##### # ### # ### ##### ###
#       #   #     #   # #   #     #   #
# ####### ### ##### # # ### ##### # # #
# #     #   #   #   #   #   #   # # # #
# # ### ### ### # ####### ##### # ### #
# #   #   # #   # #       #     #     #
# # # ### # # ### # ####### ######### #
#   #   #   #   #   #                 #
#######################################
