#######################################
#         #                           #
# ####### # ################# ####### #
#       #   #     #       #         # #
# ############### # ##### # ####### # #
# #             #     # #       #   # #
# # ######### ####### # ######### #####
# #   # #   #       #     #     #     #
# ##### # # # ##### ####### ### ##### #
# #   #   #       #         #         #
# # # ########### ######### # ####### #
#   #       #   #   #     # #       # #
########### # ##### ### ### ####### # #
#   # #   #   #       #     #     # # #
### # # # ### # ##### ##### ##### # ###
#   #   #     #   # #     #       #   #
# # ######### ##### ################# #
# #   #     # #   #   #     #     #   #
# # ### ### # # # # # ### # ### ### ###
# # #   #   #   #   #   # # #   #   # #
# ### ### ############# # # # # ##### #
#       #                 #   #       #
#######################################
