#######################################
# #     #       #       #     #       #
# # ### # # ##### # ### # ### # # ### #
#     # # #     # #   #   #   # # #   #
# ##### # ##### # ### ##### ### # # ###
# #   #   #     #   # #   #   # # #   #
### # ### # ### ### # # # ### # # ### #
#   #   # #   #   # # # #   #   #   # #
####### ##### # ### # ##### ##### ### #
#             # #   #     # #   # #   #
# ####### ####### ####### # # # # # ###
#       # #       #   #   # # #   # # #
### ### ### ####### # # ### ##### # # #
# # #       #     # #   #       # # # #
# ### ####### ### # ##### ##### ### # #
#   # #     # #   #     #   # #     # #
### # # ### # ### ##### ### # ####### #
#     # #   #   # #     # #         # #
# ##### # ##### # # ##### ######### # #
#   #   #     # #   #   #     #   #   #
### # ####### # # ##### # ##### # ### #
#   #       #   #       #       #     #
#######################################
