#######################################
#   #   #   #             # #     #   #
# ### # # ### ##### # ##### # ### ### #
#     # #       #   # #     #   # #   #
# ##### ######### ### # ### ### # # # #
#     # #     #   #   #   # #   # # # #
##### # # ##### ### ### ### # ### # ###
#     # #   #   # # # # #   # # # #   #
####### # # ### # # # # # # ### # ### #
#       # # #   #     # # #   #   #   #
# ######### # ### ##### # ##### ### ###
#           # # # #     #   #   #     #
# # ######### # # # ####### # ####### #
# #     #     # # # # #       #       #
# ##### ### ### # # # # ### ### #######
#     #   # #   # # #   # #   #   #   #
######### # # ### # # # # ##### # # # #
#         # # #   # # #   #   # #   # #
# ######### # ##### # ### # # # ##### #
# #         #       #   # # #     #   #
# # ##### ############# # ######### ###
#       #               #             #
#######################################
