#######################################
#                 #               #   #
# # ##### ####### ##### ### ##### # ###
# # #     #     #     #   # #     #   #
# # ####### ### ######### # ### ##### #
# #           #   #   #   #   #     # #
# ####### ##### # # # # ##### ##### # #
#     # # #     #   # # #   #     #   #
##### # # # ######### ##### ##### #####
#   # #   #   #   #       # #     #   #
# # # ### # # # ######### # # # ### # #
# # #   # # #   # #   # # # # # #   # #
### # ### # # ### # # # # # # ### ### #
# #   #   # #       # # #   #     #   #
# # # # # # ######### # ########### # #
# # # # # #         # #           # # #
# ### # # ######### # # ### ##### # # #
#     # #   #   #   # #   #   #     # #
# ##### ### # # # ### ##### # ####### #
# #     # # # # # # # #   # #   #     #
# # ##### # # # ### ### # ##### # #####
# #   #       #         #       #     #
#######################################
