#######################################
#   #     #           # #     #       #
# # # ### # ######### # # ### ####### #
# #   # # # #       # #     #     #   #
# ##### # # # # ##### ####### ### # ###
# # #   #   # # #     #     # # # #   #
# # ### ##### ### ### # ### # # # # # #
#     #     #   # #       # #   # # # #
# ### ##### # # # # ####### ##### ### #
# #       #   # # #   #   #           #
# # ##### # ### # ##### # ########### #
# #     # # # #   #   # # #       #   #
# ### ### ### ##### # # # # ##### #####
#   # #   #   #     # # # # #   # #   #
####### ### ##### ### # # # ### # # # #
#   #           # # #   # #     #   # #
# # # ######### # # ##### ### ####### #
# #   #   #   #   #       # # #     # #
# ##### # # # ### # ####### # # ### # #
# #     # # # #   #   #       # # #   #
# # ##### ### ####### ######### # ### #
#   #       #                   #     #
#######################################
