#######################################
#       #       #   #     #   #       #
### ##### ### # ### # ### # # # ##### #
#   #     # # # #   # #     # # #     #
# ### ##### # # # # # ####### # ##### #
# #   #     # #   # #     #     #   # #
# # ##### # # ### ####### ####### # # #
# # #   # # #   # #   #   #     # # # #
# # # # # # ### # # # # ####### # # ###
# #   # # #   # # # # #       #   #   #
# ##### # ### # ### # ##### ######### #
#     #   #   #     #     #           #
### ####### ####### ##### ####### #####
#   #   #     #   #   #     #   #     #
# # # # ####### # ##### ##### # # ### #
# #   #         #     #     # # #   # #
# ### ############### ##### # # ### # #
# # #             #       #   #     # #
# # # ##### ####### ##### ######### # #
# #   #   # #       #   #   #     # # #
# ##### # # # ####### ##### # ### ### #
#       # # #       #         #       #
#######################################
