#######################################
#                   #         #       #
# ##### ########### ##### ### ##### ###
# #   # #       #         # # #   #   #
### # # # ##### # ######### # # # ### #
#   #   #   #   # #   #         #   # #
# ##### ### # ##### # ############# # #
#   # #   # #     # #       #   #     #
# # # ### # ##### # ####### # # #######
# # # #   #     #       # #   #       #
### # # # ##### ######### ########### #
#   # # #   #   #   #     #       #   #
# ### # ##### ### ### # ##### ### # ###
# #     #   # #     # #       # # #   #
# # ##### # # ##### # ######### # ### #
# # #     # #   #   #     #         # #
# # # ##### ### # # ##### ### ####### #
# # # #       # # #     #   #     #   #
# # # # ##### # # ##### ### ####### # #
# # # # #     # # #   # #   #   #   # #
# ### # ####### # # ### # ### # # ### #
#     #           #     #     #   #   #
#######################################
