#######################################
#           #     #                   #
# ######### ### # # ############# ### #
#       # # #   #   #           # # # #
# ##### # # # ####### ######### # # # #
# #     # # # #     #   # #   # # #   #
### ##### # # # # ### # # # # # # # ###
#   #     #   # #     # #   # #   #   #
# ### ### ##### ######### ### # ##### #
#   # # #     # #   #       # #   # # #
### # # ##### ### # # ####### ### # # #
#   #     # #     # #     #   #     # #
# ####### # ##### ####### # ####### # #
#   #     # #     #       # #   #   # #
### ####### # ### # ####### # # # ### #
#   #   #   # #   # #     # # # #   # #
# # # # # ### ### ### ##### # # ##### #
# #   # #   #   #     #   #   #       #
# ##### ### # # ### ### # ########### #
# #   # # # # #   # #   #       #     #
# # # ### # # ### ### ### ####### #####
#   #       #   #       #             #
#######################################
