#######################################
#           #       #       #     #   #
# ####### ### ##### # # ### # ### # # #
#   #     #   #     # #   # #   # # # #
# # ##### # ### ######### ##### # ### #
# #     # #   #   #         #   # # # #
# ##### ##### ### ### ##### ### # # # #
# #   #       # #     #       # #   # #
# ### ####### # ### ######### # ##### #
#   # #   #   #   #       # # # #     #
### # ### # ### # ####### # # # ### # #
# #   #   #   # #       # # #   #   # #
# ##### # ### # ### ##### # ##### ### #
# #     # #   #   # #     #       #   #
# # ### # ### # # ########### ##### ###
# # # # #   # # #           #   # # # #
# # # # ### # # ##### ##### ### # # # #
# # # # #   # #   #   #     #   #   # #
# # # # # ### ##### ### ##### ### ### #
#   # # #   # #   # #   #     #   #   #
# ### # ##### # # # # ##### ### ### # #
#     #         #   #       #       # #
#######################################
