#######################################
# #       #     #       #   #         #
# # ### ### ### # # ### # # ##### #####
#     #     # #   #   #   #       #   #
############# ####### ### ######### ###
#       #       #   #   # #   #   #   #
# ##### # ##### # # ### ### # # # # # #
#   # # #     #   #         # # # # # #
### # # ### ################# # # ### #
#     #     #         #         #   # #
############# ####### # ### ####### # #
#           #   #   # #   #       #   #
# ##### ### ### # # # ##### ##### #####
# #   #   #     # # # #   # #   # #   #
# # ############# # # # # # # # # # # #
# # #             # #   # # # # #   # #
# # # ############# ##### # ### ##### #
# #   #   #   #   #     # # #   #     #
# ##### # # ### # # ### # # # # # #####
#   #   # # #   #   #   #   # # # #   #
### # ### # ##### ####### ### ### # # #
#     #         #         #         # #
#######################################
