#######################################
# #               #           #       #
# # ############# ######### # # # ### #
# #   #   #     #           # # # # # #
# ### # # # ### ############# # # # # #
#     # #   # #             # # # #   #
# ##### ##### ##### ##### ### # # # ###
# #   # #       # #     # #   # # #   #
# ### # # ##### # ##### ### ### # ### #
#   #     #   #       #   #   # # #   #
# # ####### # ####### ### ### # # # ###
# #         #       #   #   # # # # # #
############# ######### ### # # # # # #
#     # #     # #     #   #   # # #   #
# ### # # ##### # ### ### ### # # #####
#   #         #     # #   # # # #     #
### ######### ##### # # ### # # ##### #
# # #   #   #     # #   #   # # #     #
# # # # # ####### # ##### # # ### #####
# #   # #   #   # #     # # #     #   #
# ### ### # # # # ##### # # ####### # #
#     #   #   #   #       #         # #
#######################################
