#######################################
#   #         #   #   #     #     #   #
# # # ### ### # # # ### ### # ### # # #
# #   #   #     #   #   #   #   #   # #
##### # ##### ##### # ### ### ####### #
#   # #     # # #   #   # #   #   #   #
# # # ##### # # ####### # ##### # # # #
# # # #   # # #     #   #       #   # #
# # ### # # # ##### # ##### ######### #
# #     # # #     # #   #     #     # #
# ####### # ####### ### # ##### ### # #
#   #   #   #     #     #   #   #   # #
# # # ##### # ### ######### # ### # # #
# # #       #   #   #       # # # # # #
### # ######### ### # ####### # # ### #
#   #   #       # # #   # #   # #     #
# # ##### ####### # ### # # ### #######
# # #     #       #   #   # #     #   #
# ### ##### ### ### ### # # ### # # # #
#     #   # # #         # # #   # # # #
####### ### # ########### # # ### # # #
#           #             #   #     # #
#######################################
