#######################################
#   #         # #           #       # #
# # # ### ### # # # ####### # # ### # #
# #     # #   # # #       # # # #   # #
# ####### # ### # ####### # ### # ### #
# #   #   # #   #   # #   #     # #   #
# ### # ### # # ### # # ######### ### #
#     #   # # #       # #   #     #   #
##### ### # ######### # # ### ##### ###
#       # #   #     # # #   # # #     #
######### ### # ### ### ### # # # ### #
#         #   # # #     # #   #   # # #
# ######### ### # ### ### # ### ### # #
#   #     # #   #     #   # # #     # #
# # ##### # ### ##### # ### # # ##### #
# # #         # #   # # #   #   #   # #
# # # ####### # # # ### # ####### # # #
# # #       #   # #     # #       # # #
# # ####### # ### ####### # ####### # #
# #     # # # #   # #     #   #   #   #
# ##### # # ### ### # ####### # # ### #
#     #   #     #             # #     #
#######################################
