#######################################
#       #         #   #     #         #
### ### ### ### ### # # ####### # ### #
#   #       #   #   #   #     # #   # #
# ######### ##### ####### ### ##### # #
#     #     #     #       # #     # # #
# ### ##### # ########### # ##### # # #
# # #     # #       #   # #     #   # #
# # ##### ######### # ### # ### ##### #
#   #   #     #   #   #   #   #   # # #
### # # ##### # # ### ### ### # # # # #
#   # # #   #   #   # #   # # # #   # #
# ### # # # # ##### # # ### # # ##### #
# #   #   # #     #   #   # # # #     #
# ### ##### ############# # # # # #####
#     #   #       #       #   # # #   #
####### ######### ### # ####### # ### #
#   #           #   # # #       #     #
### # ######### ### ### ### ######### #
#   #       # #   #   # #   #         #
# ######### # # ##### # # ### #########
#             #         #             #
#######################################
