#######################################
#     #   #   #   #         #         #
# # ### # # # # # # ##### # ### ### # #
# #   # #   # # #     #   #   #   # # #
# ### # ##### # ####### ##### ##### ###
#   #       #     #     #   # #   #   #
### ########### ### ##### ### # # ### #
#   #     #   # #   #     #   # # #   #
# ### ### # # ### ### # # # ### # # # #
# #   #     #     #   # # # #   #   # #
# # ########### ####### # # ### ### ###
# #           # #   #   # #     # #   #
# ########### ### # # ########### ### #
# #         #     # #   #         #   #
# ### ### ######### # # # ##### ### ###
#   # # # #     #   # # # #   #   # # #
### # # ### ### # ##### # # # ### # # #
#     #   #   #   #     #   # #   # # #
# ####### ### ##### # ##### ### # # # #
# #       #   #     # #     #   # # # #
# # ####### ### ##### # ##### ##### # #
# #         #       #       #         #
#######################################
