#######################################
#         #         #         #       #
# ### ### # ######### ##### ### # ### #
#   #   #   #   #     #   # #   #   # #
### ### ##### # # ##### # # # ##### ###
# #   #     # #   #     # #       #   #
# ### ##### # ######### ############# #
#   #     #   #       #     #     #   #
# # ##### ##### ##### ##### ##### # ###
# #   #   #   # #   # #   #     # #   #
### # # ### # # ### # # # ##### # # # #
#   # # #   #   #   # # #       # # # #
# ##### # ####### ### # ####### # ### #
#     # # #       #   #     # # #   # #
# ### # # ### ### # ####### # # ### # #
# #   #   #   #   #     #   # # #   # #
# # # ##### ########### # # # ### ### #
# # #   #   #         #   #   # #   # #
# # ##### # # ##### # ####### # ### # #
# #     # #   #     #   #   #   #   # #
# ##### # ##### ######### # ### # ### #
#     #       #           #     #     #
#######################################
