#######################################
# #           #     #         #   # # #
# # ####### # # ### # ### # ### # # # #
#   #       #   #   # #   # #   #   # #
# ### ########### ##### ##### ####### #
# # # #                 #     # #     #
# # # ####### ######### # ##### # # # #
#   #   #   # #   #     #   # #   # # #
### ### # # ### # ######### # # ### # #
# #   #   # #   #           #     # # #
# ### ##### # ##################### # #
#   #     # # #   #             #   # #
# # ##### # # # # ##### ####### # #####
# #   # # #   # #     #     #   #     #
# # # # # ##### ##### ##### # ####### #
# # #   #   #     # #       # #       #
# # ####### ##### # ######### ### ### #
# #       #     # #   #       #   #   #
# ##### ####### # # # # ####### ### ###
# #   # #   #   # # #   #     # # # # #
# # # # # # # ### # ##### ### # # # # #
#   # #   #       #       #     #     #
#######################################
