###############################################################################
#   # # #               #   #             # #                   #     # #   # #
# # # # ########### ####### ##### ####### # ######### ### ##### ### ### ### # #
# # #         # #   #   #   # #   #   #     #         #   # #   # # # # #   # #
### ######### # ### # ##### # # # ### ##### ### ##### ##### ### # # # # # ### #
# #                 # #     # # # #             #     #   #     #     #     # #
# ################# # ##### # ##### ##### # ##### ### # # ##### # ####### ### #
#     #   #   #   #   # # # #       #     # #     # # # # # #     # # # #     #
##### ### ### ### # # # # # ####### ##### # ####### # ### # ### # # # # # # ###
#               #   #               #     # #       # #   #   # #         #   #
####### # ##### ##################### ##### ####### ##### ### ### # # # # # # #
#       # #     #           #         #   # #           #         # # # # # # #
# ####### # # # ### # # ### ### ######### ##### ####### ##### # # # ### # ### #
# #   #   # # #     # # #       #     #     #   #             # # # #   # #   #
### # ######################### ### # ##### ############### # ##### ### ### # #
#   #                         # #   #                       #   #     #   # # #
##### # ### ######### ##### # ############# ########### # ### ### ### # ### # #
#   # # #   #         #     # # # #         # #         # #   #     # # #   # #
### ##### # ### ##### # ### # # # ######### # ############# # # # ### # ### ###
# #       # #   #     # #   #               #       # #     # # #   # #   #   #
# ##### # # # # ########### ####### ####### ### ### # # # # # # ##### ####### #
#       # # # # #           #       #       #     #     # # # # #       #     #
###############################################################################
