###############################################################################
#             # # # #         #   # #   #     #   #                   # #   # #
########### ### # # # ########### # # ##### ### ### ################### # ### #
# #         # #   # # # # #         # # # #                   # #   # # #     #
# ######### # ### # # # # # ######### # # # ########### ####### # ### # # #####
# # #   #   #       #         # #   # #             # # # #   #     #     #   #
# # # ##### # ##### # ### ##### # ### # ### # ####### ### # ##### ### ### ### #
#       #     # # # #   #   #   # #     # # # #   #   #     # #   #   # #     #
####### ####### # # # ####### ### # ##### ##### ### ### ##### # ### ### ##### #
# #       #         #         # #   #   # # #     #   # #         # # # # #   #
# ####### ####### ### ######### # ### ### # # ### # ### # ######### # # # #####
# # #       #   # # #   #   #   # #     #       # #             #             #
# # ##### ##### # # # ### ##### # # ##### ######### ############# ### ##### # #
#   # # # #       # #   # #   # #   # #                       #     #     # # #
# ### # # ####### # # ### # ### # ### # ####################### ### # #########
#   #     #   #         # # # #     # # #           #   #       # # #         #
# ####### ### ### ##### # # # # ##### # # ### ######### ### ##### ##### #######
#   # #   #   # # # # #     #       #       #                   #   # #       #
### # ### ### # # # # ####### ####### ############# ######### ### ### # # # ###
#     # # # # #       # #       # #     #     #   #         #         # # #   #
##### # # # # # ####### # # # ### # ##### ##### ######### ############# #######
#                         # #                         #               #       #
###############################################################################
