###############################################################################
#       #     #         # # #   # #   #       #         #             #     # #
####### # # # # ### ### # # # # # ### ####### # ##### ####### ######### ##### #
# # # #   # # #   # #         #               #   # # #   #     # # # # #     #
# # # ####### ### ########################### ### # ### ### ##### # # # # #####
#     #       # # #       #     #             # # # # # # #   #     #   #   # #
##### ##### # # # ### ### ##### ############# # # # # # # # ### ##### ### ### #
#     #     #     # # #     #     #       #   # # # # # #   # # #           # #
##### ############# ####### # ######### ##### # # # # # # ### # # ########### #
#       #   # # #   # #         # # #   # # #   #                       #     #
### ### ### # # ### # ##### ### # # ### # # ### # ######### ############# ### #
# # #   #     #         # # #       #           #         # #     #     #   # #
# ##### # ### # ##### # # ##### ### ########### # ########### # ### ### # #####
# #   #   # #   #     #         # #     #         #   #       #     # #   #   #
# ### ##### ### ### # ##### ##### ##### # ##### ### ### ##### ####### # ### ###
#         #     # # # #     #         #   #   #           # #         #       #
######### ##### # ######### ##### ### # ##### # ##### ##### ###################
# # #           # #       # # #   #       #         # #   #   #         # # # #
# # ####### ### # ####### ### ####### # # ##### # # # # ### # # ##### ### # # #
# #         #   #         # # #       # # #     # # #       #       #       # #
# ### ### # # ### ### ### # # ##### # # ##### ### # # # # # ### ####### ##### #
#     #   # # #     # #             # # #       # # # # # #   #       #       #
###############################################################################
