###############################################################################
#           # #             # # # #                                   #       #
##### # # # # ##### # ##### # # # ### ######### ##### ######### ### ### ### # #
#   # # # #         # #       #     # #         #     #         # #   # # # # #
### ######### # ##### ####### ##### ##################### # # ### ### # # #####
#   #     #   # #     #                   # # #   #       # # #   #   #       #
### ##### ####### ######### ####### # ### # # ### # # # # ####### ### # ### # #
#                   # # #   #       # #           # # # # #             # # # #
######### ### ####### # ### ### ### ############# ### ############# # # # ### #
# #       #   #           # # # #   #                   #           # #     # #
# ### ### # ############# ### ######### ######### ### # ##### ### # ### ### # #
#     #   # #         #   # #     # #   #         # # # #     #   # #   # # # #
### # ### ### # ### # ### # ##### # ####### ####### ########### # # ### # # ###
#   # #   #   # #   #           #         # # #         # #     # # #     #   #
# ####### ####### # ######### # ######### ### # # ##### # ##### ####### # # # #
# #       #       # #         #               # # #       #           # # # # #
##### ####### ### ########### ### # ######### ########### # # # # # ### # # ###
# #   #     # #   #     #     #   #   #       # #           # # # # #   # #   #
# ######### ########### ########### # ####### # ####### # ### # # # ##### #####
# #       #             #     # # # #   #     #         # #   # # # #         #
# ### # # ####### ##### ##### # # ######### # # ##### ### ##### # # # # # # ###
#     # #         #                         #   #     #   #     # # # # # #   #
###############################################################################
