###############################################################################
#   #   #                 #     #     # #       # # #             # #     #   #
# # ### # ####### ### # # ### ####### # ### ##### # # ### # ### ### # ##### ###
# #       #   #   #   # # #     # # # # #   #     # #   # #   #   #     # # # #
# ########### ########### ### ### # # # ### # ##### # ##### ####### # ### # # #
# #                         # #   # # # #     # # #     # # # # # # # # #   # #
############### ########### # ### # # # ##### # # # ##### ### # # # ### # ### #
# #     #   #   #   # # #   # #   #   # # #   # # #   # # #       #         # #
# ##### ### ####### # # ### # ### # ### # # ### # # ### # # ####### ######### #
#   # #   # #   # # # #         #   # # #   # # # # # #             # # #   # #
### # ### # ### # # # ### ### ### ### # ### # # # # # # ############# # # ### #
#           # #     # # # #     # # # # # # # # # # #   #   # #   #           #
##### ##### # ### # # # ##### ### # # # # # # # # # # ### ### # ### # ### #####
# #   # #     #   #   #         #   #     # #                 #   # # # #   # #
# ##### ##### ####### # ##### ##### ### ### # # ##### # ####### ### ### ##### #
# #             #       #               #     #     # #         #   # # #     #
# ####### ##### ### # ############# ### # ### ### # # ##### # ### ### # # # ###
#         #         # #       #     #       #   # # # #   # #           # # # #
# ##### ### ############# ### ######### # ############# ####### ### ##### ### #
#   # # #   #     #     # # #   #       #   #       #         #   #     #     #
##### ##### ##### # ### ### ### ### # ### # # ##### # # # # ####### # ### ### #
#           #       #               # #   #       #   # # #       # #       # #
###############################################################################
