###############################################################################
#                             #             #   #     # # #   # #   # # #     #
############# ######### ##### ##### ### ### # ####### # # # ### # ### # ##### #
# #   #       #         #           # # # # # # # # #   #     #     #   #   # #
# ### ####### ### # ##### ########### ### # # # # # ### # ####### ### ### ### #
#             #   # # #     #       # #   # # # # # # # #     #   # #       # #
################# # # ### ######### # ### # # # # # # # # # ##### # # ### ### #
#     #     #   # # # #   #                 #   #     # # # # #   #     #   # #
##### ##### ### ##### ##################### # ####### # # ### ### ### ####### #
#       #       # #                   #         # #   #   # # #   # #     # # #
# ##### ####### # ######### ####### # ####### ### ### # ### # # ### # ##### # #
# #         # # #           #       #                         #   # # # # # # #
# ######### # # ##### ############### # ########### ########### ### # # # # # #
# #   # # # #     #   #   #           # #       #     # # #   #   # #         #
##### # # # ### # # ### ### ################### ##### # # ### # ### # #########
# #       # #   #   #       #             #       #   #   # # #   #     # #   #
# # ##### # ########### ######### # ### # # ##### ### # ### # # ### ### # # ###
#   #         # # # # #   #     # # #   #     # #       # #   #   # # # #   # #
########### # # # # # ####### # ############### ##### # # ### # ### # ### ### #
#         # # #   #           #       # #       # #   #           #           #
######### ### ### ### ####### # # ### # # ### # # ##### # ##### # ### # # # ###
#                     #       # # #         # #         #     # #     # # #   #
###############################################################################
