###############################################################################
# #     #       #   #               # # #   # #   #   #     #   #   #       # #
# ##### ####### # # ############### # # # ### # ##### ### ### ##### # ####### #
# #   #         # #     #             # #   #   #   # # #                 # # #
# ### ######### ####### ##### ##### ### # ##### # ### # # ######### ####### # #
# #   # #       #         # # #   # # #   # #       # # # #   #   #       #   #
# # ### ####### ######### # ##### # # # ### ### ##### # # # # # ############# #
#               #   #   #   #     # #           # # #       #   #             #
### # ##### ### # ##### # ####### # ### ######### # ### ########### ##### #####
#   # #     #   # #         #   #   # #   # # #   #   #           #   # #   # #
# # ########### # ### ##### ### ### # # ### # # # # ##### ######### ### ##### #
# #   #               #   #         # # # # # # #     # #     # #   # #   #   #
# # ####### ### ####### # ######### # # # # # # ####### # ##### ### # # ##### #
# # #   #   #   # #     #                       #   #               #       # #
# # ### ######### ####### ### ########### ####### ### ### ### ##### # ####### #
# # #             #   # # # # #                         #   #   #             #
# # # ### ####### ### # ### ##### ####### ####### # ####### ### ### # # #######
# # # #   # # #         # # #   # #         #   # #       #   #   # # #     # #
####### # # # ##### # ### # ### # # ##### # # ########### ######### # ### # # #
# #     # # # #     #             # #     #             #   #   # # # #   #   #
# ######### # # ### ##### ##### # ##### ### ####### # ####### ### ### ### ### #
#                 # #     #     # #     #       #   #               #   # #   #
###############################################################################
