###############################################################################
#           # #     #     # #             #           #                       #
##### # # ### # ### # ##### # ############# ### ####### ########### ###########
#   # # #     # #   #     #           #   # # # #     # #   #   # #           #
# ##### ##### ##### # ##### # # # # ### ### # ### ##### # ### ### ### # ##### #
#     # # # # #   # #   # # # # # # #   # #       # #   #           # #     # #
### ##### # # # ### # ### # # ######### # # # # ### ### # ####### ##### ### # #
# #   #     #     # # #     # # # # #       # #           # #   #     #   # # #
# ### # ### ### ### # # ####### # # ### ##### # # ####### # # ##### # # # # # #
# # # # # # # # #             # # #     #   # # #       #       # # # # # # # #
# # # ### # # # ### ### ####### # ### ### ####### # ##### ##### # ########### #
# #   # # #   # # # # #     #   #   #   # # #   # #     #   #         #     # #
# ### # # ### # # # # ####### ##### # ### # # ########### # # # ####### ### ###
#                     # # #   # # #       # #           # # # #           # # #
# # ############# # # # # # ### # # ####### # # ######### # ### ######### ### #
# # #       #     # #   # #   # # # #         # #   #   # #   #         # #   #
########### ##### ####### # ### # # # ############# # ####### # # # ### ### ###
#     #                 # #   #   #                         # # # #   #       #
### # ######### # ####### # ### ### ##### ####### # # ######### # # ###########
# # #         # #                   #   #       # # #         # # #           #
# ########### # ### ##### ### # # ### # # # ########### ### # ##### ### ##### #
#                 #     # #   # #     # # #           #   # #     #   #     # #
###############################################################################
