###############################################################################
# #   # #         #     #           #           # # #         #   #           #
# # # # ### ####### ####### ######### ### ### ### # # ######### ### ##### ### #
# # # #   # # # # # #   #     #       # # #   #               #       # # # # #
# ### ### # # # # # # ##### ### ##### # ####### ############### ####### ### ###
#     #   #             #           #   # # #               # #     # # # # # #
# ##### ### # ########### ############### # ### ### ######### # ##### # # # # #
#           #                         #           #       #     #     #     # #
# # ##### ##### # ####### # ### # ##### # ### ############# ##### ##### ##### #
# #     #   # # #       # #   # #       #   # #           # #     # # #       #
# ######### # # ### ### ####### # ######### ### ##### ##### # # ### # # #######
#         # # #   # # #       # #         # #       #         # #   #   # # # #
# ##### ##### ####### ##### # ### # ######### ####### ############# # ### # # #
#     #                 # # #   # #   #           # #             #   #       #
# # ### ##### ########### ### # # # # # ### ####### ### # ######### ### #######
# #   #   # # # #         # # # # # #     #         # # #     # # #           #
# ##### ### ### # ### ##### ########### # # # ##### # ######### # # ####### # #
# #               # #     #     #     # # # #     #                       # # #
# # ### ### # # ### ####### ####### ### # # ### ### ##### # ### ###############
# # #   # # # #     # #         #     # # # #     #   #   #   # #     #       #
# ####### # # ### ### # # ### ### ### # ##### # # ### # ######### # ### # #####
#     #     #   #       # #         # #     # # #   # #           #     #     #
###############################################################################
