###############################################################################
# # #             # # #     #     # #   #   #         # # # # # # # # #       #
# # ####### ##### # # ##### ##### # # ##### ##### ### # # # # # # # # # #######
#   #   #   #         # #     #   #   # #     #   # # # # #       # #   #   # #
### ### ############# # ##### ### # ### ##### ##### # # # ##### ### ### # ### #
# # # #         # # # #   # #     #       # # #       # # # #   # # #     # # #
# # # ######### # # # ### # ##### ####### # # ##### # # # # # ### # # ### # # #
# # #   # #   # # #   # # #     #   # # # #   #   # # # # #   #     # # # # # #
# # # ### ### # # ### # # ##### ### # # # # ##### ### # # # ### ##### # ### # #
#     # # #   #         # # #   #   #   # # #   #         #     #   #         #
##### # # ### ######### # # ### ### ### # # # ####### ### # ##### ### ### #####
#   # #   # #       #   #     #               # #   # #       #   # # # #     #
### # ### # ####### ### ### # ############### # ### ####### ### ### # # ### ###
#     #   #     #       #   #     # # #           #                   #   #   #
### # # # ### ##### ### ######### # # ### ####### ######### ####### ### ### ###
# # #   #   # #   # #   #       # # #     #     # #       # #     # #     #   #
# ######### # ### ##### ####### # # ### ####### # ####### # # ####### ####### #
#               #         #   #     # # #   #       #                       # #
### ##### ##### ######### # ### # # # ##### ##### ##### ### ####### ###########
#   #     #               # #   # # # # #     #         #       #         #   #
### ### ### ### ##### ### # ####### # # ##### # ####### # # ##### # ####### ###
#   #   #     # #     #                         #       # #     # #           #
###############################################################################
