###############################################################################
#             #     #   # #   # #   # # # # #   #                         #   #
# ### ### ### # ##### ### ### # # ### # # # # ### ### ##### # # ########### ###
# #   # # # #     # # #   #     # # # #   # #   # # #   # # # # #   #         #
####### ### # # ### # ### ### ### # # ### # ### # # ##### ####### ### ##### # #
#     #       #   # # # # # # # #     #       #   #       #     #       #   # #
##### ####### ##### # # # # # # # ##### ######### # ####### ##### ### ### #####
#             # # # # # # #         # #     # #                     #   #     #
############# # # # # # # ##### ##### # ##### ### ############### # ####### # #
#       #   #     # # # # # #     #     #                       # #     # # # #
# ##### ### ##### # # # # # # ### # ### # # ### ############# # # # ##### # # #
# # #       #   # # # # # #   # # #   #   #   #             # # # #   # #   # #
### ####### ### # # # # # # ### ### ##### # ##### ########### # ### ### ##### #
#               #     # #               # #     # #         # #   #   #     # #
### ### ####### # ##### # ####### ######### ### ### # ### ### ######### #######
# # # # #   # #             #   #     #   # #       #   #   #                 #
# ### ##### # ### # ##### ### ### # ### ##### ##### ####### # ############### #
#               # # #   #   # # # #   #     #     #     # # #               # #
############### ### # ####### # ####### # # # # ### ### # ##### # ####### # ###
# # # #   #       #             # #     # # # #   #   #       # #   #   # # # #
# # # # # ####### # ##### ####### # ### ######### # # ### ##### # ### ####### #
#       #               #             #         # # #   #     # #             #
###############################################################################
