###############################################################################
#   # # #     # # # #       # #     # #       # #         #         # # #     #
# ### # # # # # # # ####### # ##### # # ### ### ### # # # # ######### # # #####
# #     # # # # #   # # #   #   # # #     #         # # #         #       # # #
# # ######### # ### # # ### ### # # ### ##### ##### # # ### ### # # ####### # #
#   # # # #     #         # #               #     # # #   #   # #   #     #   #
### # # # ##### ######### # ##### ####### # ####### ##### # ######### ##### ###
#           #     # # #           #   # # #     #       # #             # #   #
# ######### # ### # # ### ####### # ### ############# # # # ### ##### ### # ###
# #             # #     #   #             #       #   # # #   #     #       # #
# # ##### ####### ##### ### ### # ##### ### ################### # ### # # ### #
# #   #   #       #         #   #     #           #       #     #   # # #     #
# ### ####### # ### ### # ### # ### # ### ######### ### ##### # # ##### # # # #
# #   #       #     # # # # # # #   #   #             # #     # #     # # # # #
########### ##### ### # ### ### ### ##### ##### # # # ##### ### ### ### # # # #
#         # #       #       #   #       # #     # # #   #     # #     # # # # #
######### ### # # ##### # ##### # # # ### ### # # ##### # ### # ######### ### #
#   # #       # # #     # # #   # # #   #   # # #     # #   # #       #   #   #
### # ### # # ##### ### ### # # ##### # # ##### # ######### ### # # ######### #
#         # # #     #     #   # #   # # #     # # # #     #   # # #   #       #
######### ### ######### ####### # ##### ### # # # # # ############### ####### #
#         #   #           #           #   # # # #                 #   #       #
###############################################################################
