###############################################################################
# #   #     #   #   # #   # #     # #   # #   #     #       # #             # #
# # # ##### ### ### # ### # ##### # # # # ### ##### ####### # # ######### ### #
#   #       # #       # #       # #   #     #       # #     #     # # #       #
########### # ####### # ####### # ##### ### ####### # ##### ##### # # # #######
#   #               #       #   # # #   #     # # #       # #   #   # # #     #
# ######### # ##### # ##### ### # # ######### # # ####### # # ### # # ### #####
# #   # #   # #       #           # # #         #     #     # #   # #       # #
# ### # ########### # # # ##### ### # ######### ##### ##### # # ####### ##### #
#                   # # # # #     # #     # # # # #         # # # # # # #   # #
### # ### ##### ### ####### ##### # ##### # # # # ######### # # # # # # # ### #
#   # #   #   # #   # #     #     # # #   # #     # # # #     #   # #       # #
##### # ##### ####### ##### ### # # # ### # ##### # # # ##### ### # # ####### #
#     # #             #   #     # #         #   #     # #     # #   #     #   #
# ####### ########### ### ##### # ######### ### ### ### ##### # # ### # ### ###
#   #     #         #   #       # #   # #     #   # #     # # #       #       #
### ##### # ### ### ### ######### ### # ##### ### # ### # # # # # ######### ###
#   #   # # #   #     # #       # # #             # #   #       #   #     #   #
### ### ######### # # # ####### # # # ########### # ##### # ### # ### # ### # #
#   #             # #         #       #   #               #   # #   # #   # # #
# ########### ######### ##### ####### # ######### ### # # # # ### # # # # ### #
# #           #         #             #           #   # # # # #   #   # # #   #
###############################################################################
