###############################################################################
#   # # #   # # # #       #   #   #     # #   #   #     # # # # # # # # # #   #
# ### # ### # # # # # ### ### # # ##### # ### ### ##### # # # # # # # # # ### #
# #     #   # #     # #       # # # # #   # # # # #               # # #     # #
# # ##### ### ######### # ### ### # # ### # # # # ######### ##### # # # ##### #
# # # # # # # #       # # #   #     #       #   #   # # #   #   #     #   #   #
# # # # # # # ####### ####### # ### ####### # ##### # # # ##### ### ### ### ###
# # # # #   # #         # #   # #   #           # #       #     #   # # #     #
# # # # # ### # ####### # ### ##### ########### # ############# ### # # # #####
#     # # # #   #       # #     #               # #           # # # #   # #   #
# ### # # # ########### # ### ############# # ### ######### # # # # ### # # ###
# #   # # # # #         # # # # # #       # #   #   #     # # #     #         #
##### # # # # ######### # # # # # ####### ##### ### ##### ### ##### ### #######
#       #   #   # #   #   # #   #     # #         # #     #         # #       #
# ### # ### ### # ### ### # # # # ##### ######### # ### ### ####### # # #######
# #   # #     # #   #       # # #   #       #     #       # #                 #
####### # # # # ### ####### ### # ### ### ####### ### ### ######### # # ##### #
#     # # # # #       # #           # #   #         # #   # #       # #   # # #
# # # # ##### ####### # ####### ### ##### ######### ##### # ### # ### # # # ###
# # #       #   #   #           # # # #         #   #     #     # #   # #     #
# ##### ### ### ### ##### # ##### # # ### # # ##### ##### ##### # ### # ##### #
# #     #                 # #             # #                   #   # # #     #
###############################################################################
