###############################################################################
#       #         #       #         #       #   #   #   # # #   # #   # # # # #
##### # ##### ########### ####### # # ##### # ### ### ### # # ### # # # # # # #
#     #           # #           # # # # # # # #   # #   #   # #   # # #   #   #
##### ### ####### # ##### ##### ### ### # # # ### # # ### ### # ### ##### # ###
#     #   #     # # # #   #   # # # # # #   #   # # #       #   # # #   # #   #
# ### # # ### # # # # ### ### # # # # # ### # ### # # ####### ### # ### # ### #
#   # # # #   # #         # #     #   #   # #   #           #   # # #         #
# ### ### ##### ### # # # # # ### # # ### # # ### ######### # ### # # ####### #
#   #   # #         # # # #   #   # #   #   # # # # # #   #   # # # #   #     #
# ####### # ### ### ### ### ##### ##### ### # # # # # # ####### # # # ##### # #
#     #   # # # # # #   #   #     # # # # #     #   # # #   #           # # # #
# ########### ### ### ####### ### # # # # ### ##### # # ### # ########### ### #
#   #   # #           #   # # #   #   # # # # # #   # # # # # #   # #   #     #
# ##### # # # ### ### ### # ##### ### # # # # # ### # # # # # # ### # ####### #
# #         # #   # # # #             # # #           #               #     # #
################# # ### ############# # # ### ######### ############### #######
#   #             #     #   #   #             #   #                         # #
### ##### ### ##### ### ### ### ######### ####### ### ################# # ### #
#     # # #   # # # #   # # # # # #       #     #                 #     #   # #
# ### # ####### # ##### # # # # # # ##### # ##### # ##### ############# # ### #
# #                                 #             #     #             # #     #
###############################################################################
