###############################################################################
#         #     #             #       # #     # # #   # #   #     #   # #     #
### ### ####### # ########### # ### # # ##### # # # ### ### ##### # ### # #####
# # #     #       #             #   #         #   #   # # #   #               #
# ####### # # # ####### # ### ### ######### ##### ### # # # ### # # ### ### ###
#   # #     # # #       # #   #   # #           #               # #   #   #   #
### # ##### ##### ##### # ######### ######### ##### ################# # ##### #
#           #   #   #   # #   #   #     #   # #     #   # # #   #   # #   #   #
####### # ##### # ########### # ####### ### # ### ##### # # # ### # # ### #####
# #     # #       #       #                   #   #           # # # #   # #   #
# ####### # ##### ####### ############### ### ### # ####### ### # ####### # ###
#         # #     # #     #   #   # # #   #             # #             #     #
# # ##### ####### # ### # ### ### # # ######### # # ##### ########### ### # ###
# # #     #   #   #     #               # #     # #       #         #   # #   #
# # ######### ####### ### # # ######### # # # ### # ####### ###################
# # # #         # #   #   # # #             # #   #             #     # #   # #
### # ######### # ############# ##### ### ### ##### # # # # ##### ##### # ### #
#   #     # #                   #     #   #   # #   # # # #         # #   #   #
# ####### # # ### ############### # ####### ### ### # # ### ######### # ### # #
# #           #   # #   #   #   # #   # #   # #     # #   # # #             # #
# ### # # ##### ### ### ### ### ### # # ##### ### # ######### # ### # ##### # #
#   # # # #       #                 # #           #               # #     # # #
###############################################################################
