###############################################################################
#     #   #     # # # #   # #   #   # # # #       #     #             #       #
# ####### ### ### # # ### # # ### ### # # # ##### # # ### ### ######### ### # #
# # #       #     # #       #           #   #   # # #       # # #         # # #
# # ### # # # ##### # ####### # # # ##### ### # ##### ##### # # # #############
#     # # # # #   #           # # #           #   # # #     #       #   #     #
### # ##### # # ### ####### ### ################### # # ############# ### #####
# # #             #   # # #   # #   #   #     #   # # # # #             # # # #
# ########### ##### ### # ####### ### ### ##### ### # ### # ### ##### ### # # #
# #   #       # # # # #   #       # # # # # # # #     #   #   #     #       # #
# ### ####### # # # # # ### ####### # # # # # # ### ### ##### ############### #
#   #   #   # # #           #   #       #       #     # #         #           #
# ### ##### # # # ########### ### ####### ####### ##### # ### # ##### ##### ###
#   # # #   # #       #   #     # #   # #     #       #     # #     #     #   #
### # # ### # # # ##### ### ##### # ### # # ### ####### ##### ##### # # # #####
#   # #         #   # # # #         #     #                 #   # #   # # # # #
# ### ##### # ####### # # # ######### ####### ################### # # ##### # #
#           #         #         #   #       #               #     # #   #   # #
# ##### ##### ######### ##### # # # # # ### ################# ########### # # #
# #     #                   # #   #   # # #                       #       #   #
# ####### # ### ################### ##### ### ### ### ####### ##### ###########
#   #     #   #                   #         #   #   #     #                   #
###############################################################################
