###############################################################################
#     #               #                 #       #   #     #               # # #
##### ### ### ### ### ######### ######### # ##### ### ########### ### ##### # #
# #       #   #   # # # # #       # # #   # #     #   #     #   #   #   #     #
# ########### ##### # # # ##### ### # # ######### # ### ##### ### # ### # #####
# #   #       # # #   #       # # #       # # # # #     #       # # # # # # # #
# ### ######### # # # ####### # # ### ##### # # # # ####### ##### ### # # # # #
#   # #           # #     #   #   # #   # # #   # #     #   #       # # #   # #
### # ### ####### ####### # # # ### ### # # ### # # ##### ### ####### ##### # #
# # # #   #                 #       #   #   # #     #   #             # #     #
# # # ##### ####### ####### # ### ##### # ### # ### # ### ############# # ### #
#           #       #       # #   # #   # # #     #               #   #     # #
################# ####### ####### # ### # # ### # ##### ######### # ### # #####
# #   #           #       #   #   #   #   # # # #     #   # #   # #     #     #
# # ############# # ##### ### ### ### # ### # # ########### # ####### #########
#   #     #       # #     #   # #   # #   #                     # # #       # #
### ##### # # ### ########### # ### # # ### ######### ########### # # ####### #
#       #   # # # # # # # #     #                   #         # # # #     #   #
####### ####### ### # # # ##### # # # # ##### ##### ########### # # # ### # ###
# # # #               #     #     # # #   # # #   # #         # #       #     #
# # # ##### ######### ##### ##### ### # ### ### ##### ######### # ### #########
#             #                   #   #                             #         #
###############################################################################
