###############################################################################
#     # #               # #     # # # # # # #   #     #                   #   #
# ### # # ########### ### # ##### # # # # # # ### ##### ########### ### ### ###
# #   #         #     #           #         #   # # # #           # # #     # #
##### # ############### ##### ##### ######### ### # # # ############# ####### #
#     #   # #   # #       # #                       #   #       #   #     #   #
##### # ### # ### # ####### # ##### ################# # # ### ##### # ##### # #
#               #         #     # #   # # #         # #   # #         #     # #
### # # # # # # # ### ### ####### ##### # # # # ### # # # # ####### ### ##### #
#   # # # # # #     #   # #     #         # # #   #   # #         #         # #
### # ### # # # ######### # ##### ######### ##### ############# # ### # ##### #
#   #   # # # #       #     #                   #       #   #   #   # #     # #
### # # # # ##### # # ### ### ##### # ####### ### # ### # ######### # # ##### #
#   # # # #     # # #   #         # #       #   # #   #   #     #   # #   # # #
### # ### ### # ### ##### # # ### # ### ######### ### # ### ########### # # ###
#   #   #   # # # #     # # #   # #   #         #   # #     # # # # # # # #   #
# # # ### # # ### # ####### # # # ### # ### # ######### # ### # # # # ##### ###
# # #   # # #     #   #   # # # #   # #   # # #   #   # #   #   # #           #
# # ### ####### ### ### ##### ### ##### # # ### # # ### ##### ### # ####### # #
# #   #       #   #         # #       # # #     #   # #         #     # #   # #
# ##### # ####### ### # # ####### ####### # ######### # ######### ### # ##### #
#     # #     #     # # #       #       # #           #             #       # #
###############################################################################
