###############################################################################
#   #     #           # # #                     # # #         #         #   # #
### ##### ####### ### # # # ############### ### # # # ### # # ####### # # ### #
#     #   #       #         # #   #         #     # # # # # #         #       #
##### ### ### ####### # ### # ### ############### # ### # ########### # ##### #
#           #   #     # # # #     #             #   #   # #           #     # #
# ### ### # ####### ##### ####### ### ######### ### ### ########### # # # ### #
# #   #   #         #     # #   #   # #   #                     #   # # #   # #
### # # ######### # ##### # ### ### # ### ##### # ### # # # # # ### # # ### # #
#   # # # # #     # #               # #   #     #   # # # # # #     # #   # # #
# # ##### # # ########### # ### ### ##### ####### ### ### ### ### # ### # #####
# # #         #           # #   #                 #     # #     # #   # #   # #
# # ##### # ### # ##### ######### ##### # ##### # # ######### ####### # # ### #
# # #     # #   # #   # # #   #   #     # #     # # #               # # #     #
### ### ### ##### ### ### ### ######### ##### ############### ### ### # # # ###
#     # #   #     #   #     # #     # # # #   # #   #   #     #   #   # # #   #
##################### ##### # ##### # ### ##### ### ### ##### ##### # # # ### #
# #           # #   # #     #   #           #   #     #       #     # # #   # #
# # ######### # # ### ##### ### ########### ### ##### ### ##### # # ######### #
#   #             # #                     #     #         #     # #         # #
##### ########### # ##### ############### ##### # ######### ##### ### ####### #
#       #                 #                       #             # #     #     #
###############################################################################
