###############################################################################
#   #       #         #       #       #                   #       #           #
# # ####### ######### ####### ### # ##### ### ##### ### # ### # ### ##### ### #
# # #   #   #   # #           #   #       #   #     #   #     #       # #   # #
### ### ### ### # ########### ####### ### ### ##### ####### # # # # # # ##### #
#   # # #   #                         #   #     #   #       # # # # #       # #
### # # # # ################### ####### # # # # # # ### ### ### # # ##### # ###
#   #     #                     #       # # # # # # #   #   #   # #     # #   #
# # ######### ### ##### # # # ##### ### ##### # ##### ### ##### # ### ####### #
# #   #       #   #     # # #   #   #       # # # #   #   #     #   #       # #
##### ############# # # ##### # ##### ######### # ######### ### ### ### ##### #
#                 # # # #     # #     #       # #             #   # #       # #
# # # ### ### ### # ### # ### ############### # ### ### # # # ### # ### ##### #
# # # #   #   #     #   # #   #                 #   #   # # # #   #   # # # # #
### # ### # # # # ##### ### ############# ########### # # ### ### # ### # # ###
# # # #   # # # #   #   #   # #           #       #   # # #     # #   #       #
# ### ##### # # # # ### # ### ############# ##### ####### ### # ### # ### # # #
#     #     # # # # #   # #         #       #     # #     #   # #   #   # # # #
### # ### ##### ### ##### # ### # # ####### # ### # ######### ##### ### # ### #
#   #   #   #   # # #     # #   # #         # #               # # # #   #   # #
##### ########### # ### ####### ##### ##### ### ############# # # ### # # ### #
#     #             #     #     #     #     #   #                   # # #   # #
###############################################################################
