###############################################################################
# #                   #       #       # # #         # # #     #           # # #
# ########### ##### # # ##### # ### ### # ######### # # ##### # ####### ### # #
#             #     #   #       # #     #     #   #             #           # #
######### # ################# ### ##### ### ##### ### # ### ######### # ##### #
#   # #   # # #                 # # #   #     #       # #     #   #   #   # # #
### # # ##### ### # # ### # ##### # # # ##### # ### # # ### # ### ### ### # # #
#   #   # #       # # #   # #         #     #   #   # # #   # #   # # #     # #
### ##### # ### ##### # # # # ### ##### ### ##### # # ########### # ####### # #
#           #   #     # # # # #   #   # #         # # #           # # #   #   #
# ##### ##### # ### ##### ######### # # ##### # # ############### # # ### ### #
# #     #   # # #   #     #         #     #   # # #     # # # #       # #   # #
# ######### ######### ########### ### # # ### ### # ### # # # ##### # # ### # #
# #           #     # #     #   # # # # # #   # # # #               #     # # #
# # # # # ### ##### # # # # # ##### # # ####### ##### ### ##### ####### ### # #
# # # # # #           # # #           # #             #   #     #             #
# ### ### ####### # ##### # ####### # ############### ### # # ##### # # # # # #
# #   #   #       # # #   # #   #   # #               # # # # #     # # # # # #
# ##### ### ### ### # ##### # ### # # ####### ##### ### ### ### ######### # # #
# #     #   # # #   #     #   #   # # # #     #     #       #   #         # # #
# ##### # # # ### ##### # # ### ####### ########### ##### # # ############# ###
# #     # # #     #     #   #   #                   #     # # #               #
###############################################################################
