###############################################################################
#     # #     #   #   #       #   #   #   #     #   # #   #           #     # #
# ### # # # ##### ### # ####### ### # # ##### # ### # # ##### ##### ### ##### #
# # # #   #     #   #   # #   #   # # #     # #   #       #   # #     #     # #
### # ####### ##### # ### # ### ### ### ##### ########### ### # ##### ##### # #
# # #   #     #   # # #   # #   #   # # #     #   #   #         # # # # # #   #
# # ### ##### ### # # ### # # ### ### # # ##### ##### ### ####### # ### # # ###
#       #       #   # #   # # # # # #     #   # # # #   #                     #
####### ####### # ### # ### # # # # # ##### ### # # # ### ####### # ###########
#     # # #       #           #   #               #             # #         # #
# ### # # ####### # ########### ### ##### ######### # # ##### ### # ### ### # #
# #   # #       #   # #   #   #   #     # # #   #   # #     #   # # # # #     #
# ### # ### ### # ### # ### ### ### ####### # ##### # ### ### ####### ### # # #
#   #       #   # # #     # #     #   # #   #     # # # #   #         # # # # #
### # # ####### # # # ##### # # ### ### ### # ##### # # ############# # ##### #
#   # # #       #             # # #     #     #     #     #       # #       # #
##### # # ##### # ########### ### # ##### ####### ### ##### ####### ### # ### #
#     # # #             #               #           #           # #   # # #   #
######### ##### ##### ### # # ### ####### # ####### ##### ####### # # ##### ###
# #       #         #   # # #   #     #   #   #   #   #             # #   #   #
# ########### # ### ##### # # # ####### ### # # ####################### ##### #
#             #   #     # # # #           # #                               # #
###############################################################################
