###############################################################################
# #                 # # # # #   #           #     #   #     #             #   #
# ### ### ### ##### # # # # ### ######### # ### ##### # ### # ##### ### ### ###
#     # # #   #       #                   #   # #   #   # #     # #   #     # #
# ##### ############# ############### ####### # ### # ### # ##### ### # ##### #
# #                                   #     #     # # #       #     # # # # # #
# ######### # # # ############# # ### ##### ##### # ####### ### ######### # # #
# #       # # # # #       # #   # #   #                           #   # #     #
# # # ### ####### ### ### # ### ##### # ### # ### # ##### ### ##### ### # #####
# # # #           #   #           #   # #   # #   # #     #                   #
### # # ### # # # # ########### # ##### ##### # # ##### # # # # # ##### # #####
#   # # # # # # # # #           #   #   #     # # #     # # # # #     # #     #
# ####### ############### # # ### ##### # # ############# ### # # # # ####### #
# #               # #     # # #   #     # # # #     #       # # # # #       # #
# ############### # ####### # # ##### ####### ##### ##### # ### ####### #######
# #           #           # # #   # #   #                 # #         #   #   #
### # # # # # ######### # ### ##### # ######### ####### # # # # ########### # #
# # # # # # #           #   # # #     #         #       # # # #         # # # #
# ########### ##### # ##### ### # # ##### ##### # # ######### ### # # ### # # #
#       #     #   # # # #   #     # #   # #     # # #           # # #       # #
##### ### ##### # # ### ### # ### # ### ##### # ####### # ### # # ##### #######
#         #     #   #         #   # #         # #       #   # # #   #         #
###############################################################################
