###############################################################################
#       #       #   #   # # # #             # # #   #   # #   #           # # #
####### ####### # ##### # # # ######### # # # # ### ### # ### # ### ##### # # #
#   #       #   #     #   #     #       # #     # #   # #       #   #   #     #
### ####### # ##### ##### # ### ##### # # ### # # # ### ##### ####### ### #####
#               # #       # #   #     # # #   #   # # # # # #         # #     #
############### # ####### ##### ################# # # # # # # ######### #######
#         # #     #         #   # # # # #       # # # #     #           # # # #
# ####### # # ### ####### ##### # # # # ####### # # # # ##### # ### ##### # # #
# #   #       #     #     # #   # #   #         # # #   # #   #   #         # #
# # # ##### ####### ### ### ### # ### ##### ### # # # ### ##### # ####### # # #
# # #       #                 #   #     #   #     #         #   #   #   # # # #
# ############# ##### ####### # ##### ####### ### # # ####### # ##### ####### #
#   #       #   #   # # # #             #   # #   # #         #               #
# ##### # # ### ### ### # ### # ### # ### # ##### ### # ##### # # #############
# #     # #     #             #   # #     # #         #     # # #             #
##### ##### # # ####### ##### ######### # # ######### ##### ######### ### ### #
# #   # #   # # #       #     #         # #               # # #   #     #   # #
# ### # ### # ##### ### ##### ##### # ### ##### ##### # ##### # ### ### # #####
#     # #   # #     #     #   #   # # #   #     #     #   # # #   #   # # #   #
# ##### ### ##### ### ####### ### # # # # ### # ### # ##### # # ##### ####### #
# #         #     #   #       #     # # # #   # #   #               #         #
###############################################################################
