###############################################################################
#         # # # #   #   #     # #   #               #               #         #
# ##### ### # # # ### ### ### # # # ### ########### # ############# # ##### ###
# # # # #       # #   #     # #   # # # #         # #       # # # #       # # #
# # # ### ####### ### # ######### ### # # ####### ### ####### # # ### ### ### #
#               # #   #     # # #   #     # # # # #   # #       #   #   #     #
##### ########### ### # ##### # # ### ##### # # ### ### # ####### ### ### # # #
# #         # #       #       #                                     # # # # # #
# ### ####### # ####### ####### ######################### ####### # ### # # # #
#   # # #     #   #   # # #                             #       # # # # # # # #
### # # # ##### ##### # # # ### # ##### ####### # # ######### ####### # ##### #
#     # # #   #     #       # # #     #       # # # #       #       # #     # #
### ### # ### # ##### ####### ### # # ### ########### ####### # ##### # # ### #
# #     # #     # #             # # #   #           #       # #         #   # #
# ### ### # ##### # ######### # # # ######### ######### ####### # ### #########
# # # #               # # #   # # #         # #     #     #   # # # #     #   #
# # # # # ############# # ######### ########### ##### ##### ####### ### ##### #
#       #             #       # # #     # # # # #       # #         # #       #
# # ####### # ######### ####### # ####### # # # # ####### # # ####### # ##### #
# # #     # #   # #         #   # # #   # # # #             #         #     # #
# ### ####### # # # ######### ### # # ### # # # ############# # # ### ##### ###
#       #     #                                           #   # #   #     #   #
###############################################################################
