###############################################################################
#     #       #     #   #   # # # #   #           #   # # #                   #
# ########### ##### ### ### # # # # ### ########### ### # # ####### # ##### # #
#           #     #   # #   #     # #     #                       # #   #   # #
########### ##### ### # # ##### ### # ##### ########### ######### ####### ### #
#       #     #   #     # # #   # #   # # #     #   #     #   # #       #   # #
##### ####### ### ##### # # # ### # # # # # ### # ######### # # ###############
#     # #   #       #       # #   # #       # #   #         #         #       #
##### # ### ##### # # ##### # ### # ####### # # ### ### # ### ######### ### # #
# #     # #       # # # # #               # # # #     # #   #             # # #
# ### ### # # ##### ### # ### ##### ######### # # ##### ##################### #
# #   # # # # #     #           # #       #   #       #           #       # # #
# ### # # ######### ### ### ##### ### ##### # ################# ##### ##### ###
#       #   #     #     #           #       # # # # # #       #             # #
##### # # # ##### ####### ### ####### ### ##### # # # # ### ##### # ######### #
#     #   #   #     #       # #     #   #                 #     # # #     #   #
############# ##### ### # # ### # ### ### ####### ### # # ### ####### # ### ###
#           #   #     # # #     #   #   #       # #   # # #           #   #   #
######### # ### ##### ### # ##### # # ##### ### ### ### ##### ############# ###
#       # #             # #     # # #     # #   # # # #     #                 #
# ### ### # # ######### ### # # ### # # ######### ### ######### # # # ####### #
#   #     # # #             # #   # # #                       # # # #       # #
###############################################################################
