###############################################################################
#                         # #     #   #     #         #               #   #   #
### # ### # ##### ##### ### # ### # ##### ####### ##### ### ########### ##### #
# # # # # #   # # #     # # # #   # # #   # # # # #   #   #   #   # #   #   # #
# ### # ####### ####### # # ##### # # # ### # # # # # # ### ### ### # ### ### #
#     # #           # #   #   #   # #   #   # # #   #     #         #   # #   #
# ### # ########### # # ### ##### # ### ### # # # ### ### ########### ### # ###
# #   #                   # # #     #   #   # # # # # #     #   #   #   # # # #
### # # # # ### ### ### # # # ##### # ##### # # # # ######### ### ### ### # # #
#   # # # # #   #     # #       # # # #       # #     #   #               #   #
### # # # ### ### # ### ### # ### # # ### ##### # ##### ### ####### ####### ###
# # # # # #     # #   # #   #   #   # #   #   #       # #         #   #   # # #
# # # ### ### # ############### # ### ### # ##### ##### # # ######### # ### # #
#   #   # # # # # # # #               #     # #       # # #     # # #     # # #
# ### ##### ##### # # ############### # ##### # # ### # # ####### # # ##### # #
# #   #                 #               # #     #   #             # #         #
# ### # ##### ####### ### # ### ##### ### # # ############# # ##### ####### ###
# #   # #       # #       # #   #     # #   # # #   #     # # # #     #       #
# ### # ### # ### ################### # # ##### ### # ######### # ### ##### ###
#   # #   # # #                 #           #         #   #         #   #     #
# ##### ### ##### ############# ### ##### ### # ####### ### ######### # ### # #
#   #   #   #     #                 #         #                     # # #   # #
###############################################################################
