###############################################################################
#     # # # # #     #     #         # #       #   #           #   #   # # # # #
# ### # # # # # ##### # ### # ### # # # ####### ### ### ####### ### ### # # # #
# #   #       #     # #     #   # # # #   #   # # #   #   #     # #           #
# ### ####### # ##### # ####### ##### # ### ### # # # ### # ##### ### # # # ###
# #     #             # # # # #       #         # # # # #       # # # # # # # #
##### # # ### ########### # # ####### # ######### # ### ######### # # ####### #
#     #   #               # # # # # #           #   # #         # #     #   # #
### # ### # # # ### ####### # # # # ##### # # ### ### # ######### ##### ### # #
#   # #   # # # # #                     # # #       #   #     #   # #   # #   #
# ### # # # ### # ########### ####### # ### ######### ### ##### # # # ### ### #
#   # # # # #               #     # # #   #       # # #   # #   # # #     # # #
# # # ##### ### ##### # ########### ######### ##### # # ### # ##### # ##### # #
# # #   #   #       # #         # #         #   # # # #   #                   #
##### ### ### # # ### ########### # # # ######### # # # ### ##### ### # # ### #
#       #   # # #   #               # #                 #   #   # #   # #   # #
# # ### # ### ### ### ########### ### ### # # ####### ### ### ##### # # # #####
# # #   #   # #   #   #   #   #   # # # # # # #   #       #       # # # #     #
# # ##### ### # ### ### ### ####### ### # # ### # ### ### # # ####### ##### # #
# #     #   # #   #       #           #   # #   #   # #     #       # #   # # #
# # ##### # ### ### ######### ##### # ##### # ##### # # ### ##### ##### # ### #
# #     # #   #   #               # #     #       # # #   #   #         #   # #
###############################################################################
