###############################################################################
#         #       #                   #           #   #     # # #     #       #
# ##### ####### ##### ########### ### ### ####### ### ##### # # # # # ####### #
# #   #     #     # # #           #     # #   #   # # # # #       # # # # # # #
### # ### # ##### # ### ### # # ##### # ### # ### # # # # ##### ####### # # # #
#   # #   # # #     # # #   # # #     #   # #         #         # # #     # # #
# ######### # ##### # ##### ######### # ########### # # ####### # # # ##### # #
#     #   # # #     # # # # #   #     # # #   # #   #   #   # # #   # #   #   #
# ####### # # ### # # # # ##### ####### # ### # ####### ### # # # ### ### ### #
# # # #     # #   #   # #         #   # #   #     # #   #   # # #     #     # #
# # # # ### # ### # ### # # # # ##### # ### ##### # ####### # # # ##### ##### #
#     # #   #   # # #   # # # # #       #         # # # #   # #               #
### # ##### # ##### # ######### ##### ########### # # # ### # ### ######### ###
#   #           #     # #               #     # #                         #   #
# # ##### ##### ### ### ########### ### ##### # ############# ######### # # ###
# # #     #           #     #       #     #     # #   #               # # #   #
##### # ############# ##### # # # ####### ### # # ### ####### ########### #####
#   # #   #         # # # #   # # #     #     # # # #                   #     #
# ##### ##### ##### # # # # # # ####### ####### # # ##### # # # # # ##### # # #
#       #     #       #     # # #   #     #           #   # # # # #     # # # #
# # ############### ####### # ##### ### # # # ####### ### # # # ###############
# # #                       #     #     #   # #           # # #               #
###############################################################################
