###############################################################################
#       # #   #   #               # #     #         # #         #     # #     #
####### # # ### ### ############# # # ##### ######### # # # ### ##### # ### ###
#   # #   # # #   #     #   # # #       # #   #         # #   # # #           #
### # ### # # # ### ### # # # # ### ##### # ### ################# ### #########
# #   #   #     #     #   #       #       #   # #     #     # #       # #   # #
# ### # ### # ### ################# ####### ### # ##### ##### # ##### # # ### #
# # #   # # #   # #   #   #       # # #           #           #   # # #       #
# # ### # # ##### # ### ### ### ##### # # ######### ########### ### ### ##### #
#     #   #     # # # # # #   #       # #         # # # #         # # #     # #
##### ### # ### # # # # # # # ### ##### ##### ### # # # ### ### ### # # ##### #
# #   # #   # # # #     # # #   # #       #     #   # #   #   # #   #       # #
# # # # # ### ### # ##### # ####### ############# ### # ### # ### ### # #######
#   #                     # # # #       # # #   # #         #     #   #   #   #
####### ### ##### ##### # # # # ### ##### # ### ##### ### ######### # ### # ###
#         #     # #   # #               #           # # #     #     # # #     #
# # # ### # # # ### # # ######### ####### # ### ##### # ### ### ##### # #######
# # # # # # # # #   # #   # # # #         # # # #   #     #     #   #   #   # #
### ### # ### # # ######### # # ##### ####### ### # # # ### ##### ####### ### #
# #   #     # #   #   # #   # #   #     # # # # # # # #   # #       #       # #
# # ######### ### # # # # ### # ### # ### # # # # ### ######### ##### ### ### #
#     #         #   #             # #                                 #       #
###############################################################################
