###############################################################################
#     #       #   #   #   #               #   #               #     #     # # #
# ### ##### # ### # # ### ##### ######### # # # ### ##### ##### ##### ##### # #
# # #       #   # # #   # #     # # # #     #   # #     #                 #   #
# # ### ####### # ##### # ####### # # # ### # # # # # ########### ########### #
#   # #   #   # #                         # # #   # #     #   #   #     # # # #
##### ####### # # # ########### # ##### ##### # # ##### # # ######### ### # # #
#   # #     #     # #           # #         # # #     # #     #               #
### # ##### # ### ### ####### # ### # # ##### ### # # # # ### # ########### ###
#     # #     #     # #       #   # # #     #   # # # # #   # #       #   #   #
##### # # ### ####### ### # # # ### ### # ### ####### # ##### # ##### # # #####
#   #     #   #       #   # # # #   #   # #       # # #     #     # #   #     #
### # ### ################### ### ### ### ######### # # # ##### # # # ##### ###
# #   #   #     #   #       # #   #   #       # # #   # #     # #   # # # #   #
# ### ### ### # ### ####### ### # ### # # # # # # ### # ### ##### # ### # #####
#     #   #   #   #             # #   # # # #   # #   #   #     # #       #   #
### ##### # ##### ### ####### ### ### ### ### ### # ### ### ##### ##### ### # #
#     #   #   #       # #     #   #   #     #     #   #   #     #     # #   # #
# ### ##### # ### # ### ##### # # # ##### # ##### # ### # # # ####### # # # ###
# # # # #   # # # # #   #     # # #   #   #     # # # # # # #       # #   #   #
# # ### ####### ####### ### ### ### ##### ##### # # # ##### ##### # # ### #####
#       #                     # #     #   #     # #       #     # # # #       #
###############################################################################
