###############################################################################
#   # #   # #     # #     #   # # #   #     #     #   # #   #             #   #
### # # ### ### # # ##### ### # # ### # ### ##### # ### ### # # ####### ##### #
#   # #     #   #   #         # #     # # #   # #   #   # # # # #     #       #
# ### ### ######### ######### # ##### ### ### # # ##### # # # ### ########### #
#       # #   # #   #         #     #   #       #                       #   # #
### ##### # ### # # ### ##### # ### # # ####### # # # ### ### ### # ##### # ###
#     # #     # # #     #   #   #   # #   #       # # #   #     # # # #   # # #
##### # # ### # ##### ##### # ### ####### # # # # ### ### ### ####### # ##### #
#         #           #       # #   #   #   # # # #   #   #                   #
### # ####### ################# ### ### # ##### # ### ### ### # # # ### #######
#   # #       #         #   #   # # # # # # #   # # # #   #   # # #   #     # #
# # ##### ####### ##### # ##### # # # # ### ### # # ### ##### # ### ##### ### #
# # #     #   # # # # # #     #   #             # #   # #     #   #     #   # #
# # # # ##### # ### # # ##### # ##### ##### # # # ### ### # ### # # # # # # # #
# # # # #     #                 #   # #   # # # # #       # #   # # # # # #   #
##### ##### # ##### ### ####### ### ### ### ##### ### ######### # ########### #
#     #   # #       #   #   #     #   #         # # # #         # #       #   #
# # ### # ### # ### # # # # # ####### # # # ####### # # ### # # # # ####### # #
# #   # #     #   # # # # #         # # # #     #     # #   # # #         # # #
# ##### # # ### # # # # ##### # ### # ### # ####### ######### # ######### # # #
#   #   # #   # # # # #   #   # #         #       #         # #         # # # #
###############################################################################
