###############################################################################
#                 #     #         #     # # # # #   #       #     #   #       #
# ##### # # ##### ### ### ##### ##### # # # # # # ### ##### # ##### ##### ### #
# #   # # # # #   # #   # #   # #     #           # # #   # #     #         # #
### # # # # # ### # ### ### # # # # ### # ### ##### # # ##### # ### # ### #####
#   #   # #   # # #         #   # # # # #   # # # #       #   #     #   #     #
####### # ##### # ############# ##### ### ##### # # ####### # ######### ### # #
#   # # # #   # # #     #   #     #     # #   #             #         # # # # #
# ### ####### # # ##### ### ### ####### # ### ##### # # ### # # ######### # ###
# #   #     #     #   #         #         #     # # # #   # # #         #     #
# # # # ### ##### # ### ##### ########### # ##### # ##### ####### ##### ### # #
# # #   #   # #     # # #       #         #             #       #   # # #   # #
# ##### ### # ##### # ######### ######### # ######### ########### ### ##### # #
# #   #   #       #           # # #                 #       #   #   # #   # # #
# ### ##### ##### ####### ### # # ####### ##### ####### ##### ####### # # ### #
#           #     # #   # #   #     # #     #         #       #         # #   #
# # # ##### ### # # # # # ### # ### # ### # ### # ####### ##### ######### ### #
# # # #     #   #     #   #     #         # #   #       #     #     #   #   # #
# ### ############# ### # # ########### # ### ### ##### ##### # # ### #########
# #   #           #   # # # # #       # # #   #       # #   #   #             #
# ##### ######### # ### ##### # ##### # ####### # ####### ############# ##### #
#   #   #           #     #     #         #     #                     #     # #
###############################################################################
