###############################################################################
# #     #           #   #   # #   #   # #             #           #       #   #
# ##### ########### # ##### # # # ### # ### # ### ##### ### ####### ##### # ###
#   # # #               #   # # # # # #     #   #   #   # # #   # #   # # #   #
### # # ############### ### # ### # # # ############# ### ### ### ### # ### ###
#           #   # #   # #   #   #     #     # # # #     # #       #     #     #
########### ### # ### # ### ### # ### # ##### # # # # ### # ####### ##### # ###
#   # #   # #     # #   # #       #           # #   # #       # #       # #   #
### # ### # ### ### ### # ######### # # ####### # ##### ####### # ####### #####
#   # # #   # #                     # #                                       #
### # # # ### ################# ### ######### ### ##### ##### ### # # #########
# # #   #     #                 #           # # #   # #     #   # # #   #     #
# # ### ### ##### # ### ####### # # # # ##### # ##### ##### ##### ######### ###
#   #     #       #   # #       # # # #     #             # # # #   #   #   # #
### ### ####### ##### # ### # ### # # ### ### # ############# # ####### # ### #
#       #     # #     # #   #   # # #   #   # # #             #             # #
### ### ### ### ##### ### # # # ##### # # ##### # # # ######### ####### ##### #
#   #           #       # # # # #     # #   #     # #               #     #   #
##### # # # ### ### ### ### # ### ### # # # ### ############# # ### # # # ### #
#   # # # # # # #   #   # # #   #   # # # # #               # #   # # # #   # #
# # ### # # # ######### # ##### ####### # ####### ### ########### # # # ### # #
# #     # # #           #           #   #   #       #           # # # #   #   #
###############################################################################
