###############################################################################
#           #     #       # #     #     #   #     # #       #         #       #
# ### ##### ##### # ##### # # # # ### # ### # ##### # ### # # ### ##### # ### #
# #   #       # # # #   # #   # # #   #   #   # # # # # # # #   #       #   # #
# # ##### # # # # ### ### ####### ####### ### # # # # # ### # # # ######### # #
# # #     # #   # # # # #   # # #     #   # #       # #   #   # #     # # # # #
##### # ####### # # # # ### # # ##### # ### # ####### ### ########### # # # # #
# #   # #     #   #   #   #     # #   #   # #         # #   #   #   # # #   # #
# ########### # ##### # ####### # ### ### # # ######### # ### ### ### # #######
# #   #         #   #   #       # #       #     #       # #   #     #   #     #
# # ########### ### ### ####### # ##### ### # ### # ### # ### # ### ##### #####
#       #   #         #     #   # # #       # #   # # # #         # # # #   # #
####### # # # ####### ##### ### # # # ##### # # # # # ### ##### ##### # # ### #
#       # #   #   #   # # #   #     # #   # #   # #           #             # #
### # # ##### ### # ### # # ####### # # # ############### ################# # #
#   # #       #           #       # # # #   #           #   #       #     #   #
# ##### ### # ### # ##### # ##### # # # # ### ### ##### ##### ##### # ##### # #
# # #   #   #   # # # #   # #           # #   # #     #         #       #   # #
### # ##### ##### ### # ############### ### ### ########### # ### ### ### # # #
# #   #       #   #       # # #             #             # #   #   #   # # # #
# ##### ### # # # ##### ### # ##### ### # ### ############### ##### ### ##### #
#       #   # # # #                 #   #                   #     #   # #     #
###############################################################################
