###############################################################################
#       #   #     #   # #     #       #   # #     # #         #       # #   # #
### ### # # ### ##### # # # # ####### # ### # ##### # ######### ##### # # ### #
#   #   # # # # #   #   # # #   #   #             # #     #   #     #       # #
# # ### ### # # # ### ### ######### # ######### ### # ##### ### ### ######### #
# # #   #   #   # #         # # #   #   # # #   #       # #   #   #   #   #   #
# ##### # ##### # ### ####### # ### ##### # # # ####### # ### # ##### # ### ###
# #   # # #     # # #   # # # #   # # # # #   #   #             #   #   # #   #
##### # # # ##### # # ### # # # ### # # # # # # # # # # ######### ####### ### #
#       #   # # # # #   #       #   #       # # #   # #               #     # #
### # # ### # # # # # ### # # ### ### ######### ### ########### # # ##### ### #
# # # #   #   #           # #     #         # # # #           # # # # # # #   #
# ####### ### ####### ############# ##### ### # # ######### ### # ### # # # ###
#                   #                   #     # #   # #   # #   # #     #     #
########### ### # # # # # # # # # # # ######### # # # # ########### ##### # ###
#   #         # # #   # # # # # # # #     #   # # #             #   #     #   #
# # # # ### # # ### # # # # ##### # # # ### ### # ### # # # ### # ### ##### ###
# #   # #   # #   # # # # # #     # # #   #   #   #   # # # # #         # # # #
######### ### ##### # ### # # ##### # ##### ### ### # ### # # ### ####### # # #
#       # #   #   # #   # # #     # #         # #   # # # # #   #     #   #   #
####### ### ##### ### ### ### ### # ##### ##### # # # # ##### ### ##### ##### #
#               #     #     # #   #   #     #   # # #           #         #   #
###############################################################################
