###############################################################################
#   #     #         #             #           #   #   # # #     #   # # #     #
# # # ### ####### ######### # ### # # # ####### # # ### # # ##### # # # # # ###
# #   #                 #   #   #   # #         #   #             #       #   #
####### ### ########### # # # # # ### # ######### # ### # # # ### ### # # #####
#     # #     #       #   # # # # #   #     # # # #     # # #   #   # # #     #
# ### # ####### ##### ####### ### ### # ##### # # ### # # # ################# #
# #     # #     #             #     # #   # # # # #   # # #           #     # #
# ##### # ########### ##### ##### ####### # # # ### ### ####### # # ### # # ###
# # # # # # #   #     # #   #     #     #     # # # #     #     # # #   # #   #
### # ### # ### ####### ####### # # ### ####### # ######### # # ##### # ### ###
# # #   # # #     #             #     #   # # # #       #   # #     # #   #   #
# # # ### # ##### ####### ##### ### # ### # # # # ##### # # # ####### ##### # #
#   # # #               #   #     # #   #   # # #     # # # # #           # # #
### # # # # ##### ##### ### # ##### ####### # # # # # ######### ### ### ##### #
#         # #   # #         # #         # #       # # #         # #   # # #   #
####### ### # # ### # # # # ##### # ##### ##### # ##### # ##### # # ### # #####
# #     #   # #   # # # # # #     #     #       #       #   # #   # # #       #
# # ### # ### ########### # ### ### # # ##### # ### ######### # ##### ####### #
#   #   # #     #         #   # #   # # # #   # # #   #     #   #       # # # #
# ##### ##### ############### # ### ### # ### # # ######### ##### ####### # ###
# #         #                 # #   #       # #                               #
###############################################################################
