###############################################################################
#   #           #   #   # # #     #   #     #       #     #   #   #           #
# # # ### ##### ### ### # # ##### # ### ##### # ######### # ### ##### ####### #
# #   #   # # # # # #   #   # #   # # #   # # # #   #   #     # # # #       # #
# ##### ### # # # # ### # ### ### # # # ### # ##### ### ### ### # # # #########
#   #   #                 # #   # #     #   #     # #     #   # # # #       # #
# # # ######### ######### # # ### # ##### ### ##### ### ##### # # # # ##### # #
# # # #         #       #   # # #           # #     #   #             #   #   #
# ####### ### # # # ### # # # # # ##### # ### ### ##### # ##### ####### ### ###
#   #     #   # # # # #   #           # # # #     #   #       #       # #     #
### # ### ### ##### # ##### ### ########### ##### ### # ####### ### ### ### ###
#   # #   #   #     #       #       #   #   # # #   #         #   #     # #   #
# ##### ################# # ### # ### ##### # # ### # # ### ##### ### ### # # #
# #     #         # #   # #   # #     # # #       #   #   #     #   #   # # # #
####### ### ### # # # # # # # ### ### # # # ####### # ##### ### ### ### # ### #
#       #   #   # # # #   # # #     # #   # #       #     #   #   # # #     # #
# ### # ### ##### # # # ### ##### # ### ### # ##### # ############### ### ### #
# #   # #   #   # # # # #   #     #   # # #   #   # #             #     # #   #
######### # ### # # # # ### ##### ### # # # ### # # # ########### # ### ##### #
#   #     #   #       # #   #       #       #   # # #         # #   # #   #   #
### ####### ### # ##### # # ##### ##### ### # ### ##### ####### ### # ####### #
#           #   # #     # #     #     #   #     # #           #             # #
###############################################################################
