###############################################################################
# # #         #       #         # # #     #     #   #     #           #       #
# # ####### ##### ####### ##### # # # # ####### # # # # # # ######### # # #####
# # #     #     # # #   #   # #   #   # #   # #   #   # #         # #   #     #
# # # ##### ### # # # ##### # ####### ##### # # ####### ####### ### # ### ### #
# # # # #   #     #   #   # #     #     #             # #     # #   #   #   # #
# # # # ######### ### # ### # ##### ##### ##### ##### ### ### ### ##### # # ###
# #   # # # #   #         #     # #     #   # #     #       #         # # #   #
# # ### # # ### # # ### ####### # # ### # ### ##### # ######### # ### ####### #
#       # #   #   #   # #       #   # #           # #     # # # #   # #       #
# ####### # # ### ##### # ####### ### ### # # ##### ##### # # # ### # ##### ###
#     # #   # # #     #               # # # #     #   #       #   # # #       #
# ##### # ##### # # # # ##### # ### ### ######### ##### ### # ####### ####### #
# #   #     # # # # # #   # # # # #             #   # # #   #   #   # # #     #
# ### ### ### # # ######### ##### ####### ######### # ### ##### # ##### # # # #
# #     #   #     # # #     # #         #         # # #     # # #   # # # # # #
# ##### # ### ##### # # ##### ### ####### ####### ### ####### # # ### # ### # #
#       #       #     # # #     #       #       #             #   # #   #   # #
####### # ### # # ### # # # ##### ################### # # # ### # # # #########
# # #     # # #     #           # #   #   #       # # # # #   # #   #       # #
# # # # ### ##### # ### # ####### # ### # ### ##### ### # ### # ##### ### ### #
#     #         # # #   #               #           #   #   # #         #     #
###############################################################################
