###############################################################################
#       #           # #   # #     #   #     #   #             #   #           #
####### # ####### # # ### # ### ### ####### # # ### # ##### ### ##### ### #####
# # #   # #   #   # #           #       #     #   # #   # #             # #   #
# # ### # # # ##### ####### # # # ### ### ### ##### # ### ### ############### #
#   #     # #   #   #     # # #   # #   # # # # #   # # #   # #         # #   #
# ### # # ##### ### ##### ####### # # ##### # # # ##### # ### # # # ##### ### #
# #   # # #     # #   # #   #   # #       # #   # #       #     # #       #   #
# # ######### ### # ### ### ### ######### # ### # # ############### ####### ###
#   # #   # # # #     # # #   #         # #   #   #     #   #   # # #         #
# ### # ### # # ### ### # # ######### ### ### # ### ##### # # # # ### ### #####
# #   #   # #     # # #     #   #         # #   # #       #   # #       #     #
# ### # ### ##### # # ### # ### ######### # # ### # ##### ####### # ####### ###
# #   #     #   #   # # # #               # #           #   #     #   #       #
# ### ##### ### ### # # ### # ### ####### # ### ### ####### # ### ##### ### # #
#   #     #   # #           # #   # #     #   # # #       #     #     #   # # #
######### # # # ##### ##### ####### ##### # ### # ####### ##### # # ### #######
# # #     # #       # #     #                   #   # # # #   # # #   #   # # #
# # ### ######### # ### # ##### # ####### # ##### ### # # ### ##### ##### # # #
#       # #       #   # # #   # # #       #       # # # # #     # # #   #     #
##### ### ### # ##### # # # # ############### ### # # # # # # ### ##### # ### #
#             # #       # # #                   #       #   #           # #   #
###############################################################################
