###############################################################################
# # #     #       # #                 #                 #   #   #           # #
# # ##### ####### # # # ### ##### ### # ### ####### ### ### # ##### # ### ### #
# # #     #       #   #   # #       #     # # # #     # #       #   # #   #   #
# # ### ##### ####### # ######### ### ### ### # ####### # ####### ### ####### #
#   #   # #   #     # # # #   # # # # # #             # #     #   #       # # #
### ### # # # ### ####### ### # # # ### ### ########### # # ##### ######### # #
#       # # #     #     #     # # # # # #   #   # # # #   #     #   # #     # #
# ##### # ##### ##### ####### # # # # # ### # # # # # ##### ##### ### # ### # #
# #     #     #           #     # # # #   # # # # #   #   #     # #     # #   #
####### ##### # ### ##### ##### # # # # ##### ### ### # ######### ### ### ### #
# # #           #   #   # #   # # # #         #   # # #             #   #   # #
# # # # # # ### # ##### # ### # # # # ######### # # # # ######### # # ### #####
# # # # # # #   # #     # #       #   #   # # # # #   #       #   # #         #
# # ### # ### # # ### # # ####### # ### ### # ### # ### ######### # # ####### #
# #     #   # # # # # #         # #   #   # #     #           #   #       # # #
# ############### # ######### ### # ### ### # # ### # ########### # ####### ###
# #           #   #     # #         #         #     # #         # #       #   #
# ########### ### # ### # ##### ##### ##### # ### ##### ####### ### ####### # #
# #     #       # # #       # #   #     # # # # #     # # #   # #           # #
# ### ### ##### ########### # # # # ##### ### # # # ### # # ##### ### ##### # #
#         #                     #           #   # #             # #       # # #
###############################################################################
