###############################################################################
#   #     #       # # # #   #       #   # #         # # #         # #     #   #
### # # # ####### # # # # ##### ### # ### # # ### # # # # ######### # ### # # #
#     # #             #   # #     #     #   #   # #           #   #     # # # #
##### ####### ########### # ##### ####### ####### ### # # # ### # # ######### #
#     #       #   #       #         #     # #   # #   # # #     #     #   #   #
### ####### # # ####### # # ### # # # # ### # ### ##### # ########### # ### ###
# #   #     #       #   # # #   # #   #         # # #   #           #       # #
# # ############# ##### ####### ### ### ### ####### ##### # ### ### ######### #
# # #   #   # # #   # #   # #     #   #   #       # # #   # # # #         #   #
# ##### # ### # ### # # ### # # ### ##### # ####### # # ##### ########### # ###
# # #           #     #   # # # # #     # #   #       # #     #         # #   #
# # ########### ##### # ### # ### ### ### ### # ######### # ### # # # ####### #
#   #           #       # #         #   #   #       #     #     # # #   #   # #
### ### ### ### ####### # # ############### ####### # ##### ### # ### ### ### #
#       # # #     #   # #             #   #   #   #       #   # # #   # # # # #
### ##### # ##### ### # ### # ####### # ####### ####### ############### # # # #
# #   #     # # # #         #   #   #     #     #     #                   #   #
# ### ### ### # # ##### # # ##### # ##### # ##### ########### # # ####### # # #
#     #   #     #       # #     # # #   #   #       #       # # # #       # # #
# ### ######### ### # # # # ##### ### ##### ### ### # ############### # ### # #
# #   #             # # # #               #       #                 # #     # #
###############################################################################
