###############################################################################
#     #       #   # #                     #       #       #         # #     # #
##### # ####### ### # # ### # ######### ### ####### ####### ######### ### # # #
# #             # #   #   # #         #   #   # #   #                     #   #
# ##### ######### # ##### ########### ### # ### # ### ######### # ### ####### #
#   #   #         #     #       #   #   # #     # #   #       # #   #       # #
### # # # ####### ### # # ##### # ######### # # # # ##### ####### # # # ##### #
# # # #       # #     # #     # #           # #               # # # # #     # #
# # # ### ##### ### # # ### # ### ### # ### # ######### # ##### ######### # ###
#       #         # # #   # #       # #   # #         # # # #   #     #   #   #
##### ##### ### ########### ##### ##### # ### ##### # ##### # ##### ######### #
#         # # #           #     #     # # # #     # #             #     # # # #
### # # # ### ############# # ### ######### # # ####### # ### ##### ##### # # #
#   # # #   # #           # #   #     #     # # #   # # # # #       #     # # #
##### # ### # # ### # # # ######### ### ##### ### ### # # # ##### ##### ### ###
#     #   #       # # # #         #   #     #       # # #       #     # #   # #
# ### # ############# ############### # # # ### # # # ### # ########### # ### #
# # # # #         # # # #   #   #       # #   # # #     # #   #           #   #
# # ### # ### ##### ### # # # ########### ### # ##### # ##### # ########### ###
#     #     #       # #   #   #     #   #   # # # #   #   #       #   # # # # #
# ##### ############# # ####### ##### ### ### ### ### # ####### ##### # # # # #
#   #                                   # #         # #       #               #
###############################################################################
