###############################################################################
#     #       # # #       #   #         #   #           #               # #   #
##### ####### # # # ##### # ### ##### ##### # ############# # ########### # ###
#           #   #   #     #     # # # # # # # #       # #   #       #   # #   #
########### ### ### # ### ####### # # # # # # # ####### ### ######### ### ### #
#       # #   #     # #           # # #   # #         #   #               #   #
# ##### # ### ### ### ##### # ### # # ### # # ######### ### ### # ########### #
#   #     #         # #   # # # #                 # #       #   # #         # #
### # # # ### ######### # ##### ### ### ### # # ### # # ######### # # ####### #
# # # # #     #         #           #   #   # #       #         #   #   #     #
# # ##### # ### ################# ##### ##### ######################### # #####
#     #   # #   # #   # #   #     #     #             #         #   # #       #
# ########### ### # # # # ####### # ######### # ### ### # # # ##### # ### # # #
# #   #       #   # # # #       # # #         #   #     # # # #       # # # # #
# ### ########### # ### ##### ### ##### ### # # ######### ### # ### ### # #####
# #             #     #         #   #   #   # #         #   #     #     #   # #
# ############# ### ######### ### ##### # # ##### ########### ### # ### ##### #
# #                   # #         #     # #     #           #   # # # #   # # #
################# ### # # # # ### ### # # ##### ### ####### # # # # # # ### # #
#   #       #     #       # # #   #   # # #       #   #   # # # # # # # #     #
# ### ##### ##### # # # # ##### # ######### # ### # ### ### # # # # # # ### ###
#     #           # # # #   #   # #         #   # #     #   # # # #   #       #
###############################################################################
