###############################################################################
#   #       #             #         #     #           #       #   #   #       #
# ### # ################# # ##### # # # # # # # # ### # # ### ### # ### ### ###
#   # # # # #         #   # #     # # # #   # # #   #   # #       #   # #     #
# ##### # # ### ##### ### ##### ### ### ####### # ### ####### ### # # # ### # #
# #   # # # #   #       #       # #   # # #   # # #   #       #   # #   #   # #
# ### # # # ### # ### ########### ### # # ### # ##### ########### ########### #
#   #     #   # # # #     #             #         #     #                     #
### # # # # ####### ### # # # # ######### ### ##### # # ####### # # ####### # #
#     # #       #       # # # # #         #     #   # #   #     # # #   #   # #
### ######### ########### # # ####### ### ##### # # # ####### # ### ### # ### #
# # #   #         #   #     # # #   # #       # # # # #   #   #   # #     #   #
# ### ### ####### ### ### ##### # # ##### # ############# ### ### # # ### #####
#     #   #     #     #   #       #       # #                 #   # # #     # #
##### ### # ### # # # # ######### # ### ####### ####### ########### ####### # #
#         #   # # # #   # # #     # # # #   # # #       #           #         #
######### ### # ##### # # # ####### # ### # # ########### # ##### ### ### # ###
#     #   #   #       # #     #       #   # #     #       #   #   #   #   #   #
### # ### ####### ####### ### ####### ##### ##### # ### # # ### # # # # ### ###
# # # #     #       #     #     #   #   # #   #     #   # # # # # # # # #     #
# ### ####### # # ### ### ##### # ####### # # # ######### ### ####### ### # ###
#             # # #   #   #                 #   #             #         # #   #
###############################################################################
