###############################################################################
#     #     # #       # #   #     #                                 # #       #
# ### ##### # ####### # # # # # ####### ### ### ##### ##### ######### # ##### #
# # # # #   # # # # #     # # #     # # #     #   #       # # #   #   # #     #
# # ### ### # # # # ##### # ### ##### ### ######### ##### ### # ### ######### #
# #     #     #     # #   #   # #       #       # # #   #                 # # #
# ##### ##### ##### # ####### # ####### # ####### ### # ### ### ### # ##### # #
# # # # #       #   #                         #       #   #   #   # #       # #
# # # # # ##### # # # ######### # ##### ### ### ####### ##### ### # # # ##### #
#   # #   #   #   #   #   #     # #       # # #     #       #   # # # #       #
### # ##### # # ######### ### # ##### # ##### # # # ### ### ############# #####
#           #     # #         # #   # #     #   # #   #   #         #         #
### # # # ### # ### ### ##### ##### ### ##### ####### ######### # # # # ##### #
#   # # # #   # #           # #     # # #       #   #         # # # # #   #   #
# # ### ####### ################### # # # ### ### ########### ####### # # # ###
# #   # #       #             #   #         #         # #   #       # # # # # #
################# ########### ### # # # # ############# # ### # ### ### ### # #
#             # # #       #   #   # # # #           #     #   #   #   #   #   #
# # ######### # ### # ### # # ### # ##### ######### # # ######### ### # #######
# # # #   # # # #   # #     #       #   #       # #   #       #     # # #     #
# ### # # # # # ### ##### ##### ####### # ####### ##### ### ####### ### ##### #
#   #   #             #   #     #                   #     #       #   #       #
###############################################################################
