###############################################################################
#   #     # #   #         #   #   #     # #       # # #         #     #     # #
# ####### # # ######### ### ##### # # # # ##### ### # # # ##### # ### ##### # #
# #   # #   #         # # #   # #   # # # #     #     # #   #   # # # # #   # #
# # # # ### ####### ### # # ### # ### ### ##### # # # ##### ##### # ### # ### #
# # # #         #       #     #     # #     #     # # # #         #       # # #
# # ##### ### # ### ### ### ### # ### ##### ######### # ### ####### ####### # #
# #     # # # #     #   # # #   #   #   # #   #     # #     # #     # #       #
# ##### # # # ######### # # # # # ####### ### ##### # ##### # # ##### # # # # #
#   # #   #   #       #       # # #   # #   #   #   #       # #   # #   # # # #
### # ########### ### ######### ### # # ### # ### # ### ### # # # # # # # # ###
#           #       #       #       #             #     #     # # # # # # # # #
########### ############# ############# ##### # # # ####### # # ### # ##### # #
#     #       #   #   #             #       # # # # #       #             # # #
##### ##### ### # ### # ### # ##### # # ##### ##### ### ### # ####### ##### # #
#         #     # #     #   # #       #     # #     # # #   #       #     #   #
# ### ### ####### ### # # # ####### ##### # ### ### # ##### # # ####### ##### #
# #     # #   #     # # # # #     #     # # # # #   #       # #     #     #   #
# ### ### # ####### ############# # ### ##### ############### # ##### ##### ###
# #   #     # #     #         #     # #   # #       #         #     # #   # # #
# # ### # ### ### # ##### ### # ##### # ### ##### # ####### # ####### # # ### #
# #   # #         #       #         #         #   #         #       #   #     #
###############################################################################
