###############################################################################
#                       #     #     #     #         #                   # # # #
# # ####### ######### # # ####### # ### ### ######### ##### ### ######### # # #
# #   # #       #     #   #   # # # # #                   #   #               #
# ##### ##### ########### # ### ### # # # ### # # ##################### #######
#   # #     # # #           # # # # #   #   # # #   #   #           #   #   # #
### # ##### # # ########### # # # # # ##### ### # ### ### ################# # #
#   #     #   #     #       #   #         # # # #         # # #     #         #
# ### # # # ####### ####### ### ### # ##### # # ########### # # # ### ##### # #
# #   # #   #   #       #   #       #     # #           #     # #     #   # # #
####### # ##### ### # ### # ### # ############### # # ##### # # # ##### ##### #
#   #   # # # #   # # #   #     # #         #   # # #     # #   #           # #
### ####### # ### ### # ##### ### # ### # ### # # # ######### ##### ### # ### #
#       # #     #     # #     #       # #     # # # #   # #     #     # # # # #
####### # ##### ##### ####### # # ####### # ##### # # ### # ##### ### # # # # #
# # # #   # #                 # #     #   #   #   #             #   # # #   # #
# # # # ### ######### ######### ####### ### ### # ### ### ### #################
#               #     #     #         #   #   # # #   #     #     #     #     #
######### # # ########### ### ### # ######### ### ################# ##### ### #
#   #     # # #     #     #     # # # #     # # #   #           #         # # #
# # ##### ### ### # ### ####### ### # # ####### ##### ### ### ### ### ##### # #
# #       #       #               #                   #   #         #       # #
###############################################################################
