###############################################################################
# #     # # # # # #     #     #         # # #   #   #       #         # #     #
# ### # # # # # # # ######### ### ##### # # # ### ##### ##### ##### ### # # ###
#   # # #   # # # # #   #   #   # #   #     #   # #     #   #     # #     #   #
### ### # # # # # # # ##### # ### # ########### # ### ### ##### ##### ### ### #
#     # # #     #   #   #             # #       #     #       #   #   # # # # #
##### # ####### ### # ##### # ### ##### # ####### ##### ### ### ##### # ### # #
# #             # #     #   #   # #   #   #         #     # #   #   # #   # # #
# ######### ### # ### # # ### ### # ##### # # ### ### ####### ### # # ### # # #
# #   # #   # #       #     #   #   #   # # # # #   # # #     # # # #   #   # #
# ### # ##### ##### ########### ##### # # # # # ### # # # # ### ### # ### # ###
#                         #   #       #   # #     # # #   # # # # #       # # #
##### ####### ####### ##### ########### ### ### ##### # ### # # # ##### # ### #
#     #     #   #         #   # #   # #   # #   #     # #     #   #     #   # #
##### ##### ##### # ##### # # # # ### ##### ##### # ### ######### # ### ### # #
# #   #     # # # #     #   #         #   #       #       # # #     #     # # #
# # ####### # # ### # ######### ####### ### # ### ### ##### # # ### ### ##### #
#   #   #         # #         #     #   #   #   #   # # #   # #   #   # #     #
# # ### ######### # ################# # ### ########### # # # # ####### ##### #
# # #       #               #   #     #   #   # #       # # # #   #   #     # #
# ### ##### ####### ######### ### ##### ### # # ##### # # ### # # # ####### # #
# #     #                             #     #         #         #       #     #
###############################################################################
