###############################################################################
#   #           #   #     #     #   #           #       #       #         #   #
# ### ####### ### ### ##### ##### # # ########### # # ### ####### ######### # #
# #   #   # #   #   #   #     # # # # #   #   #   # #   #     #   #         # #
# # ### ### ##### ##### ##### # # ### # # # ### ### ### # ####### # ##### ### #
# # #   #   #   #     #             #   #   #     # #     # #   #       # #   #
# # # ### ### # # ### ### ### ### # # ##### # ### ### # ### # ### ####### #####
#             # # #     #   #   # #       #   # # #   #                 #     #
# ### ### ####### ####### ##### # # ####### ### # ### # # # ######### ### ### #
# #   #   #   # #       #   # # # #       #     # # # # # #   #     #   #   # #
# ### ##### ### # ####### # # ####### # # # ### ### # ### # # # ### # # ### ###
#   #             #   # # #         # # # # #     # #   # # #     # # #   # # #
# # ##### # # # ### ### # ##### ### # # # # ####### # # # # # ### ##### # # # #
# #     # # # #               # #   # # # # #       # # # # #   #   # # # # # #
# # # ####### # # ##### # ####### # ### ##### ### ### ######### # ### ####### #
# # #       # # #     # #       # #   #       # #   #   # #     #         #   #
# # # # ################# # ################### # # # ### # ### ########### # #
# # # #               #   # #     #       #   #   # #   # #   #   # #       # #
### ######### ### ### ##### # # # # # ##### ##### ####### ### ### # # ####### #
# #         #   #   #   #     # #   # #         #   #   #   #   #           # #
# ### # # ##### ########### # # ### # # # # ######### ### ##### ########### ###
#     # #     #         #   # #   # #   # #                   #           #   #
###############################################################################
