###############################################################################
# #   # #   #           #   # #               #                     #         #
# ### # ### # ### ##### ### # # ########### # # ####### ### # ######### # #####
#             #   #   #             #     # # # # #   #   # #         # #   # #
# ################### # ##### ####### ####### # # # # ######### ### ### # ### #
# #   # #     # #   #   # # #         #     #       #   #     # # #   # #     #
# ### # ##### # # # ### # # ########### ############# ### ####### ##### #######
#   #       # #   #       # # # # # #     #   # #   # #         # #   # #     #
# # ### ### # ##### ### ### # # # # # ####### # # ##### ######### # ### ### ###
# # # # #     #       #             #   #   # # #     # # #   #     #   # #   #
##### ##### # ### # ### ####### # ### # # ### # # # ### # ### # ### # ### # # #
# #         #     #   #       # #     #       # # #     #   # # #     #   # # #
# ##### ### ### # # ### # ### # # ### ##### ### ### ##### ### ### ####### # ###
# #     #     # # # #   # #   # #   #     #   #               #             # #
# # ### # ####### ##### ####### # ############# ############### ##### # ##### #
#     # #   #       #       #   # #       #   # #         #         # #   #   #
# ### # ### # ### # ### ##### # ##### # # # # # # # ######### # # # ####### # #
#   # # # # #   # #   #   #   #       # # # #   # # #         # # #       # # #
# ##### # # # ### # ##### ############# ### # ### ### ######### ######### # # #
# # #   #   # #   #     #   #     #   # #   #     #   # #   # # #     # #   # #
# # ##### ############# ##### ##### # # # # # # ### # # # ### ### # # # #######
#       #     #                     # #   # # #     #             # #         #
###############################################################################
