###############################################################################
#   # #             #   #     #         #   # #       #   # # # # #           #
# ### ### ##### ####### # ##### ##### ### ### # ### ##### # # # # # ### # # ###
# #   #       #     #     #     # # #   # # # # #         #   #       # # #   #
# # ####### ####### ### # ####### # ### # # # ####### ####### # ###############
#           # #   #   # #     # #     # #   #   #   #   #   #   # #       # # #
# ####### ### ### ### ### ##### ##### # # ### ##### # ### ### ### # ####### # #
# #     # #   # # # #     #   # # # # # #   # #     #     #   # #   #   #     #
# ### ##### ### # # # ####### # # # # # ### # ##### # ####### # # ### ####### #
# #   # #     # # # # # # #             #             # # #   # # # #   #   # #
##### # ### # # # # # # # ############# # ##### ##### # # # ### # # ### ### # #
#   #     # #           #           #   # #     #         #   # #     # #     #
# ##### ### # ##### ### ### # ### # # # ##### ########### ### # # ##### ### # #
#     #   # # # #   # #   # # #   #   #     # #                   #         # #
##### ### # ### # ### ### ##### ### ### ### ################# ### # ###########
#   #   # # #   #   #     # #   #   #   #   #     #             #             #
### # ### ### ####### ##### # ##### ####### # ### ### ### ### # ##### # #######
#       # #         # # # #   #   #     #   # # #   #   # #   # #   # #       #
##### # # # # ####### # # ##### # # ### ### # # ### # ##### ####### # #########
#   # #     #   #   #   #       #     # #   #   #       # #     #   #         #
### # ######### # # # # ### # ### ### ##### ### ######### ### # # ########### #
#     #           #   #     # #     #     #       #           #       #       #
###############################################################################
