###############################################################################
#               #   #       #   # #     #   #   #   #                   #     #
### # ######### # ### # # # ### # # # # ### ### ### ####### ######### ##### ###
# # #   # #     # #   # # # #       # #           #     #   # #         # # # #
# ####### ### ### ####### # ########### # ####### ### # ##### ### ### ### # # #
#     #       #         # #             #     #     # #     #     #           #
##### # ### # ### ### ####### ### # # # # ##### ### # # ### ##### ### ### ### #
# #     #   # # #   #   #   # #   # # # #   #   #     # #           # #   #   #
# ####### ### # ####### # ####### # ### ### # # # ################### # ### ###
#         #   #         # #       # #     # # # # #           #       #   #   #
##### ### ### # ### ##### ### # # ### ### ### # # ### ##### # ####### # ### # #
#   # #   #     # # #   #   # # # #   #   #   # #   #     # #     #   # #   # #
# ##### # # ##### # ### ### ##### ### # # # ### ####### ####### ### # ### #####
#       # #   # #   #   #         #   # # # #   #     # #           # #   #   #
# ######### ### ### # # # # ### ##### # ##### ### ### # ### ### ### # # # # ###
# #         #   #     #   # #   #     #     # #     #     # #   #   # # #     #
# ############# # # # ### # # ##### ##### # ############### ### ##### # # ### #
# #       #       # #   # # # #   # #     # #       # #   #   #   #   # #   # #
# # # # ########### ##### ##### # ########### ### ### ### ### ####### # # ### #
# # # #         #     #       # # # #         #                 #     # #   # #
### ####### # ### # ### ##### # ### ### # ##### ############# # ### ### # #####
#       #   #     # #   #     #         # #     #             #   #   # #     #
###############################################################################
