###############################################################################
# #     #   # #   #       #       #   #     #     #   # #   # #               #
# # ##### # # ### ### # ######### ### ##### ##### ### # ### # # # # ##### #####
#     #   # #         #     # #   #     #   # # #   # # # #     # #   #       #
# # ####### ####### ### ### # ### # ### # ### # ### # # # # # ####### ####### #
# #   #       #     #   # #     # # #   #   #     # # # #   # #   #     # #   #
# ####### ### # ##### # # ### # # # ### ### ### ### # # # ####### ##### # # ###
#         #     #     # #     #     # # # # #   # # # #   #     #   # #   #   #
### ### ####################### # # # ### # # ### # # ### # ####### # # ### ###
#   #     # #     #   #         # # #   # #     # # #     # #     #   # # # # #
# ##### # # ##### ### ### ##### # # # # # # ### # # # ##### ### # # ##### ### #
#   #   # #       #       #   # # #   #     #     #       #     #     #     # #
### ##### ##### # ### # ##### ### ##### ######### # ######### # ##### # ##### #
#   #     # #   # #   # #   #   #   #   #         #           #   #       # # #
# ### ### # ##### # ##### # ### ##### ##### ##### # ############# ######### # #
# #   #   #       #   #   #     #     # #   # #                 #     #     # #
# ##### ######### ########### ##### # # ### # # ### ### ### # # # ### # ##### #
#   #   #   #           # #         # #       #   #   #   # # # #   #         #
### # ### ############# # ### # # ######### ##### ### # ############# #########
#   #   # #   #   #           # # #         #       # #             #       # #
####### # ### ### ### ### # ### # # # ### ##### ##### # ### ######### ### ### #
#       #             #   #   # # # # #     #       # #   #         #   #     #
###############################################################################
