###############################################################################
#   #     # # # #       #                   # # # #       #     #   # #       #
# ### ##### # # ### ### # ### ### ####### # # # # # # ### # # ### # # ### # # #
#     #   # #   #   # # # # # # # #       #     #   # #   # #   # #       # # #
### # ### # ### ### # # # # ### ##### ####### ##### # # ##### ### #############
# # #   #   # # #   # #   # # #         #   # # # # # # # #   # # # #     #   #
# # ### ### # # ### # ### # # ######### # # # # # ### ### # ### # # # ####### #
# # #     #   #   # #     #   #       # # #   # # #         #   #   #   #     #
# ### # # ### ### ####### ### ####### ### ### # # ### # ##### ### ### ####### #
#     # #   #     # #     # #   #   # # # #       #   # #   # #       # #     #
######### ##### ### ####### ### ### # # ####### ##### ### ### # ####### # ### #
#                 #       # #       # # #   #     #                   # #   # #
# # ########### ##### # # # ### ### # # ### ### ### ######### ### ##### ### # #
# # #             #   # # # #   # #               #         #   # #     #   # #
################# # ### # # ##### ####### ##### ### ##### ##### # # ##### # ###
#       #     #   # # # # #   # #   #     #             # #   # #   #     #   #
####### ##### # ##### ### ### # ### ########### # ##### ### # # ##### ####### #
#             #     #         #           #   # # # # #     # #             # #
# ########### # ##### ####### ####### ### ### # # # # ####### # ######### ### #
#   #           #   # # #     #     # #     #   # #     #     #       #   #   #
# ######### # ##### ### ##### ##### # ##### # # ### ### ##### ####### # ### ###
# #         #                         #       #       #     #     #   # #     #
###############################################################################
