###############################################################################
#   #   #   #                     #   #         #       #     #           #   #
### ### ### ##### # # # # ####### # # ##### ### ####### ### ##### # # # ##### #
#   # #     # #   # # # #   #     # #       #   # # # # #   #     # # #     # #
# ### ### # # ### ######### ### ######### # # # # # # # ### ##### ##### ##### #
# #   # # #     # # #       #     #     # # # #   # #     #         # #   #   #
# ### # ##### ##### ############# ##### ##### # # # # ### ########### # ### ###
#   # # #       # #         #         #   #   # #     #         # # #         #
# # # # # ##### # ######### ######### ### ########### ######### # # # #########
# #     # # # # # #   # #   #   # #   #     # #   #   # #   #               # #
##### # ### # # # ### # # # ### # ### # ### # ### # ### ### ####### ### ##### #
# #   #   #   # # # #     #   # # # # # # #     #   #         #     #         #
# ####### # ### # # # ##### # # # # # ### ### ### ##### ##### # ##### # ##### #
#   #     # # #   #   #     #   # #   # #     # # #   # # #     #     #   #   #
# ####### # # ### ### ######### # # ### # ### # ### # ### ####### # # # # ### #
# #   #     # # # # # #                 # #     #   #             # # # # #   #
# ### ##### # # # # ### ### ##### ### ### ##### # ############### # ### ##### #
#     #           # #     # #       #     # #       #   #         # # #     # #
# ### ### # # ##### # ##### ####### ##### # ####### # # ### ### # ### # # # ###
# # # # # # #   #   # # #   #         # #   # # # # # #   # #   #   # # # #   #
# # # # ##### # # ##### ############### ##### # # # ##### ### # ### # # # # ###
# #           #                                       #       #   #   # # #   #
###############################################################################
