###############################################################################
#   #   # # #   #     #       #   #                               #     #     #
# # # # # # ### # ### # ### # # # ### ### # # # # # ### # # # ### # ##### #####
# #   # #         #   # #   #   # #   #   # # # # # #   # # #   #   #   #     #
# # ### ### ### ### # ### # ##### ####### # # ##### ##### ######### # # # ### #
# # # #   # #   #   #     #   #   #       # # # #   #         #   #   #     # #
# ### # ############# # ### ### ### ##### ### # ####### ### ### ### ######### #
# #   # #             #   # #       #   #   # #         #       #         #   #
### ### ### ####### # # # ############# ### ######### # ############# #########
#         # #     # # # # # # #   #         #   #     #           #         # #
# ##### # # # ### ######### # ### # ##### ##### # ### # ##### ######### ##### #
# #     #   #   #   # #     #     # #     # #   # #   #     #   #     #       #
############### ### # ### # # # # # ##### # # # ##### # # ####### ##### ### ###
#     #     #   #       # #   # #     #   #   #   # # # # #     #   #     #   #
# ### # ### # ######### ### ### ##### ########### # # # # # # # ### # ##### # #
# #     #     #   #   #     #   #   # # #   # # #     # #   # #     #   #   # #
# # # ### # # # ### # # # # # ##### ### ### # # ### # # ### ### # # # # #######
# # # # # # # #   # #   # # # #   #       # #   #   # #   #   # # # # #       #
# # # # # ##### ### ##### # # # # ##### ### # ### ### # ##### # ######### ### #
# # # # # # # # #   #     # # # # #     # #   #   #   #   #   # #   #   # #   #
### ### ### # # ### ############# # ### # ### ######### # # ##### # # # ### # #
#     #                 #           #                   # #       #   # #   # #
###############################################################################
