###############################################################################
#         # # #     #   #   # #   #   #     #   #     # #   #         #       #
# # ### # # # # ####### ### # # # # # ##### # ### ##### # ### # # # ### ##### #
# # #   # #   #   #         # # # # #   # # #       # #       # # #     #   # #
### ##### ### ### ######### # ### ##### # # # ##### # # ######### # ##### # ###
#   #   #       #   #         #       # # #     # # #   #     #   #       #   #
##### ##### ### ### # ### ######### # # # ### # # ### ### # # ### # ##### ### #
# # # # #   # # #   # #   #         #       # # #   # #   # #   # #   # #   # #
# # # # # ### # # ##### ### ### # ######### ### ### # ##### # # ### # # # # # #
#   # # # # #   #   #     # #   # #     # # # # #   #   #   # #   # #   # # # #
# # # # # # # ### # ### ######### ##### # # # # # ### ### ### # # ### #########
# # # # # #       # #             #   #     # # # # #     # # # #   # # #     #
# ### # ######### ####### ######### ####### # # # # # # # # ### ### ### # #####
# #   #     #   #         #       # #   # #       #   # # # # #   # #         #
# # ### ### # ######### # # ### ### # ### # ##### # # # ### # ### ### ##### # #
#   #     #     # #     # # #   #               #   # #   #   # #         # # #
# ### ####### # # ### ### ### # # ### ### ### # ### # ##### ### ### ### #######
# #   # #     # # # # #     # # # # # #     # #   # #             #   # #   # #
# ##### ### # # # # # # ####### ### ##### ### # # ##### ############### # ### #
#           # #     # # #   # #           #   # #     #         #     #       #
# ##### # # # # ### ##### # # ### ####### # # ### ### # ### ### # ####### # ###
# #     # # # #   #       #       #       # #   #   # #   # #           # #   #
###############################################################################
