###############################################################################
#     #       #   #     #   # #       # # # # #     # #       #   #     # # # #
# ### # ##### # # ##### ### # ### ### # # # # # # ### ####### # ##### ### # # #
# #   # #   #   #   #   #   # #     # # #   # # #   # #   # #   #     #   # # #
# # ####### # ######### # ### # # ##### # ### ##### # # # # # ### ##### ### # #
# # #     # # #         # # # # #   #   # #   #   #   # #   # # # #     #     #
# # ### ### # ### ####### # # ##### # ### ### # ##### ##### # # # # ##### #####
# #           #   #     #   # # # #   #   # #   # # #     # # #     #   #   # #
# ### # # ### # ### ####### # # # # # # ### ### # # ##### # # # # ### ##### # #
# #   # # # #     #   #       #     # #   # #       # #   # # # #   #     # # #
# # ### ### ##### # ####### # ##### ##### # # ##### # # # # # ### ##### ### # #
# # #   #     #   #         #   #   #       # # # # # # #           #       # #
##### ####### # # ########### ### ### ##### ### # # # ######### ####### ##### #
#     #     #   # #   # # #         # #     # # # #         #     # #     # # #
# ### ##### # # # ### # # ##### ######### ### # # ####### ### ### # ### ### # #
# #   #   #   # # # #   # #   #     #       # # # #       #   # # #   #       #
####### # # ##### # # ### ### # # # ### # # # # # ####### ### # # # # # ##### #
#   #   #   #       # #         # #     # # #   #     # # #   #     #   # # # #
# ####### ### ### ### ##### # # ##### # ### ### ##### # # ##### # ####### # # #
#         #   #             # # #     #   #   # # # # #   # # # # # #     #   #
### ##### # # # ####### ### # # ####### ### # # # # # # ### # ### # # ### # ###
#   #     # # #   #       # # # #       #   #                         #   #   #
###############################################################################
