###############################################################################
#                 # #     #   # # #     # #   #     #   #             #   #   #
##### ##### # # ### ##### ### # # ##### # ### ### ### ### ########### # ##### #
# #   #     # # #   #       # #       # # # #   # #   #   #   # # #   # # # # #
# # ####### ### # ####### ### ##### ### # # ### # # ### ### ### # # ### # # # #
# # # #   # # #         #             # # #   #   #   # #   # # # #   # # # # #
# ### # # # # ####### ### ##### ##### # # ### ### # # # # ### # # ##### # # # #
# #   # # #   #   # #     #   #   #     # #     #   #   #   # # #   #   #     #
# # # ### ##### # # ##### ### ### # ### # ##### ### ##### ### # ### # ####### #
#   #           #     # # #     # # #   #   #   # # # # # #     #   #   # # # #
### # # ##### ### ##### ####### ### # ##### # ### # # # # # ##### # # ### # # #
#   # #     # # #         # # # #   #     # # # # # #   #   #   # #     #     #
##### # ##### # ##### ### # # # ##### ### # # # # # # ### ##### # ####### # # #
#     # #     # #   # # #     # #     #                     #   #   #     # # #
##### ### ##### ### # # # ### # ############### ### ### ####### # # # # ### ###
#   # #     #   # # #   # #   # #           #   #     #     #     #   # # #   #
# # # ####### # # # ### ##### # ### ### ### ######### ####### ### # # ### # # #
# # #     #   #         #   #     # # # # #         #       # # # # #     # # #
# ##### ####### ##### ##### # # ##### # # ######### # ##### # # ### # ### #####
#     #   # #   #     #       # #       #   #             #     #   #   #     #
# ####### # # # ### ### ### ### ### ##### # # ### ##### ### # # ##### # ##### #
#         #   # #   #   #   #       #     #   #       #   # # #     # #     # #
###############################################################################
