###############################################################################
# #         #                   # # # #     #   # #     #   # #     #         #
# # ####### ####### ### # # # ### # # ##### ### # # ### # ### ##### ### # ### #
#     #             #   # # #       #     #     #   # #         # #     # #   #
# ##### ####### ########### ### ### ##### ##### ##### ##### ##### ####### # # #
# #   # #         #         #   #               #             #           # # #
##### ##### ### ########### ##### ####### ##### ############# # # ##### ### ###
#   #   #     # #         #     #     #       #         #       #   #   #     #
# ##### # ### # ##### ### ### # ### ########### # ### # ####### # ### ### ### #
#     #     # #   # # # #   # #   # #       #   #   # #         # #   #   #   #
##### ### ### ### # ### # # # ### ##### # # # ##### ######### # # # ### # # ###
#   # #   # # #   #       #     # # #   # #   #     # #       # # # #   # # # #
### # ##### ######### ### ####### # ########### ### # ### # # # # # # # # # # #
# # # #         #   # #         # #       #       # #     # # # # # # # # # # #
# # # # ### # # ### ##### # ### ######### ### ### # # # ### # ### # # # ### # #
# # #   #   # #           #   # #   #         #   # # # #   # #   # # #   #   #
# # ##### # ### ### ##### # ### ### # ### ### ####### # # ### # # # ##### ### #
# #       #   # #   #   # # # # #     #   # # #   #   # #   # # # # #     #   #
# ### ### ### # # ### # # ### ##### ### # # # # ### # # ### # ##### # ####### #
#   #   #   # # #   # # # #           # # #   #     # # #   #   #   # #       #
# ##### ####### ####### ### # ### # # ### ### # ######### ####### # ### ### ###
#       #           #       # #   # #   #   # # #               # # #     #   #
###############################################################################
