###############################################################################
#         # #     #                 # #       #     #             # # #       #
# ### ##### # ### ##### ### ######### # ### ### ##### # ####### ### # # # # ###
#   # # #   #   # # #     #   #   #   #   #     #   # #       # # # #   # #   #
### ### # ### # # # # ### ####### ### ### # # ##### # # # # ### # # # ####### #
#   #         # #       #           #     # # #       # # #   #     #     #   #
### # ####### ################### # # ##### ### ##### ### # ### ### # ##### ###
#           # #     #     #     # #   #             # #   #   # #       #     #
### ######### # # ### ### # ### ########### ### # ##### ##### # # ####### #####
#   #       #   # #   # #   # #   #       #   # # #   #   # # # #     # #     #
### ### ######### # # # ##### # # ### ##### ### ### ####### # ##### ### ##### #
#               # # # #     # # #     #   #   # #       #   # #   #         # #
# # ####### ####### ### ##### ######### ######### ### ### # ### ### ### ##### #
# # # #   # #   #     #   #         #   #     #   # # # # # #         # #     #
### # # ##### ### ##### ### ##### ### ##### # # # # ### # # # # ### ##### #####
#               #     # # #   # # #         # # # #       # # # #       #     #
### ######### # # # # # # ### # # # # ### ### # ##### ##### # ##### ####### # #
#     #     # #   # #     #     #   # #     #   #     # #   #   #     # # # # #
# ##### # ### ### # ##### # ########### # # # ### ### # ####### # ##### # # ###
#       # # #   # #     #           # # # # #       #       # # #       # #   #
# # ### # # ########### ##### ####### ##### ########### ### # # ######### ### #
# #   # #       #           #             #         #     #   #             # #
###############################################################################
