###############################################################################
# #   #   # #           # #   # #     #       #     #           #   #       # #
# ### ### # ######### ### # ### # ### # ####### # ### # # ####### ####### ### #
#               #   # #   #   # #   #           #     # # #     #     #   #   #
# ### # ### ### ### # # ### ### # ##### ############### # # ####### ### ### ###
#   # # #   #   #     #   #           # #     #       # #     #   # #     #   #
### ##### # ### ##### ### # # ### ### # # ### # ########### ##### # # # ##### #
#   #     # #     #       # # # #   # #     #   #         #   #   #   #       #
######### # ##### # ### # ### # ### # # # # ##### ### ########### ### ####### #
#   #     # #     # #   #         # # # # # #       #     #   #           # # #
### ##### ####### # # # ### # ### ####### ### ############# ### ########### # #
#       # #         # #   # #   #   #   #   #   #   #       #         #   # # #
### ### ##### # # ##### ##### ##### # ####### ### # # ### ### ########### # ###
#     #   #   # # #       # #     #     # #   #   #     #   #     #     #     #
# ##### ### ### # ### ### # ####### # # # # ### ############### # ### # # ### #
# #         #   #   # # # #       # # #   # #     # # #       # #     #   #   #
# ### ######### ### ### ### # ### # # # ### # ##### # # # # ### ####### ##### #
# # #   #       #     #     # #   # # #   # #     #     # #           #     # #
### ##### ### # ##### ### ####### ##### ### # ### # ################### #######
# #       #   # # #         #   # # #     # #   #   #     # #       # #       #
# # # ######### # # ####### # # # # # # # # ### ##### ### # ####### # ##### # #
#   #     #     #   #         # #   # # #               #             #     # #
###############################################################################
