###############################################################################
#           #     # #   #         #       # #     #               #   #   #   #
# ### ### # ##### # # ########### # # ##### ### ### ####### ##### ### # # # ###
#   # # # #   #           #   # #   # # #     #     #     #     #     # # #   #
####### ##### # ####### ##### # ##### # ### ##### ### ####### ####### # ##### #
# # # #   #   #   #           #       # #         #         #   # #         # #
# # # # ### ####### ##### ##### ### ### # # ####### ### ####### # # ##### ### #
#     # #   # #       #         #   # # # # #   #   # #   # #     #     # #   #
### # # # ### ### ### ########### # # # ### # ### ### # ### # # ##### # ##### #
#   # # # #     # # # # #     #   #       #     # #   #     # # # #   #     # #
# ##### # # ### ### ### # ##### ##### ### ### ### # # ######### # ### ### ### #
#   # # # #   #   #       #   # #     #       #     # # #     #     #   # #   #
# # # # # ##### # ### ### # ### ### ### # # ### ### ### # # ########### # # ###
# # #       #   #   # # # # #   # # #   # #     #         #       #     #     #
# ####### ######### # # # # ### # ### ### # ####### # ##### ########### ### ###
#     #   #     #   # #       #   #   # # #   #   # # #   #           # #     #
# ####### # ### # ### ####### # # # ### ##### # ####### # # ##### # # #########
#       #   # #       #         # # #       #     # # # # #   #   # #   #   # #
# ### ### ### ##### # ##### ##### ####### # # ### # # ### ### ### ##### # ### #
#   #     #         # #       #   # #   # #     # # # # # #     #     #   #   #
##### ### # ######### # ##### ##### ### # ######### # # # # ### # # # # ### # #
#       # # #         #     # #                       #       # # # # #     # #
###############################################################################
