###############################################################################
# #       #     #     # # #   #   # # # # # #   #         #       #   #       #
# # # ### # # ### ##### # # ### ### # # # # # # # ### # # ####### ### # ##### #
#   # #   # #   # #   #   # # #       #       #     # # # #       #   # #     #
# # # ##### ##### # ### ### # # ### ### # ### ### ### # ### # # ### ######### #
# # # #   #     # #           #   # #   #   #   #   # #   # # # #           # #
##### ### # ##### ### ### # # # ##### ######### # # # ##### ####### ### # ### #
# # # #   # # #     # #   # # #         # # #   # # #   #   # # #     # # #   #
# # # # ### # # ######### # # ### ####### # # ##### # ##### # # # ##### ##### #
#       # #   #   # # #   # #     #       # #   #   #       #   #   #   #   # #
##### ### # ##### # # ### ### ### # ####### ### # ####### ### ##### ####### # #
# # #       #   #       # #     #           #   #       #     #     #   #   # #
# # ### ##### ### ### ### ### ### ##### # ##### # ######### ### # ##### # # # #
# # #               #   # #     #     # #   #   #   #   #   #   #     #   # # #
# # ##### # ### ########### ####### # ####### ######### ##### # # ######### # #
# #       #   # #           #   # # # #   #   #       #       # # #           #
# # ############# ######### # ### ### # ####### # ####### ##### ### ### #######
# #   #     #   #         # #       #   #     # #       #   #       # # #     #
# # ### ##### # # ####### # # # # # ######### # ####### # # ####### # ### ### #
#   #   #     # #     #   #   # # #   #         # #   # # #   # # # # #   # # #
# # # ####### ### # # # ##### ### ##### ######### # ### # ### # # # # # ### # #
# #               # # # #       #                   #       #     #       #   #
###############################################################################
