###############################################################################
# #   #   #     #   # # # #   # # #   #             #         #     #   # #   #
# ### # # ### ##### # # # # ### # # ##### ########### ####### ### ### ### # ###
#   # # # #     # # #   #           #       #       # #   #   # # #         # #
### # ### ##### # # # ####### ####### ##### # ### ####### # ### # ### # # # # #
#           #                       # #       #   # #     # #   # #   # # # # #
##### ### ######### ######### ##### ##### ######### # ##### # ### # ####### # #
#       #   # #       #         #   #     #   #   #       #     #         #   #
########### # ####### ### ### # ######### # ##### ### ##### ### # ########### #
# #       #         # #   #   #   #                 # # #   # # #         # # #
# ### ### ######### ### ### ### ######### ######### # # ### # # # ### ### # # #
#       #             # #     #     # # #   #   #         #   #     #   #   # #
### ### ######### # ############# ### # # # # ### ######### # ### # # #########
# # #   #         #   #   #   #     #     # #   #           # #   # #       # #
# ##### # ### # ##### ### # # ##### ### ##### ######### # ### ### ### ####### #
#       # #   # # #         #   # #             #     # #   #   #   #       # #
# ### ##### # ### ##### ##### ### ### ####### ### ### # ######### # ######### #
# #   #     # #   #     # # #               #   #   # #   #   #   #   # # #   #
### ########### ##### # # # ##### ### ######### ### ##### # ##### # ### # # ###
# # # #   #   #     # # # # #     #     # #   #         #     #   # #     #   #
# # # # # # # ##### ### # # ### # ### ### # ### ### ####### # ### # ##### ### #
#   #   #   #           #       #   # #           #     #   # #   #           #
###############################################################################
