###############################################################################
# #   #       #     #       # # #     # #   #             #   # # #           #
# ### ### ### # ##### ####### # # ### # ### ####### # # # ### # # ### ### ### #
#       # # #             #   #   #     #   #       # # #         # #   # #   #
##### ### # ######### ### ### # ### ### # # ####### ##### ##### ### # # ##### #
#   #   #   #       #   #   #   # # #     #     #   #     #           # #   # #
# # ### # ### ### ##### # ####### ############# # # ######### # # ##### # ### #
# #   # # #   #         #         # #             # # #       # #   #   #   # #
### # # ####### # ######### ##### # # ####### ##### # ### ####### ####### #####
# # #   #     # # #   #       # #   #   # #   #   #     #     #               #
# # ### ##### ### # # ######### ### ##### # ### ####### ######### ####### ### #
#     #       # # # #           #             # # # #       #         #     # #
######### ### # ### # ####### # ####### ####### # # # ######### ### ##### # ###
#   # #   # #       # #       #         # #     #         # #   #       # #   #
# # # # ### # # ### ### # ### ########### # ### ##### # ### ####### # ### ### #
# # # #   #   # #   #   # #   #             #     #   #   # #   #   #   #   # #
# # # ### ##### ### ######### ########### # # ### ### ### # # ### ### # # ### #
# #       #       # # #     #   #     #   # # #   #   #     # # # #   # # #   #
# ############### ### # ### ######### ####### ### # # # ##### # ### # ### ### #
# # #   # #   #       # # #     #             #     # # # #   #   # #   #   # #
# # ### # # # ### ####### ### ##### ######### ### # # # # # # # ##### # ##### #
# #         #         #               #       #   # # # #   #         #     # #
###############################################################################
