###############################################################################
# #     # # # #         #                       #   #   #   # #             # #
# ##### # # # ### ### # # ####### ##### ######### ##### # ### ##### ####### # #
# #     #   #     # # # # #       #   #     #                   #   #     # # #
# ##### # ### ### # # # # ########### # ##### ####### ### ####### ### ### ### #
#     # # #     #   # #   #     #   #     #       #     #   # #       # #   # #
##### # # ####### ### # # # ### ### # ### # ################# # ####### ### # #
# #     # #     # #   # # # #         #   #   #     #     #   #   # # #     # #
# # ### # # # # ### ##### ####### # # ### ### ### ### # ### ##### # # ### ### #
#   #       # #     #     #     # # #   #   #   #   # #     #   #   # # # #   #
# ######### # ##### # # # ### # ### ### ##### # # # # ### ### ### ### # ### ###
# #   #     # #   # # # # # # #     #         #   #     #       # #     #     #
### # ##### ### # ######### ##### # # # # # ######### ######### # # ##### #####
#   #     # #   #   #   #   #     # # # # #         #         # #   # #     # #
# # ### # # # ### ##### # ############# # ######### ##### ####### ### ### ### #
# # #   #   # # # # # # #               #     #   #   # #       #     #   #   #
# ### ####### # # # # # ### ### # # # ##### # ### ##### # # # ### ### # ### ###
#   # #       # # # #       #   # # #     # #           # # #       #   #     #
### # ##### # # # # ########### # # ### ######### ##################### ##### #
#   # #     #   #       #       # #   #   #     # #               # #   # #   #
# ### ### ############# ### ### ####### ### ### # # ##### ######### # ### # # #
# #     # #                 #         #     #   #       #         #         # #
###############################################################################
