###############################################################################
#   #   # # #       #             # #                     #     #   #     #   #
# ##### # # ### ### # ######### ### # ##### ### ### # ####### # # # ##### # ###
#       # #     # #   # #     #       # #     # #   #       # # # # # #   # # #
# ##### # ####### # ### # ### ######### ##### ##### ### ### ### # ### # # # # #
# #       #           #   # #       # # #       # # #   #   #   #   #   # #   #
######### ##### ### # # ### ### ##### # # ### ### ### ####### # # ####### ### #
# #     #     #   # #         # #       # #       # # # #   # # #   #   #   # #
# # ### # ### ####### # ######### # ####### ##### # # # ### # ### ##### # ### #
#   #     # #         #           #       # #       # #   #   # #       # #   #
# ######### ####### # ### ################### ######### # # ### ### # ### # ###
# #         #     # # #     #       #     #     # # #   # #     #   # # #     #
# ####### ### ### # # # # ### ########### # ### # # # ##### ##### # ### # ### #
#     #       #     # # #     #           #   #   #       #     # # #     # # #
### ############# # ##### ##### ################### ######### # # ### ##### # #
#   # #           #     #       # # #   #       # #     # # # #   # # #   #   #
##### # # ##### # ##### ### ### # # # ### ##### # # ##### # # ### # ##### ### #
#   #   #   # # # # #     #   # #   #   #     # # #   # #   # #   #         # #
### # ### # # # # # # ### ####### ##### ##### ### # # # # # # ### # ### # # # #
# #   # # # # # #   #   #     #       # #       #   # #   #     # # #   # #   #
# ##### ##### # ### # ##### ### ####### ### # # ### # # # ####### # ##### ### #
#               #   # #                     # #     #   #     #       #     # #
###############################################################################
