###############################################################################
# #   # #           #         #           #     #   #     #   #         # #   #
# # # # ### # ####### ####### # # ######### ### # # # ####### ##### # # # # ###
#   #   #   # # #         # #   #   #   # # #     # #   #     #   # # # # #   #
# ### ##### ### # ######### # # ##### # # ##### ####### ### ##### ### ### # ###
# #   #   # #   #           # #       # #   #   # #       #     #   #   #     #
### ### ### # ##### ######### # ########### # ### # ######### # ### ### # ### #
#   #     # #       # #   # # #     #     # # #   #     #   # # #         #   #
### # ##### ####### # # # # ####### ##### # # # ### ### # ### ### ####### #####
#   # #     #         # # #   #   #   #   # #     #   # # # # #       #   #   #
# # # # ### # # ####### ##### # ##### # ### ##### # ##### # # # ########### ###
# #     # # # # #   #       #       #     #     #       # #   #     # #       #
# ### # # ##### # ### # # ### ### ### ### # # # ### ##### ### # ##### # ### ###
# # # #     # #   # # # #   # #     #   # # # # #         # # # # # # # #   # #
# # ##### ### # ### ### ### # # ######### # # ### ######### # # # # # # # ### #
#   #       # # #       # #   #   #   # # # #   #   #       #       #   # #   #
# ####### ### # ### ##### ### ### # # # ####### ### # ####### ######### # # ###
# #             #         #   #     #           #   # #   # #   #   #   #     #
# ### ### ####### ### ### # ####### ######### # ### # # # # # ##### ### ##### #
# #   #     #       #   # # #     # #     #   # #     # # # # #       # #   # #
# # ####### ### ####### ##### # ####### ### ### # ### ### # # # ##### # # ### #
# #   #               #       #         #   #     #                 #     #   #
###############################################################################
