###############################################################################
#   # #     #   #       #                 #   #             #     # #         #
# ### ### # # ### ##### ####### # # ##### ### ##### ##### # ### ### # ####### #
#         # #     # # #         # #   # # # # # #   #   # #       #   #     # #
######### ######### # ######### # # ### # # # # ### # ######### # # # # # # ###
#   # #       # # #       # #   # # #       #     #       # # # #   #   # #   #
# ### # # # # # # ####### # # ### ### # # ####### # ### # # # # # ####### # ###
# # # # # # #   #   # #     # #     # # #   #       # # #     # #       # #   #
# # # ##### ####### # ### ########### ##### ####### # ######### ### ##### # ###
# #         #   #     # # # #     #     #                   #   # # # #   #   #
# ##### # # ### # ##### # # ### # ######### ####### ##### # # ### ### # ##### #
#   #   # #   #       # # # # # # # # #   # #       #   # # # #       #     # #
# # # ####### ##### # # # # # # ### # ### ### # ### # ### # ### ############# #
# #   #           # # # # #     #   #         # #       # #   #       #   #   #
####### # ####### # ### # # ### ### # ### # # ### ### # ##### # ### # # # #####
#   #   # #   #   #   #     #     #   #   # #   #   # # # # # #   # #   #   # #
# # # ### ### # # ### ##### ##### ####### ### # # ### # # # ### ### # ### # # #
# # #   # #   # #             #     # #   #   # # #   #     #     # # # # #   #
# ##### # ### # ############### ### # ### # ### # # # # # # # ######### # #####
# #     # #     # # #   #   #   #   #   # #   # # # # # # #           #   #   #
# ############### # # # # # # ### ##### ##### ##### # ### # # ### ########### #
#                     #   #   #               #     # #   # #   #             #
###############################################################################
