###############################################################################
#     #     #                     #             #           #           #     #
# ### # ### # ### ### # # ##### # ############# # ####### # # # ######### ### #
#   # # # # #   # # # # # #     #       #             # # #   #             # #
# # ##### # ### ### # ### ### # ### # # ### ##### ### # # ### # ### ##### #####
# #   # # #     # #     # #   #   # # #       #   #     # #   #   # #       # #
# ##### # # # ### ##### # ####### ########### ##### # ### # ### ##### # # ### #
#       # # # #         #   #     #       #   #     #   # # #       # # #   # #
### # # # ### # ##### # ############### # # # # # ##### ### ##### # ### # # # #
#   # # #     #   #   # #     #         # # # # # #       # #   # #   # # #   #
# # # ##### ##### # ### # ### # ##### # # ### ### # ### # # # # ### ##### #####
# # # #         # # # # # # #   #     # #       # # #   # #   #   #   #       #
### ########### ##### # # # # ########### ##### # # ### ### ########### # # # #
#               #       #   # # #         #     # # #     # #       #   # # # #
# ##### ####### # ######### ### ######### # ### ### # ### # ### ##### #########
#     # #       # #       # #       #   # # #   #   #   # #         #         #
### # ####### ### # ##### ####### ##### # # # ##### ### ### ### ####### ##### #
#   # #     # #   # #         #     #     # # #       #   # #         # #     #
# ### # # # # # ### ######### ##### # ####### ##### # # ### # # ### ### # # # #
# #   # # # # # #   #       # #       #     # #     # # # # # # # # # # # # # #
### ### ### # # ##### ### # # ######### ### # ### # ##### ##### # ### # # #####
#   #     #   #     #   # #               #     # # #               #   #     #
###############################################################################
