###############################################################################
# #       # #       #         # #   #     #   #           #   #         #   # #
# ##### # # ##### # ### ####### ### ### ### ### ####### # ### ### # ##### # # #
#       #     # # #   # # #   #   #     # #     #       # #   #   #       # # #
##### ####### # # ### # # ### ### ### ### # ####### ### ### ### ### ##### # # #
#     #     #   # #   # #         # # #     #     #   #         # #   #   # # #
# ######### # ####### # ##### ##### # # ####### ### # ########### ### ##### # #
# #       #       # # #     #           #     # #   # #             #   #   # #
####### ####### ### # # ### # ############# # # ### # # ##### ### # ### # # # #
#   #     #   # #   # # # #       #     # # # # # # # #     #   # # #   # #   #
# ### # # ### # ### # ### ### ##### ##### ### # # ### ##### ### ### ##### #####
#     # #   # #   #     #               #   #       # #   # # #   #   # #     #
# ####### ### ### ##### # # ############# ### # ### ##### # # ### ##### # #####
#   #   #           #     #       # # # #     #   #     #       #       #   # #
# ### # ##### # ### ##### # ####### # # # # ### ####### ### ############### # #
# #   #     # # #         #   #         # #   #       #     # #   #       # # #
######### ##### ### ### # # # # ### ### ### ########### ##### # # # ######### #
# # # #   #   # #   #   # # #     #   #       # # #   #         #   #   #     #
# # # # # # # # ### # # ##### ##### ######### # # # # ### ### ####### # # ### #
#   #   #   # # # # # # #         #   # #   #     # # # # #   #     # #   # # #
### # ##### # # # # ############# # # # # ##### ### # # # # ### # ### # ### # #
#         # #     # #             # #         #     # #   #     #     #     # #
###############################################################################
