###############################################################################
#     #     #                 #   #     # #   # # #           #     # #     # #
# ### ##### # ####### ##### # # # # ##### # ### # # ########### # # # ### # # #
#   #   #   # # #   # #     # # # # # # # #       # #   #   #   # #   #   # # #
### ##### # # # ### ### # # # ### # # # # ### ##### # ##### # ########### # # #
#   #   # #   # #       # # # #   #   #   # # # #   #       # # #     #   # # #
# ##### # ##### # ####### ### # # # # ### # # # # ### ##### # # # ##### ### # #
#     #   #       #       #   # #   #     #           #   #   #     # # #   # #
##### ##### # # ### ######### ### ### ### # # ######### ##### # ##### ##### # #
# # #     # # # #   #   #         #   #     #   #   #   #   # #     # #   # # #
# # ### ### ####### # ######### ####### ### ##### ##### # # ####### # # ### # #
# #   # #     #     #         # #     # #     #       # # #   #   #   #     # #
# # # # ######### # ####### # ####### ### # ##### ##### # ##### ### ##### ### #
# # # #   #       #   #     #           # #   #   # # # #   # #     # #   #   #
# # ### # ####### ### ################# ### ### # # # # # ### # ##### # ### ###
# #     #     # # #     #         #   #   # #   # # #           # #   #   #   #
# ########### # ### ##### ### ### ### ### # # ##### # ########### # ### ### # #
#     #     #       # #   #   #           #   #     #             # #       # #
### # # ### ####### # # ### # ########### ### # ##### ############# # # #######
#   # # # #   #     #   # # # #       #             #         # # # # #   #   #
# ### # # ### ##### # ### ####### ### ##### # # ####### # ### # # # # ####### #
#   #     #         #       #     #         # #         #   #                 #
###############################################################################
