###############################################################################
# #   # #   #                 #     # # # #   #     #   #   #       #   #   # #
# # ### ### ##### ##### # # # # ##### # # ### ### ### # # # # # # ### # ### # #
#       #     # # #   # # # #   #         #     #     #   # # # # #   #   # # #
# # # ### ### # ##### # # # ##### ### ### ##### # ##### ### ### # # ##### # # #
# # #   #   #   # #   # # # #     # # # #   #   # #     #   #   # # #   #     #
# ##### ### ##### # # # # ##### ### # # # ### ########### ### ### # # # # # ###
# #   # #   #   # # #   #       #   # # #     #       #   # #   #   # #   #   #
# # # # # ### ### # # ### ####### ### # ### # # ##### # ### # ####### # ##### #
# # #     #     #   #   # #   #     #   #   #     # #             #   #     # #
####### ##### ### ### # ### ####### ### ### # ##### ####################### # #
#   #             #   # #             # # # #   #     #     #   #           # #
# ####### # ### ####### # ### ### ### ### # ### # ##### ### # ### ##### # ### #
#   #     #   #       #   #     # #   #   #   # #   #     #   #     # # # #   #
# ##### # ### # ### # ### ### # ####### ### ####### # ####### ### ### # # #####
# #     # #   #   # # #     # #         # #     #   #     # # # #     # # #   #
# ##### # ### ### ### ########### ### # # ##### # ### ### # # # ####### # ### #
#       # #   #     #     #   #   #   # # # #     #   #   #   # #   #   # #   #
# # ####### ### ########### ### ### ### # # ####### ### ### ### ### # ### # # #
# # #   #   #                 #   #   #         #     # # #   #   # #   #   # #
# # ### # ################### # ##### # # ### # # ####### # # # # # ### # ### #
# # #                     #   #   #   # # #   #         #   #   #     # # #   #
###############################################################################
