###############################################################################
# # #   #     # # #   #         #       #       #           # # #   #         #
# # ### ##### # # ### ### ### # # ####### ################# # # # ### #########
# #         # #     #   #   # #   #         #   # #       #     #     #   #   #
# ### ####### ##### # ##### ####### ####### # ### # ##### # # ##### ### ### ###
#   # # # # #       # #             #     #   # # #   #     #   # #   #     # #
# # # # # # ####### # ### # ### ##### ####### # # ### # ######### ### # ##### #
# # #   # #       # #   # #   # #   #     # #         #     #       #   #   # #
### ### # ####### # # ##### ##### # ### ### ######### ##### # ##### ### ### # #
# #   # # # #           # # #     #   # # #     #   # #   # #     #     #   # #
# ### # # # # ### ##### # # ### ### ### # ### # # # # # ### # # # ##### # ### #
#       # #     # # # # #     #   #   # #     # # #       # # # #   #         #
##### # # # ####### # ####### # ##### # ### ############### # ####### ####### #
#   # #   #       #   #       # # # #     # # #   # # #   #     #   #     # # #
# # ##### ### # ### ####### ### # # ####### # ### # # # ####### ### # ##### ###
# #         # #   #   #     #         # #   # #       # #     # #   # #   #   #
# # ### ##### ####### ##### # ### # ### ### # # ####### # ##### # # # ### # # #
# # #   # # # #       # # # #   # # #   # # # # #       #   #     # #   #   # #
# ##### # # # # ####### # # # # # # # # # # # # # ### ### ####### ### ### ### #
#   #   #   # # #   #         # # # # # #   # #   #         #   # # # #     # #
# ### # # # # # ### ### ##### # ##### # # ### ##### ### ##### ### # ### ##### #
# #   #   #                 # #       #               #       #         #     #
###############################################################################
