###############################################################################
#   #     #   # #   #   #     #           # #               #   #   #         #
# ##### ##### # # ### # # # # # ######### # ####### # # ### # ### # # ####### #
# #     #     # #     #   # # # # # #     #   #     # # #         #         # #
# # ### ##### # ########### ### # # ### # # ##### ### # ### # # # # # ### ### #
#     #     # #   #         #   #   #   # #   #   #   # #   # # # # #   #   # #
### ### ### # # ##### ##### ####### ### # # # # ### # # # ### # # ### ####### #
#   # # #             #           #   # #   #   #   # # # #   # #   #   #     #
# ### ##### # ### # # # ######### ### # # ############### ### ### # ######### #
# #   #   # #   # # # # #   #   #   #   #   #             #   #   # #       # #
### ##### ### ####### # # ### # ### ### # # # ### # # ### ######### # #########
# #           #   #   # # #   #   #     # # #   # # # #     #               # #
# # ### ##### # # ####### # ##### # # ### # # # # ### # # # ####### ####### # #
#     # #     # #     # # #   #   # # # # # # # #   # # # # #     #   # #   # #
# ########### ##### # # # ##### # # ### # ### # ### ######### # # # ### # # # #
# #       # # # #   #           #     #     # # #   # #     # # #     #   # # #
# ####### # ### # ####### ##### ### # ##### # ### # # ##### # # # # # ##### # #
#     #   #   #   #         #   #   #     # #   # # #         # # # # #     # #
### ### ### # ####### ### ####### # ### # ############# ####### # ##### ### # #
#   #   #   # #       # #   #   # #   # #     #         # #     #   #   #     #
# ### ### ### # # ##### ####### ##### # ### ##### # ##### # ### # ####### ### #
# #         #   #         #           #   # #     #   #     #   # #         # #
###############################################################################
