###############################################################################
#   #     # #         #       #     # #   #   #   #   # #   #       #   #     #
# ### ##### ##### # ### # # # # ##### # ##### ### ### # ### # # # # ### # #####
# #     #         #     # # # #     #   #   # #   # #     #   # # # # #     # #
# # ##### ### ########### ### ##### ### ### # # # # ### ##### ### ### # ##### #
#     #     # #     #   # #     # # #     #   # #         # # #   # # # # #   #
# ### ##### ##### # # # ####### # # # ### ### ##### ##### # ### ### # # # # # #
#   # # # #     # # # # #   # #   # # #   #   #   #   # # # # #   #     # # # #
##### # # ##### # # ### # ### ### # ### # ### # # ### # # # # # # ### ### # ###
# #         # #   #   #     #   #   # # #       # #   #   #   # #       #     #
# # # ####### ####### ##### # # # ### # ####### ##### ### ### # ### ### ##### #
#   #       #         #   #   #     # # #   # #     # #         # #   #       #
# ##### ### # ### ##### ####### ### # ### ### ##### ####### ##### ##### ##### #
#   #     # # # # #   #   # #   #   # #   #   # #   # #     #   #     # #     #
# ### ### # ### ##### ### # ##### ### ### # # # # # # ##### ### # ######### # #
#   # #   # #   # #       # #           # # #     # #   #           #   #   # #
### ##### # # # # ##### # # ####### # ### ####### ##### # # # ####### #########
#   #     # # # #       #     #   # #   # # # #   #     # # #     #   #     # #
# ### ##### ### ############# ### # ### # # # ### ##### ### ##### # # # # ### #
# # #     #     #   #   #           #     #         # #   # # # # # #   #     #
### ### ##### ### # ### # # ##### # ##### ######### # ### # # # ### # #########
#           #     #       #   #   #     #                           #         #
###############################################################################
