###############################################################################
#     #             #       #     # #   #       # # #           # #           #
# # # # # ### ######### # # # # ### ### ### # ### # ######### # # ######### ###
# # # # # #     #       # # # # # # #   # # #   #     # #     #     #   #     #
# # ##### ##### # # ### ### # ### # # ### ##### # ##### ### # # ### # ### ### #
# #     #     #   # #   # #       # #       #     # #   #   # #   # #   #   # #
# ### # ### ##### # # ### ### # ### # # ##### ##### ### # ####### # # ####### #
# # # #   # #     # # #       # # # # # #   # #   #   #       # # #   #     # #
# # ##### # # ####### # ### # # # # ### # ### ### # ### ####### # ##### ##### #
# #     # # # #     # #   # # # # #     #       #   # # #       # #       # # #
# ### ### # # ##### ##### # # ### ##### ### ##### ### # ### ##### # ####### # #
# # # #   # # #   #       # #   # #     #     # # #   #         #   #         #
# # # ### ### ### # # ##### ##### ### ####### # # ### # ### ################# #
# # #       # #     #     #   #     #   #   # # #   #   #                 #   #
# # ##### # ##### # ### # ### ### ##### ### # # # ### # ################### # #
#       # #     # # #   #   #         # # #   # #     #       #   # # #     # #
####### ####### # # # ### ##### # # ### # # # # # # ### # ##### ### # # # ### #
#       #       # # # # # #   # # # #     # # #   #   # # #             #   # #
# ####### ##### ### # # # ### # ### ##### ### # ### ### ### ###################
# #         #       # #     # # #                 # # #         # #       #   #
# ### ### ################### ##### ### ##### ### ### ### ### # # # ####### # #
# #   #   #                         #   #       #       #   # #             # #
###############################################################################
