###############################################################################
# #   #       #                     #           # #   # #           #     #   #
# # # # # ##### ### ### ####### ##### ########### ### # # ######### # ### ### #
#   #   #   #     # # # # # # # #     #       #   # # #   # #   #     #     # #
### ##### ####### ### ### # # ### ##### ##### ### # # # # # # # ############# #
#     # # # #             # #   #     # # #     # #     # #   # #   #         #
##### # ### ### ########### # # # ### # # ##### # # # ##### ### # # # ### #####
# # # #           # #       # #     #       #   #   #   #   #     # # #       #
# # # # ### # ##### # ####### # ### ########### # # ####### ####### # ##### # #
#   # #   # # # #   #         #   #         #     #       # #   #   #   # # # #
# ### # ####### ### # # ##### ### # ### # ### # ### ##### # # # ### ##### ### #
#     # # #     # #   # #     # # #   # #   # #   #     # # # #   # #     #   #
### ### # # ##### # ### # ##### ########### ##### ####### # ### # ####### ### #
# # #   # #     #   #   # # #   #       # #   #   #   #   #   # # #   #   #   #
# # # ### # ##### # ####### # # # ### ### ### ##### # # ### ##### ### ### ### #
# # #         #   #           # # # #     #   #   # # #   #             #   # #
# # ### # # ### ##### ### # ### # # ########### ##### # ##### # ####### # # # #
#       # #     #   #   # # # #         # #     # #   #       #   #   #   #   #
### ####### ### # ####### ### ### ### # # # ##### ### ######### ### ######### #
#         # #           #     #   #   # # # #       #         # #   #     #   #
# # # ######### ##### # # ####### # ### # # ### ##### ####### # # ### ### # ###
# # #       #       # # # #       #   #                   #   #       #   #   #
###############################################################################
