###############################################################################
# #   #         #   #             #                 #         #               #
# # ### ### ##### ##### ##### ### ##### ##### ### # ### # ### ### # # # ### # #
# #   #   #   # # #     #       #       #     #   #     #   # #   # # # # # # #
# # ##### ### # # ##### ########### ##### ####### ####### ##### # # # ### ### #
#           #   # #       #   #   #     # #   # #     # #   #   # # # #   #   #
### ##### ##### # ### # # # ### # ####### ### # ##### # # # # ### ##### # #####
#   # #   #     #     # # #   # #   # #   #     #   # # # # # #     #   #   # #
# # # ####### # ####### # ### ### ### ####### # # ### # # ### ### ### ####### #
# # #   # # # #         #     #   #     #     # #   # # #     # # # #       # #
##### # # # ### ### ####### ##### ##### ### # ##### # # ####### # # ### ##### #
#     #     #   #   #   #   #   #           #     # # # # #     #   # # # # # #
####### ### ####### # # # ### # ##### # ### ##### # # # # ##### ##### # # # # #
# #     #   #   #     # # #   # #     # #     #   # #     #     #       # #   #
# # ##### # # ### ##### ####### ####### # ### # # # # ### # ##### ####### ### #
#   # #   #   #   #       # #           #   # # #     #         # #     #   # #
# ### ### ######### ##### # ################### # ##### ##### ### # ##### ### #
# #   #     #     # #       #     #     #       # #         # # #   #       # #
# ### # ### ##### # # # ######### # ### # ##### ##### ### ##### ### # ##### # #
#   #     #       # # #       # #     # # #     #     #     #   # # # # # #   #
# ####### ### ##### ### ### ### # ### # ######### ##### ### ### # # # # # # # #
#       #   #       #   #       # #   #           #     #               #   # #
###############################################################################
