###############################################################################
#         #           #   #     #   #       # #   #         #     #           #
# ### ### # ######### # ### ### # ##### # # # # # ####### ### ##### ######### #
#   # # # #     #   # # #     #     #   # # #   #           #       # #     # #
# ### # ##### ### # # # ##### ####### ##### ####### ######### # ### # ##### ###
# #           #   #     #         #     #   #     #       #   #   #           #
# # # # ####### ##### ########### # ##### ### ### ### ### # ############# ### #
# # # #   #   #     #   #   #       # #       # #   # # # # #       # # # #   #
# # ##### # # ##### ### # ### ### ### ### ##### # ### # # # # ####### # ### ###
# #   #   # #   # #   # #   # # #   #     # #         #     # # # # # #   # # #
####### # ### # # ##### # ##### # ######### ##### ####### # # # # # # ### ### #
#   #   # # # # #     #           # #             # #     # #       #     # # #
# # ####### ### ##### ############# ### # # # ##### ##### ##### ##### ##### # #
# #         #   #     #     #   #     # # # # #       #         #   #   #   # #
##### ##### # # ### # # # # # ##### ##### # ### # ### # ### # ### # ### # ### #
#         #   #   # #   # #   #   #   #   #   # #   # #   # #     # #   #     #
####### # # ##### # ######### # # # # # ### ### ### ##### # ##### # # ### ### #
#     # # #   # #   #       # # #   # # # # #   # #       # #   # #       # # #
### # ### ### # ##### # # ### # # ### # # ####### # ######### ### # ####### # #
#   #   #   # #     # # #   #   # #   #   # #         #   # #     #       #   #
# ######### # # # # ### ### ##### ### # ### ##### ### # # # ##### ####### # ###
#           # # # #       #         #   #           #   # #         #     #   #
###############################################################################
