###############################################################################
#   #     # # # #   # # #     # #         #       #         #     #   #   #   #
# # ### ### # # ### # # ### ### # ##### ######### ######### # ####### # ### # #
# #                 #       #   # #   # #   #     # #   #   #   #   #   #   # #
# # ##### ######### ##### # # ### # # ### ### ##### ### # ### ##### # ### ### #
# #   #       # #   #     # #       # # #   #         # # # # #   # # #     # #
# ### ##### ### # # ### # # # ### ##### # # # ####### # # # # # ### # # ##### #
# # # #   #   #   #     # #     # # # #   #     #     # #     #   # #   #   # #
# # ##### # ##### ##### ### # ##### # # ### ### ####### # # ### ### ### ### # #
# #     #   #     #   # #   #             #   # #       # # #   #         # # #
####### # # # ####### # ### ### # # ############# ######### # ### # ### ### # #
#     #   # #     #     #   #   # #           #   #         #     # #       # #
# # ######### ### # # ### ##### # # # ### ##### ### ############### ### ##### #
# #     #     #   # # #       # # # #   #       #   #   #             # #   # #
# # ### # # # ##### # ### # ####### # ########### ### # ### # # ### # # # # ###
# # # #   # #     # # # # #   #     #     #       #   #   # # # # # # #   #   #
# ### # ### ##### ### # ####### # ### ### ##### # # # # # ##### # # # #########
# # # # #   #   # #   #         # #     #   #   #   # # # #     #   # #   #   #
# # # ### ### ### # ########### # ##### ### # ####### # # # ##### ### # ##### #
#   #       #   # #     #       # #   # # #   #     # # # #   #   #   #   # # #
##### ### ##### # ######### ##### # # ### # ##### # # ############# ### # # # #
#     #   #       #         #       #     #     # #                     #     #
###############################################################################
