###############################################################################
#     # #       # #   #     #   #     #         # # #   #   #   #             #
# ### # ##### # # # # ### ### # ### ##### # ### # # # # # ##### # ####### ### #
#   # #   #   #   # # #       #           # #   #   # # # #             # #   #
# # ##### ##### ### ##### ####### ##### ####### # ### ### ### # ########### ###
# #   # #     #   #     # #       #     # #     #             #     # # #     #
# ### # ##### # # ##### # # ######### # # # ### # # ##### ### # # # # # # # ###
# # #   #       #         #     # #   #   # #     # #       # # # #   # # #   #
# # # # # # # ### ########### # # # ######### # # # ####### # ### # # # # #####
# # # # # # #   # #     #     # #   #       # # # #   #     # #   # #   # # # #
# # # # # ##### ####### # ########### # # # ####### # ### # ##### # # # ### # #
# # # #   #     #   #     #   #     # # # # #       # #   #   # # # # #   #   #
# # ### ### ### # # ##### # # ##### # ### # # ##### ### ##### # ############# #
#   #   # # # #   # #   # # #         #   #   #       # #   #                 #
######### ### ######### ### ############### ##### ##### # ##### # ### ### ### #
#         #             #   # # #           #         #   #   # # # # # #   # #
# # # ### ####### # ##### # # # ### ####### ### ##### ####### # ### # # ### # #
# # # # #     #   # # #   #   #   #   #     #       # # #   #       # #   # # #
### # # ##### ### # # ### # ##### ### ### # # # ##### # # # ### ##### # # ### #
#   # #       #   #   #   #   #     # # # # # # #         #   #     #   #   # #
# ########### # # ##### ##### # ### ### ######### # ####### ########### ##### #
#     #         #           # # #                 # #       #             #   #
###############################################################################
