###############################################################################
#     #     #           #     #   #   #   # #   #             #   #           #
# ### # ##### ######### # ####### # ##### # ### ##### ### # # # # ### ####### #
# # #       # # #       #       # # # # # #           # # # #   # #   #       #
# # ### ####### # ### ######### # # # # # ####### # ### ### ### # # # ####### #
# # #     #   # # #   #           # # #   #       # #       #   #   # #       #
### # ####### # ### ########### ### # # ######################### ### # ### # #
# # #       # #   #   #   #           #           # #             #   # #   # #
# # # ##### # ### ### ### # ##### ############# # # ##### # # ### ####### ### #
# # #     #     #         # #   # #       #   # #       # # # # #     #   #   #
# # ### # ### # # ##### # # # ### ####### # # ### ##### ##### # # ### # ### # #
# #     # #   #   #     #   # #   #     #   #       #       #   # #   # # # # #
# # ########### ### ### ##### # # ### ### # ##### ### # ### ### # ### ### # # #
#   # #         # # # # #       # #       # #     #   #   #     #   # #     # #
# ### # ##### ### # # # ### ### # ### ##### ######### # # ####### # ### ### ###
#   #   # #     #     # #   #   #   # #     # #       # # # #     #   # #     #
##### ### ########### ############# ####### # # ##### # # # ##### ##### # # # #
#     #                 #   #     #   #     # # # #   # # # #       #   # # # #
# ############### # ### ### ### # ### # ##### ### # # # # # # # ######### # ###
#       #   #   # #   # # #   # #     # #     #   # # # # #   # # #   #   #   #
### # ### # ### ##### # # ### # # ####### ### # # ### ########### # # # ##### #
#   # #   #           #   #     #           #   #       #           #       # #
###############################################################################
