###############################################################################
#       #     #           #   #           # #   #     #   #             # #   #
### ####### # # # # ####### # # ### ##### # # ### ##### # # # ########### # # #
#         # #   # #     #   # #   # # #   #   #         # # #   #     #   # # #
# ########### ### ####### ### ### ### # ### # # ######### ### # # # ### ##### #
# #         #   #       #   #   # #   #   # #   #   # # #   # #   #     #   # #
# # ####### ### ##### ##### ### ### # # ### # ### # # # ####### ######### # # #
#       # #     # # #         # #   # #   # #     #       #     #         #   #
# ####### ##### # # # ####### # # ##### ### ######### ### # ##### # ##### # ###
#       # #   #     #   #     # # #   # #         #   #   #       #   #   #   #
# ### # # # ### ### ### ### ### # # # # # ### ##### ##### # ### ### ### ### # #
#   # # #   #   # #   #   #   #     #   # # #     #   #   #   #   # #     # # #
# ### ### # ##### ####### # # ########### # ##### ### # ##### ############### #
# #   #   #       #     # # #                   #   # #         #       # # # #
### # ### ####### # ### # ############### # ########### ####### # ####### # # #
#   #         #     # # #   # # # #       #       # #   #     # #     #   #   #
# # ##### ### # # # # # ##### # # # ########### ### # # # ### # ### ##### ### #
# #   #   # # # # #   #   # #     #   # #   #   #   # # # #   #           # # #
# ### ### # # ### ####### # # ####### # ### ##### ### ##### # ### ######### ###
# #   #   #     #   # # #   #   #         #   #   #   #     #   #         # # #
# # ######### ##### # # # # ### # ######### ##### ### ##### # ##### ##### # # #
# #         #   #       # #     #                 #       # #         #       #
###############################################################################
