###############################################################################
#         #     #   #           #   #               # #   #             #     #
# ### ####### # # ##### ####### ### # ### ########### # # # # ##### ##### # # #
# # # #       # # #     # #     #       # #   #     # # #   # #   #       # # #
# # # ### ### # # # ##### ##### # ##### ### ### ##### # ##### # ########### # #
# #     # #   # #   #   # #   #   #     # #   # # #   #   # #         #   # # #
# ### ### # ##### ### # # # # ####### # # # ### # ### # ### ######### # ##### #
# # # #   #       #   # #   #         #   # # # # # # #   #     # #     #     #
# # # # ### ### ### # ##### ##### ####### # # # # # # ### ### ### # # #########
#   #   # # # #     # #   # # #   #         #   # # # #     # #   # # #       #
# ####### # # ######### ##### ##### ####### # ### # # ### # # # ######### ### #
# #           #       #   # #   #   #   #   #     #     # #         # # # #   #
# # # ######### ##### ### # ### ##### # ### ### # ### # # ########### # ### ###
# # #   # #   # #       # #   #       # #       #     # # #   # #         #   #
# # # # # ### ### ### # # # # ######### ### ########### # # # # # # ######### #
# # # # #   #     # # #   # #       # #   # # # # #   #   # #     #         # #
##### ##### ### ### ##### # ####### # ### # # # # # ### ### ############# ### #
#   #     #   # #   # # # # #     #       #     #   # # # #     # #   #   #   #
### ####### # ### # # # # ### # ######### # # ### ### ### # ##### # ######### #
# #       # #     #   #       #   #         #       #   #   #     #   #       #
# ### ### # ##### ########### ##### # ####### # ### # ### ### ####### # # #####
#       #   #                       #   #     #   #                     #     #
###############################################################################
