###############################################################################
# #             #   # #   # #                 # #   #             #     #     #
# # ##### ####### ### # ### # ####### ######### # # ##### ### ### # # ### ### #
#       #     #   #       #         #       #     #     # # #   # # #   #   # #
# # ############# # ##### # ##### ##### ### # ########### # ####### ####### # #
# #     # #     # # #   # # # # # #   # # # # #             #           # # # #
### # ### ### # # # # ### # # # # # ### # # # ##### # ##### # ### # ### # # # #
#   #       # # #     #     # #   #   # #         # # #     #   # #   #   # # #
# # # ### ### ### # ######### # ##### ### ### # # ### ### ### # # ######### ###
# # # #       #   # #       # # #   # # #   # # #   # #       # #   # #   #   #
# ### # ##### # ##### ####### ### # # # ### # # ####### ############# # ##### #
# #   #   # # #   #     #         # #     # # #       #       #     # #       #
##### # # # ##### # ##### ######### # ######### # ####### # # # ### # ### #####
#     # #   #           # #       # #     #   # # #       # #   # #   #       #
# ##### # # # ##### # ### # # ##### # ### # ##### # ####### # ### ##### # #####
# #     # # #   #   #     # #     #     #   #   #   #     # # #     #   #     #
# ### ### # # # # ############### ### # # ### ####### ### ##### # # # ####### #
#   #   # #   # #     # # #       #   # #   #   # #   # # #     # #   #     # #
# # ### ### # # ####### # # ####### ####### # # # # ### # # ##### ##### ##### #
# # #   #   # #     #           #         #   # #       # #     #     #   #   #
# # # # # ##### ##### ### ### ### ######### ### ### ##### # # # ##### ### ### #
# # # # #     #         #   #   #     #       #         #   # # #           # #
###############################################################################
