###############################################################################
#       #   #             # #   # # #           #       # #     #   #       # #
### ##### # # ##### ####### # # # # # ######### # ####### # # # # ### # ### # #
#       # #       #     #   # #   #   #   #   # #     # #   # # # #   #   #   #
# ####### # ### # ######### # ##### ### ### ##### ### # ##### # # # ##### #####
#         #   # #     #   #   #   # #     # #       # #       #   #     #     #
### # ### ######### ##### ### # # # # ##### # ##### # # ############### ### ###
#   #   # #     # #   # #   # # # #           #     # # #   #       #   # # # #
##### ##### # # # ##### ### # # # ### # # ##### ##### # # ### ####### ### # # #
# #         # #   # #   #     # #     # # #   #   # #   # # #   #     #     # #
# # ####### # ##### # ### ##### ########### # ##### ##### # ### ##### ### ### #
#     #   # #         #             #       #               #   #   #   # #   #
# # ### # # ####### ### ##### ### # # ####### ##### ######### ### ##### # # # #
# #     # #     #       # # #   # #         #     #           #       # #   # #
##### ### ##### # ####### # # ################# ######### ### # ##### # ##### #
# #     #   #   #       # #       #           #   #     #   #       # # #     #
# # # # # # ####### # ### # # ### # ######### ### ##### # ##### ##### # ##### #
#   # # # # #       # #   # #   # #         # #   #     #     #     # #     # #
##### # # ### ##### ##### ##### ##### ##### ####### # ######### ### # # # # # #
#   # # # #     # # #   # #         #     #     # # #     #     # # # # # # # #
# ##### ### ##### ### ### ### # # ### ######### # # ####### ##### # # ### ### #
#         #               #   # #           #       #             # #     #   #
###############################################################################
