###############################################################################
#               #     #           #     # #         #             #   #   #   #
##### ######### ### # ### ### ######### # # ####### # # ####### ### # ### # # #
#   #   #     #   # # # #   #       # #         #   # # #   #   #   # #     # #
# ##### ### ### # ### # # # ### ### # # ############# # # ### ### ####### ### #
#       #       #     #   #   #   # # # #   # # #   # #   #   #     #   # #   #
# ### # # # ### ####### # # ### # ### # # ### # ### # ####### ### # # ### ### #
# # # # # # #           # # #   # #     #   # #     #     # #     #   # # # # #
### ######### ##### ##### ### # # ### ##### # # # ### ### # # ######### # # ###
#   #             #   # #   # # # #   #   #     # #     #   #   #   #     #   #
# ### ####### # # # ### ########### # ### # ##### # ##### ####### ### ####### #
#     #   #   # # #     #           #     # # #   #     #   #     #           #
######### ### # # ##### # ############# ### # ######### ##### ######### #######
#   #     #   # #   #         #   #   #       # #     # #   #           # # # #
# # ##### ####### ### ##### # # ### # # ####### # ##### # ### ### # # # # # # #
# #     #           # #     #       # #   # # #               # # # # # #   # #
# ### ##### ### ##### # # ########### ##### # # ##### ### ##### ### ##### ### #
# #         #       # # #         #   #   #       # # #         #   #   #     #
############### # ##### # ### # ####### # # # ##### ##### # ### # ### ### # ###
#     #     # # # #   # #   # # #       #   # #   # #   # # #   #   #   # # # #
# ### # # ### # # # # ### # ### ### # ##### # # # # # # ########### ### # # # #
# #     #       #   #   # #   #     #   #   #   #     #           #       #   #
###############################################################################
