###############################################################################
#   #         # # #     #   #       # #   # #           #         #     #     #
# ########### # # ##### ### # # # ### ### # # ##### ### ### # ##### ### # ### #
#     #   #   # #     # #     # #       # #       #   #     #       #     #   #
# ### ### ### # # ##### # # ### ##### ### # ##### ##### ### # ### ### ### ### #
# # #         #   #       # # #   #   #   # #       #     # #   #   # #     # #
### # ##### ### ##### ####### # # ####### ### ##### ##### ##### ##### ### # ###
#   #   #   # #   # #     #   # #   #   # #   #   #   # #     # #       # #   #
### ##### ### ### # # ##### # ##### ### # # ##### ##### # ### # # ### ##### # #
#     #     # #     # # #   #     #     #         # #       # # #   # # # # # #
# ### # ##### # # ### # # ####### ### ##### # # ### ### ######### ### # # ### #
# # #     # # # #           #     #   #     # # #   #       #   # #   # #     #
# # ##### # # # ######### ####### ##### ########### ########### # ##### ##### #
# #             #   #   #       #   #           #             #     #       # #
### ########### # ### # ####### ### # # # ####### # ####### ####### ####### # #
# #     #           # #   #   # #     # # #     # #   # #         #   #     # #
# ### # ### ### ### # ### ### # ####### ### ### # # ### ######### ### # ##### #
#     #   # #   #     # # #   #       # # # # #   # # # #     # #   #   #   # #
######### ######### # # # # ########### # # # ####### # # ### # ### ##### # # #
#   # # # #         # # # #   #       #       #   # #   # #   #   #   #   #   #
# # # # ##### ##### # # # # # ##### # ##### ##### # # # # # ##### ### # #######
# #           #     #   #   #       #     #           #   #     #     #       #
###############################################################################
