###############################################################################
#       #         #       #     #   #         # #   #   #     #   #           #
# ##### # ### ### ### ##### ### # ########### # ### ### ### # # ##### ### # # #
# #     #   # #   # #   #   #       #         #             #       # #   # # #
# # ##### ### # ### # ##### ####### ### # # ####### ##### # ### # ### #########
# # #     #   # #   #     # #           # # #   #     #   # #   #   # #       #
# # ########### # # # ### # ##### # ####### ### # # ##### # # # ### # # #######
# # #       #     # # #     #   # # #             #   #   # # #   #       #   #
# ### ##### # # ### ######### # ### ##### ##### ### # ### # # # # ### # ### # #
#     #     # # #   #     #   #     #     #   #   # # #   # # # # # # #     # #
# ### # ##### # ####### ### ########### ### ##### ##### # ### ##### # ### #####
# # # #   #   #     #   #     #   #     #         #     #   #     # # #   #   #
### ##### ####### # ### ######### ##### # ####### ### ### ### # ### # ##### # #
#   #   #   #     #   #   #     #   #   #   #     #   #     # # #     #     # #
# # # ##### # # ##### ### # ##### # ### ### # # ### ### ##### # # ### # ### ###
# #   #   #   # #   # # # #       # # # # # # # #   # #   # # # # #       # # #
# ##### ##### # # ### # # ######### # # # ####### ### # ### # # # ####### ### #
# #   # # #   # #   #       #     # #   # # #   # # # # #     # # #     #   # #
# # # # # ### ##### ##### ##### # # ##### # ### # # # ### ##### ### ### # # # #
# # #   #   # #     #   # #     #   #   # #   #       #   # #   #     # # #   #
# ##### # ##### ### # # # # ### ##### # # # # # ####### ### # ####### # ##### #
#               #     #     #         #     #       #       #       # #       #
###############################################################################
