###############################################################################
# # # #         # #               #               #       #       #           #
# # # ######### # ### ############# ####### # ##### ### ### ### ##### # ##### #
# # #       #   #       # #       # #   # # # #       # #     #       # #   # #
# # ####### # ######### # # # ### # ### # # # # # ### ####### ########### # ###
# #             #       # # # # # # #     # # # #   # #     # #       #   #   #
# # # # ##### # # # ### # ### # ### # ### # ### # # # # ### # # ### # # ### ###
#   # #   #   #   # #       # # # #   # # # # # # # #   #     #   # # #   #   #
####### ##### # ### ##### ### # # # ### # # # # # ############### ### # # ### #
# #   # #   # # # # # #       #         # #     # #   #     #       #   # # # #
# ### # ### # ### ### ### ### ### ####### ####### # # # ### # ##### ####### # #
#     # #   #       # # #   #   #       # #       # #     # # #   # #   # # # #
##### # # ######### # # ##### ### ### ############# ##### # # # # ### # # # # #
#     # #         #     #     #     #     #       #   #   #     #     #     # #
##### # ####### ########### ### ##### ##### ######### # ##### ### ##### ### # #
# #     #     # #   #     #       # #                 #     # # # #   # # # # #
# # # ####### # # ##### # # # ##### ####### ####### ### ### ### # # # # # ### #
#   # #       # #     # #   #         #   # # #     # # # #   #   # # #     # #
# ### ### ### # ### ##### ############# ### # # ### # ### # ### ##### ####### #
# #   #     #     # #   #   # #   #   # #   #   #         #   #     #   #     #
############### # # ### # ### # ### ### # ######### # ##### ######### ### ### #
#               #                       #     #     # #           #       #   #
###############################################################################
