###############################################################################
# #     #     #     #       #       # #   #             #                     #
# ### ### # ### ########### ##### # # ### # ####### ##### ##### ############# #
#   #   # #   #   #   #     #     # #     # # #   # #   # # #   #     #     # #
# ##### ### # ### # # # # ### ### ####### ### # # # # # ### # ### ##### # # # #
#     # #   #   #   #   #     # # #       # # # #     # #   # #         # #   #
# ##### ### ####### ##### ##### # # ####### # # ####### # ######### ######### #
#   # #   #   #   # #     #   # # #     #     # # #     #   #         #     # #
### # ### ### # ##### ### # # # ####### # ### ### # # ### # # # # # ####### # #
#     #   #   #       #     #       #   # # #   # # # #   #   # # # #     #   #
# ##### ### # ### ##### # ### ### ### # ### ### # ### ####### # ######### ### #
#     #     #       # # # #   #     # # #   #   # # # #       # #   #   #   # #
### # # ############# # # ##### ### # # ### ### # # # ### ### # # # ### ### # #
# # #   #     #       # # # #   #     #         #         #   #   # # #     # #
# ### ##### ### ####### # # # ##### ########### ### ##### ##### ### # ### # # #
#   # #   # # #         # # #   #   # #     # #   # #         # # #     # #   #
### # ### # # ##### # ### # ##### # # # ### # ### ### # ####### # ##### ### # #
#   #   # #       # #   # # # #   #   # #   #         # # #       #       # # #
# # ### # ##### ######### # # # ######### ##### # # ### # # # ######### ##### #
# #   # #   #         #   # #   #             # # # #     # #   # #     #     #
# ### ##### ####### # ##### ############### # # # ####### # ### # ##### #######
# #                 #                       #   #   #     #   # #             #
###############################################################################
