###############################################################################
#                   #     #             #         #             #             #
################# ##### ### # ####### # # ####### # ### ####### # ########### #
#                 #     #   #   #     # # #       #   #       #       #   # # #
# ############# ### ### ####### ######### ######### # # ############### # # # #
# #     #     # #   # #       # #     #   #   #     # #     # # #       #   # #
# ### # # ##### # # # ##### ### ### # # # ### # ##### # ### # # # # ### # ### #
# #   # #     #   #       #   # #   # # #     # # #   # # #       # #   # #   #
# ##### ##### # ######### # ### ##### # # ##### # # ### # ##### ### ###########
#   # #             #   # # #     #   # #     #   # # # #   #   #     #       #
##### # ######### ### ### ### ##### ##### ##### # ### ### # ### ##### # ##### #
# #   # # # #   # #   # #     # #   #     #     #     # # #     #   #   # #   #
# ### ### # # ### # ### ####### ### # ##### # ####### # ##### # # # ### # # ###
#   #   #   # #   #   # # #       #   #   # # #   #         # #   # # # #   # #
### # ### ### # ##### # # # ##### # # # ### # # ############# ### ### # ##### #
#   #         #         # # #       #   #   #       # #   #   # #     #   #   #
### ##### ##### ##### ### # # ######### # ####### ### # # # ### ######### # # #
#                   #     # #         #   #   # # #     #         #   # #   # #
# # ### # ######### ### ### ### ### # ### # # # # ############# ### ### ##### #
# # #   #         # # #   #   #   # #   #   # # #     #   #   #         #   # #
##### ### ##### ### # ##### # # ####### ####### ### ### # # ##### ####### ### #
#     #   #     #           # #     #   #               #   #       #         #
###############################################################################
