###############################################################################
# #   # #   #   #   #           #     #   #           # #     #     #         #
# # ### # # ### # ### ######### ### ### # # ########### # ##### ### # # ##### #
#       # # # #   # # #       #   #     # #     #   #   # #     #   # # #   # #
##### ### ### # ### # # ### # ### # ####### ### # ### ### # ### ### # ### # # #
#   #       #   # # # # #   #     # #   #   #     #   # #   # #   # # #   # # #
### # ##### # # # # # ### ####### # # ### ##### ### ### ### # ####### # # # # #
#     # # # # #     # #   #   #       #     #   #   #   #   #         # # #   #
# ##### # # ### ##### ####### ######### ### ### # ##### # ### # # #############
# #         # #     #   # #   #         # #   # #   #   # # # # # #       #   #
# ### ### ### # ####### # # ### ######### ### ### ### # # # # ### ##### # # # #
#   # #         #   # #   #   #   #     # # #         # #     #   #   # #   # #
# # # ### ### ### # # # ### ### ##### ### # ### ####### # # ### ##### ### ### #
# # #   # #       # #       #           # # #   #     #   #   #   #     # #   #
### ### # ### # # ### ######### # ####### # # # ### ##### # ######### ####### #
# #   # #   # # #   #           #   #     #   #   #     # #             #     #
# ### # ### ### # # # ########### ### ##### # ### ##### ##################### #
# #   #   #   # # # #         # # #     #   #   # #       # # #     #   #     #
# ####### # # ### ### # # ### # ### ### ######### # ##### # # # ####### # #####
#   #     # # #     # # # # # #   #   # #   # #     #   #                   # #
### ####### # ##### # ##### # # ### ####### # ##### # # ##### # ### ##### # # #
#           # #             #               #         #     # # #     #   #   #
###############################################################################
