###############################################################################
#       #     # # # #     #       #   # #           #   #     #             # #
# ### ### # # # # # ### ##### # ### ### ### # # # ### # # # # # ### ####### # #
# #   #   # # #   # #   #   # #     # #     # # #   # # # # #   # # #         #
# # ### ### ### ### # # ### # ####### ### ####### ### ########### ####### #####
# # #   # #   #   #   #   #   #     #   # # # #   #             #   #   #     #
# ### ### ### ### ####### # ##### ### # ### # ### ### # # ##### ### # ####### #
#     #   # #   # #       #       # # # # # # # # #   # # #   # #         # # #
# ### # # # ### # # # ### ##### # # # ### # # # # ######### # # ######### # # #
# # #   #   #   # # # # #       #   #   # # #   # #   # #   # # #       #     #
# # ######### # # ### # # ##### ####### # # # ### # # # ##### # ####### ##### #
# # # # #     #     # #     #     #       #     #   # # # #   #   #         # #
### # # ##### ### ### ##### ##### ### ### ### ### ##### # ### # ### ### ##### #
#     #       #   # # #     # #   #   #     #           #         # #       # #
# ############# # # ##### ### ### ##### ##### ##### ### ######### ####### ### #
# #   #       # # # #   #   #     #     #     # # #   #   #       #     #   # #
# # ### ### ### ### # # # # ### # # ####### ### # ##### ### ##### # ### # # # #
# #     # #     #     #   # #   #   #     #   #         #   #       #     #   #
# ####### # ### # ### ####### ### ##### # # ######### ##### # ##### # # ### # #
# #   #   # #     # # #   #   #   #     # # #   #     #     # #     # # #   # #
# # # # ######### # # ### ####### # ##### ### # # ### # ########### ##### # # #
#   #             #           #         #     #   #           #         # # # #
###############################################################################
