###############################################################################
#     #       #             # #   #       #   #                     # #       #
##### ##### ### ########### # # ### ####### # ####### # ########### # # ##### #
#     #   #     #         #         #     # # #   #   #   #   #   #   #     # #
# ####### ####### ##### # ##### ### # ####### # # # ### ### # # # ######### # #
#     #     #     # #   #       #           #   # # # #     #   # #   #   # # #
##### ### ### ### # # ######### ####### ####### # # # ### # # ### # # ### # # #
#   #   # #   # # #           # #     #     #   # # # #   # #   #   #       # #
# # ### # ##### ### # # ##### # # # ######### ##### # # ### ### # ### # #######
# #     #   #       # #     # #   # #             # # #   # #   # #   #       #
# ######### # ######### ##### ####### # # ####### # # ########### ##### # ### #
# #         # #     #     #   #       # #     # #   #         #       # # #   #
# ### # ### # ##### # ##### # # # ########### # ##### ##################### ###
# #   # # #   #           # #   # #   #     #           #           # #   #   #
# ##### # ##### ######### # ### ### ### ### ##### ##### # # ######### # # ### #
#   #   #     # #         #   #     #     #     #   # # # # #       # # #     #
### # ### ### ##### # # # ### # ##### ######### ### # # ### # ##### # # #######
#   # #     #       # # #   # #         #     #   # # #   # # #       # #   # #
# # # ##### ### ##### # ### ### # ######### ####### # # # # # # ####### # # # #
# # # #     #   #     #   # #   #   #   # #         #   #   # # #   #   # #   #
# ##### ##### ### ### # # ####### ### # # ##### ########### # # # # ### # ### #
#           # #     # # #       #     #       #         #     #   #   #     # #
###############################################################################
