###############################################################################
# # #           # # # #   #                 #       #   #     # #         #   #
# # ########### # # # # # ##### # # ######### ##### # # ### ### # # ### # ### #
#   #     #     #       #   #   # #     #   #     #   #         # #   # #     #
### ##### # ####### # # ### # ########### # # ### ##### # ### ### ##### #######
#     #         #   # # #   #   # #       # # #   # #   #   #   #     #   #   #
# ### ##### ##### # ### ### ### # # ####### # # ### # ##### ### ### # ### ### #
# #     #   #     # # #   #   # # #   #   # # #   # #     #   #     # # # #   #
##### ##### # ##### # ### ##### # ### ### ### # # # ##### ############# ### # #
#   #   #     #     #       #   #     # #     # #   #   #       #       #   # #
# ##### ####### ### ##### ### ### # ### # ########### ### # ### # ####### # ###
#   #   # # #   #   # #     # #   # #     #       # #   # #   #     #   # #   #
# # # # # # # ##### # # ##### ##### ### ####### # # # ####### # ### # ### ### #
# # # #       # # # # #   # # # #         #     #   #   #   # # #   #     #   #
# # # # # ##### # ### # ### # # # # ##### # # ##### # ### ### # # ####### # ###
# #   # # #   # #     # # # # #   #   #   # # #   #       #   # #   #   # #   #
# ######### ### ### # # # # # # ### ####### # # # ####### # ### ### # # ##### #
#     #     #   # # #       #     # #       #   # #       #   #   # # #     # #
# ######### ### # # ####### # # ### # ### ####### # ########### # # # ##### # #
# # #           # #   #       #   # # #     #   # # #   # #   # # # #   # # # #
### # ######### # ### # # # ##### ##### # # # ### # # # # ### # # ##### # # # #
#     #               # # #     #       # #   #   #   #     #   #         #   #
###############################################################################
