###############################################################################
#             #       #       #     #   #   #       #   #     #   #     #     #
# ### ### ####### ### # ### # # ### # ### # # # # # ### ##### ### # ### # ### #
# # # #         # #     #   #   # #   #   #   # # # #         # #     # # #   #
# # ### ####### ### ############# # ############# # # ### # # # # ### ##### ###
# #     #     #         #         # # #   #       # #   # # #     #       # # #
# ### ### # ##### ####### # ####### # # # ####### ##### ####### ########### # #
#   # #   # # #   #       #     #   #   # #     #         # #     #   #     # #
# ####### ### # ### ##### ##### # # ### ### # # ####### ### # ### # ##### ### #
#     # #   #   # #     # #     # #       # # #   #   # #       # # # #       #
####### # # ##### # ####### # ### ####### # ##### ### ######### # # # # #######
#     # # #     #   #     # #   # # #     #   # # # #           #   #     # # #
# ##### ##### # # ### ### ##### ### ##### # ### ### # ######### # ### ##### # #
# #     #   # #     #   # #   #     #     # #     # # #   # #   # # # #   # # #
# # ##### ######### ##### # # # ######### # # ##### # ### # # ##### # # ### # #
# # # # # #     #   # #     #         #   #         # #   #   #   # # #       #
# # # # # # # # ##### # ### # # ##### # # ### ### ####### ### ### # # # ##### #
# #         # #     #     # # # #       #     #   #       # #   #   #   #   # #
# ########### ##### # ##### ### # ######### ### # # ##### # ### ### # # # ### #
# #       #       #       # #   #   #       #   #   #     # #         #     # #
# ### ### # # ### ########### ########### ########### ##### ########### # ### #
#       #   #   #           #     #         #                           #   # #
###############################################################################
