###############################################################################
#     #   #   #       #   # #     #   #         #           #               # #
##### # ### # ####### ### # ### # ### # ####### # # ####### # ########### # # #
#     #     # #       #         #   #     #   # # # #         #   #   # # #   #
# ##### # ##### ### # ####### ### ##### ### # # # ######### ### # # ### ##### #
#   # # #   #   #   # #     # #   #   # # # # #           #   # #   #   #   # #
# # # # ### # ### ### ### # # ##### ### # # # # # ########### # # ### ### # ###
# # # # #   # #   # #   # # #     # #   #   #   #     # #   #   #   #   # #   #
# # # # # # # # ### ### # # ##### # ######### ######### ### ####### # ### # ###
# # #   # #   #     #     #     #   #       # #   #     # #       # # #   #   #
# ####### ### ####### ##### ### ### ### ### # ### ### ### # ######### # ##### #
#     #   # #   #   # #     # # # # #   #   # #     #   #       # #   #     # #
##### # ### ### # # # # ### # # # # ##### ### ##### ### # # # ### # ### ### # #
#   #   #   # # # #   #   # # #   #     #   #   #       # # #     #     #   # #
# # ### # ### ############### # ##### ### # ### ##### # # ######### ##### #####
# #   #   #   #   # #   #     # #     # # # #   # #   #   #     #       #     #
# ##### ### # # # # # # # ##### # ### # ### ### # # ##### ### # # # ### ##### #
# #       # #   # #   #   #   #   # #     #       #     #     #   # #   # #   #
# # ##### # ############# # ### ### ##### ####### # ##### ######### # ### #####
#   #   # # #       #   #     # #   # # # #         #     #       # #         #
# ### # # # ##### # # # ##### # # ### # # ####### ####### # ### # #############
#   # #   #       #   #         #                 #           # #             #
###############################################################################
