###############################################################################
#   #       #     #         # #           #   #                   #     #     #
# ##### # ### ### # ##### # # ##### ##### # ############### ##### # # # # ### #
#     # # #   #     #     # #     # #   #   # #     # #       # #   # # #   # #
# ### ### # ### ##### ##### ##### ##### ### # ##### # # ### ### ######### #####
#   # #   #   # #       #   #     # #   #     #       # # #     # #     #   # #
# ### # ### # # ####### ### ##### # # # ##### ####### # # ####### # ####### # #
# #   #     # # # #   #   # # # #     #     # #       # #     # #         # # #
# # ### ####### # # # ### # # # ######### ### ### # # # # # # # # ### ##### # #
# # # # #     # # # #     #   # #           #     # # #   # #   #   # # #     #
### # ### ### ### # ######### # # ### # ### ####### ### ##### # # ### # # # # #
#   # # # # #   #     #           #   # #   # #           #   #   #   #   # # #
# ### # # # # # ############# # # ### ##### # ############# ####### # ### ### #
#       # # # #   #           # #   # #     #     #             #   #     # # #
### ##### # # ### # ##### ##### ### ####### # ##### ##### ### # ########### # #
#   #     #   #     #   #   # # # # # #             #   #   # #     #       # #
# # # ############### # ##### ### # # ### # ######### # ### # ##### # #########
# #   #     #         #               #   #   #       #     #     #           #
# ##### # # ##### ##### ####### ################# # ### # # # # # ##### ### ###
# # # # # #     # #   #     # # # #   #       #   # #   # # # # # #     #   # #
# # # ### ##### # # # ##### # # # # # # ### # # ### ##### # # ##### ##### # # #
#   #         #     #     # #     # #   #   #     # #     # # #     #     #   #
###############################################################################
