###############################################################################
#       #       #     #     #         #     #         #   # #   # #   #   #   #
# # ##### ##### # ### ### ########### ##### # ######### ### ### # # ### ### ###
# # #     # # #   #   # #     #     #     #     #     #             # # #     #
### ### # # # ####### # ### # ##### ##### ### # # ### ##### ### # ### # ### # #
#   #   #   #     # # #     #     # #   #     # # #   #   # # # #       #   # #
# ### ##### # # # # # # # ### ### # # # ####### ### ##### ### # # ########### #
#   #   #   # # #     # # # #   # # # #               #       # # #       #   #
### ### ##### ####### # # # # ### # # ######### ##### # ##### # ### ### ### ###
#     #   #   #     #   # #   #   #   #     #   #     # #     #   #   #   # # #
# ######### ### ########### ### ### ### ##### ##### # # ##### # ### # ##### # #
#     #       # #       #     #       # #     # #   #   #         # #         #
# # # ######### # ##### # ##### ##### # # ##### ### ##### ##### # # ### ##### #
# # #   #         # #   # #     #   # #   #   #       #     #   #     # #   # #
# # ### # ######### ### ####### # ### ##### ########### # # ### # # # # # ### #
# #   #   #     #                 # # # #   #     #   # # # # # # # # #     # #
### # ##### ### # ################# # # ### # # ### # ##### # ####### # ### ###
#   # #     #   # #               # #     #   # #   #   #   #         # #   # #
# ##### ##### ####### ####### # # # # ######### ####### ### ##### ########### #
#   #     #   #           #   # # #   #   #   #     # #     #   #             #
# # ####### ### ### ##### ##### # ##### ##### ##### # ####### # ### # #########
# # #           #     #     #   #                             #     #         #
###############################################################################
