###############################################################################
# # # #   #   #       #   #     # #   #           #   #   #   #       #       #
# # # # ### ##### # # ### # # ### # ##### # ####### # # # # # # ##### # ##### #
# #     #   # #   # #   #   #     #     # #   #     #   # # #   #         #   #
# ### ### ### # ############# ##### # ####### # ######### ### ########### #####
#   #   # #   #     #       # #     # # #     #       # # #   #       #       #
# ### # # # ### ####### ### # ##### ### # ### ####### # ### ######### # ##### #
# # # # # # #   #     # #   # #     #   #   #   #     #         #     #   # # #
# # # ### # # # # ##### # ### # ##### ### ####### ####### ##### # ######### # #
#       #     #   #     #   # # #     #       #   # #     #   # #         #   #
# ### ####### ##### ##### ### # # ### # ##### # ### # ##### # # ##### ### # ###
# #               # # #   #   #   #         #   # #       # # #         # #   #
# ### ####### ##### # # # # # ### ##### # # # ### # ### # ### ##### # ####### #
# # #       #   #   # # # # # # #     # # # #   #     # #   #     # #   #     #
# # ####### ######### # ##### # # ####### ### # ##### ### # ### ### ### # #####
# # # # #   # #   # # #     # #   #   #   # # #       # # #   #   #   # #   # #
# # # # # ### # ### # ### ### # # # ####### ### # ##### # ### ### ### # ### # #
# # # #     # #   #       #     # #   #   #   # # # #   #   # #   #   #   #   #
### # ##### # # ##### ### # ##### ### ### ### # # # ### # ##### ### ##### ### #
#       #       # # # #     #   #     #       # # # #   #     #   # # # #   # #
####### # # # ### # # # ### # ### ### # ### # # ### # ####### # ### # # ### # #
#         # #         #   # #       #   #   # #             #   #     #     # #
###############################################################################
