###############################################################################
#         #   #       #     #   #     # #       #     #   #   #   #     #     #
##### # ### # # ####### ### # # ### ### # # # # ##### # ### ### # # # # ##### #
#   # # #   # # # # #     # # #   #   #   # # #     #     # #   #   # # # # # #
# # # # # # # # # # # ### ### ####### # # ### ### ####### # ### ##### ### # # #
# # # #   # #     # # #   #   # # #     #   # #   #     #     #     # # # # # #
# # ### # # ####### ### ### # # # ##### # ### # ### ### # # ##### ##### # # # #
# #     # #   #   #   # #   #   #       # # # # #     # # # #   # #   # #     #
# ####### ### ### ### # # # ######### ### # # # ### ####### # # # ### # ##### #
#       #   #   # #   # # # #   #     #   #   # #     #   # # #   #   #     # #
####### ##### # # # ### # ### # ### # ######### # # ### ### # ####### # ##### #
#     #   #   #   #   #   #   #     # #       #   #     #     # #   # #       #
##### ### # ##### ### # ### # # ####### # ### # # # ### ### ### ### # # ##### #
#   #     # #       # #     # #   #     # #     # # #         #   # #       # #
# # ##### ######### # ##### ### ### ### ### ############### ### # # # ####### #
# #     # #     #             # #   #     # # #         #       #   #     #   #
##### # ##### # # # # # # ######### ### # # # ### ##### ##### ####### ### #####
# #   # #     # # # # # # #           # # # #     #       #       # # #       #
# ##### ### ### ########### # ####### ####### ##### ##### ### ##### ##### ### #
# #   #   # # # #       #   # #       #         #   #         #   # #     # # #
# # # # # # # # # ##### # ##### ##### # ### ##### ######### # # ### ### ### # #
#   #   #     #     #       #     #   # #   #     #         #             #   #
###############################################################################
