###############################################################################
#               # #       # #     #         #           #     #   #           #
# # ########### # ### ##### # ### ### ##### ### # ### ### ##### # ### ### #####
# # #       # #   #   # #   # #   # # #   #   # #   #       #   # #   #   #   #
########### # # ### ### # ### ##### # # # # # ##### ####### # ### # ##### # # #
# #             # #           #     #   # # #           #   # # # #     # # # #
# ############# # # ##### ##### ########### ########### ##### # # # ### ### # #
#     #   #     #   # # # #     #     #       #   # #   #   # # # #   #   # # #
##### # ### # ### ### # ### ##### # ### ####### # # # # ### # # # ### ### # # #
#     # # # #                   # #   # #       # #   #   # # #     # #     # #
# ##### # # # ####################### # # # ##### # # ##### # ####### #########
#   #   #   #       #     #     # # #     #   #   # #   #   #     # #         #
### # ### ##### # ### ### ### # # # ####### ### ### ####### # ### # ######### #
#     #   # #   # #   # #     # #   #   # # #   # #           #         #   # #
# # # # ### # # ### ### # ####### ### ### # ##### ##### # ########### ### ### #
# # #   #     #   # # #     #     # #     # #   # #   # #   #       # #   #   #
##### ### ### # ### # # ##### # ### # ##### ### # ### # ##### ##### # # ### ###
#     #   # # # # # #         #     # #       #   #     #         # #   #   # #
##### ### # ### # ### ########### ### ### ### # ### ##### ##### ######### ### #
#     #   #     #   #     #     #       # #     #   #     #   # #       #   # #
# ##### ### # # # # # # # ### ### # ### # ##### # ### ### ### # # # ### # # # #
# #       # # #   #   # #     #   #   #     #   #       #     #   #   #   #   #
###############################################################################
