###############################################################################
#   #             # #           # #   #   #         # #     #       #         #
# # ### ##### # # # ####### ### # ### # ### ##### # # # # ### # ### ### ### # #
# # #   #     # #           #   #   # #   #   #   #   # #     #   #     #   # #
# # ########### # ##### # ######### # # # ### # ### ############# # ######### #
# #     #       # #   # #           #   # # # # #             # # # # # #   # #
# ##### ### # # # # ### ##### ########### # ##### ########### # # # # # # #####
# #         # # #     # #   #   #   #   # #   # # #   #   #   #   # #   #   # #
# # # # ##### # # ##### # ####### ### ### # # # # # # ### # ##### # # # # # # #
# # # # #   # # # #   # # #             # # # #   # #   # #       #   # # #   #
# ##### # # # ### # # # # ######### ##### # # ### # ### # ##### ### # ####### #
# #     # #   #     # #   #   #     #     # #     #   # #   #   #   #         #
######### ### # ### ######### # # ### ##### ### ##### # # ######### ###########
#   #     # # #   # #     #   # #   #   #   #   #     # #   #   #   #   #   # #
# ### ##### # ### # # ##### ### ####### # ### ### ####### ### # # ### ### # # #
# # #   #   #   # # #       #   #   #   #   # # # #   # # # # #           # # #
# # ####### ### # ######### ### # # # ### # ### # # # # # # # ### ########### #
# #           # #     #     # #   #   #   #       # #     # #   # #           #
# ### ####### # # # # ### ### # # ########### # ### ### ### ### # # ###########
#   #   #       # # #       # # #   # #     # #   # #       #   #   #     #   #
# # # ########### # ### ### # # ### # # # ##### # # # ##### ##### ##### # # # #
# #       #       # #   #       #       #       #   # #     #           #   # #
###############################################################################
