###############################################################################
#         #           #   #   #   #         # #       #       #           #   #
# ######### ##### # ### ### ### # # # ### # # # # # # # # ### ######### # # ###
#         #   # # #           # # # # # # # #   # # #   # #       #     #     #
# ####### # # # ####### ##### # ####### ### ### # ####### # ### ############# #
# #     #   # #       #   #     #         #   # #   # #   # # #     #     #   #
### ### ##### # # ### ##### ####### ### # ### # ### # # ### # ##### ##### # # #
#   #   #     # # #         #       # # #       # # #   #   #   # #         # #
# ### ### ####### ####### ### ##### # # ######### ####### ##### # ### ####### #
#   #   #   # #   #           # #   #   #       #   #   # #         # #       #
### ### # ### # ### ### ### ### ##### ### ####### # # # # ######### ### ### # #
#   #   # #   # #   #     # #   #   #     #       #   #   #           #   # # #
##### # # ### # # ####### # # # # ##### ### ##### ### # ##### # ##### ####### #
#   # # #     # # # #     # # # #     #   # # # # # # # # #   # #             #
# ### # ##### ### # # # ##### # ### ### # ### # ### # # # # ### ##### # ### # #
#     #   # #   # #   #       #     #   #   #   #     # #     # #     # #   # #
######### # ### ### ####################### # # # ############# # # ### # ### #
#     #   #     # # #     #   #   #       # # #   #   #       # # # #   # #   #
# ### # # # ##### ####### # # ### ### ### # # # ### ### ### ##### # ###########
#   # # # #     #     #     #   #     # #   # # # #     #   # # # #   #     # #
### # # # # ### ### # ##### ### # ##### ######### # ##### ### # # # ##### ### #
#   #   #   #       #     #   #   #                 #             #           #
###############################################################################
