###############################################################################
#   #       # #   #     #             #     #       #       #                 #
### # ### # # # # ### # ####### # ### ##### # ####### ####### # # ######### # #
# #     # #   # #     # #       # # # #   # #     # #     # # # # #         # #
# ##### # ##### # ##### ######### # # # # # ##### # # ### # ##### ########### #
# #     # #     # #   # #     #   # #   # #   #   # # #   #     # #       #   #
# ### ##### ##### ### ####### ### # ##### # # # ### # ### ### # ####### ### ###
#         # # #     #     #     # #     # # #     # # # #   # #       #   #   #
### # # # # # # # ####### ### # # # ##### ####### # # # # ########### ### ### #
#   # # # #   # #     #   #   # # #     # #     # # #   #       #   #   #   # #
### # # # ##### ####### ### # # # # ####### # ### # ########### # ### # ### # #
# # # # #                   # #   #     #   # #   # # #         #     #   # # #
# ##### ### ################# ### ##### # ### # ### # ##### ### ####### # # # #
# # #   # # # #     #         # #       #   #   #   # #     #     #     #     #
# # # # # ### ### ### ### # ### ####### ### # # # ### # ####### ##### ##### # #
#   # # #       #     #   # #           #   # # #       # # #     # # # #   # #
# ##### ####### ####### ##### ### ##### # ##### ##### # # # # ### # ### # #####
#     #     #   #       # #   # # #     # #           #     # # #       # #   #
# ### ### # # ######### # ##### ### ### ### ##### # ### ####### ####### # # # #
# # #     # #     #       #   #       #     #     # # #       #   # #       # #
# # ### ### ##### # ####### # ### ### ##### ######### # # # ##### # ### # ### #
#   #   #   #         #     #     #       # #           # # #           # #   #
###############################################################################
