###############################################################################
#   #       #   #   #   #     #   #     #         #         #   #   #     #   #
# # # ##### # ### # # # # ### ### ##### ### # # # # ####### ### # ### ### # # #
# # # #   # # #   # # #   # #         # #   # # # # # #     # #   #     # # # #
# # # # # # # ##### # ##### ### ##### # ####### # ### ##### # ### # ### # # # #
# # # # # #       #   # # #   # #   # # #     # # # # # #   # #   #   # #   # #
### # ### ##### ####### # ### # # # # # # # ##### # # # ### # # ### ###########
# #           #     #   #     #   # #   # #   #   # # #   #               #   #
# ##### ########### # # ##### # ### ######### ### # # # ######### ### # # # ###
#     # #   #       # #           # #     #         #   #         #   # #   # #
### # ### # # ########### ############# ########### # ########### ### ####### #
# # #     # #     # #   #         #   # #         # # #       #     #     #   #
# ######### ##### # # # # # # ### # # # # ####### # # ### ##### # # # ##### ###
#     #     #   #     #   # #   #   # #   #   # # # #       #   # # #         #
# ### ##### # # ########### ### ### # ##### ### # # # # # # # # # # ###########
#   #       # #     # #       # #   # # # #           # # #   # # #           #
########### ####### # # ####### ####### # ##### ##### # ############# ####### #
#           # #   #     # #     #   #   #   #   #     #     #     # # #     # #
# ####### # # # # ####### # # ### # # ### ######### # ### # # ### # ##### ### #
# #   # # # #   #           #     # # # # # #       # # # #   #         # # # #
# # ### # # ### ### ######### # # # # # # # # # ##### # # ### ##### ### # # # #
# #       #     #     #       # # #           # #       # #       # #       # #
###############################################################################
