###############################################################################
#       #       #     #   #       #     #                   #         #       #
### ### # ####### ### ### # # ##### ####### ##### ### ### ##### ### # # ##### #
#   # # #   # #   # # #     #   # # #     # # #   # #   #   #   # # # # #   # #
# ### ##### # # ### ####### # # # # ##### # # # ### # ##### # ### # ### # ### #
#   #         #   #   #     # # #   #   # # #   #     #     #   # #   # # #   #
# ##### ####### ### ### # ### ### ### # # # ######### # ####### # ### # # #####
# #   #         #   #   #   #   # #   #   #     #   # # #       # #   # #     #
# ### # ######### ######### ##### ####### ##### # ### # # ####### # ### ### # #
#         #     #   # #   #   # # #           #   #   # # #       # #   #   # #
####### ##### ### ### # # # # # # # ##### ### # ######### # ####### ### # ### #
# #     #     #     # # #   #   #   #   # #           # #     # # #     # # # #
# # # # # ######### # # # ####### ### # # ### # ##### # ### # # # ##### # # # #
#   # #     #     #   # #   #   # #   #   # # # # #       # # # #     #   # # #
### # # # # ### ### ### ### # # # # ##### # ### # # ####### # # ### ####### # #
#   # # # # #             # # #   #     # #   #   #         #   #       #   # #
# ### ### ### ##### ##### # # ##### ##### # # ############# ##### ####### # # #
#   #   #   #     # #   # # #     #     #   #       #     # #   # #   # # #   #
##### ######### ### ### # ##### # ##### ################# ##### # # # # # #####
#     #   #   #   #   #     #   #     # #           #   #   #   # # #   # #   #
# ##### ### # # # ### ####### ######### ####### ### # # ### # ### # ### # ### #
#           #   #   #                 #           #   #             #   #     #
###############################################################################
