###############################################################################
#     #   #                             #       # #     #       #   #         #
# ### # # # ######### ####### ######### # # ### # # ### # ####### ### ##### ###
#   #   #   # #     # # #   #     #   #   # # #     # # #             #   #   #
##### ####### # ### # # ### # ### # # # # ### ####### # ##### ####### ### #####
#     #   # #   #     #       # # # #   #     # # #   #       # #     #   #   #
# ##### # # # ########### ##### # ############# # # ########### ####### # ### #
# # #   #   # #       # # #   # #   # # # #         # #         #   #   #   # #
### # ######### # ### # # ### # # ### # # # ######### # # ####### ### ##### # #
#         #     #   # # # #       #     #               #   # #   # #     # # #
# ####### # ####### ### ######### # ##### ######### # ##### # # # # # # # ### #
#   # #   #   #   #     #     #     #   #         # # #   # #   # # # # #   # #
##### # # ### # # ##### ##### ### # # ### ### # ### ### # ### ### # # # ##### #
#     # #       # #   # #         #   #     # # # # #   #     #   #   # #   # #
# ### # # # ##### # ### ####### ### # # ### ##### # # # ####### ##### # # # # #
# # #   # #   #   #   # # # # # #   #   # # # #       # #     #     # # # #   #
# # ##### ### ####### # # # # ##### # # # ### ### ##### # ### ######### # #####
#     #   #   #               #     # # #     # #   # #     #   #   #   #     #
### ####### ####### ##### ### ##### # # # # ### ### # # ##### # ### # ### ### #
#   #           #   #   #   #     # # #   #   # # # #   # # # #     #     #   #
# ####### ####### # ### ##### ### ### ##### ### # ### ### # ##### # # ### # ###
#       # #       # #           #     #           #         #     #   #   #   #
###############################################################################
