###############################################################################
#       #   #   #         #   # #     #           #       #       #         # #
# # ### # # # ######### ### ### ### # ### ##### ### ### # # ##### # ####### # #
# # #     #                 #     # # # # #   #       # # #   #   #   #   #   #
# # # ### ### ### ####### ### ### # # # # # # ####### # ##### ### # # ### ### #
# # #   #   #   #     # #       # # #     # #     #   # #   #   # # #   #     #
# ### ####### ### ##### ####### ### ### ### ### # ### ### ##### # # ######### #
#   # # #     #     #         #   # #   #     # #   #       #   #   #   #   # #
# # # # ##### ### # ##### ### ### ### # ######### ##### # ### ### ### # # #####
# # # #     # #   #         #   #     #     #   # #   # # #   # # #   #   #   #
### ####### ##### ### ##### ### ########### # ### # # # # # ### # # ####### # #
# #       #         #     # #   #   #   # #   #   # #   # # #     # #       # #
# ### ### ######### ######### ##### ### # ##### ##### ##### ### ### ### ##### #
#   #   #     #             #     #   # #           # #   #   # #   # # #     #
# # ### ##### ####### ############### # ######### ### # ### ##### ### ### #####
# #     #   # # #         #     #   # #           #   # # # # # # # #   #     #
####### # ### # # ### # ### ### # # # # ######### ### # # # # # # # ### # # ###
# #     #     #   #   #     # #   #   # #           # #   #     #         # # #
# # # # ########### ######### ######### ########### ### ##### ##### ##### ### #
#   # # #       #         #             #   #     #             #       # #   #
### # ##### # ### ######### ######### ### # ##### ####### ##### # ### # ### # #
#   #   #   #                       #     #       #           #     # #     # #
###############################################################################
