###############################################################################
#   #           #           #       # # #             #       # #       #     #
# ### # ##### ##### ### ### ### ##### # # ##### ##### # ##### # ##### # ##### #
#   # #     # #     #     #       #       #   #   #   #   #         # # #   # #
### ######### # ##### ######### ##### ### # ##### ####### ######### # # # # # #
#       #     # #     #   #   #       #   # #           #       # # # #   #   #
# ##### # ##### ####### # # ### ### ####### # ####### # # ##### # ### #########
# # #     #     #     # # #   #   #   #     # #     # # #   #     #       #   #
# # # ##### # ### ####### # # ### # ### # ######### # # ### # ##### ##### ### #
#   # # # # #     #   #   # #   # #   # # # #       # #     #       # # #     #
# ##### # # ### ### # ### ##### ####### # # # ### ### # ############# # # ### #
# #           # # # #     #     #     # # #   #     # #   #   #   #   # # #   #
# ##### ##### ### # ####### ##### ### # # # ####### # ##### # # # ### # #######
# #   # # #   # # # # #   # #   #   # # #   #     # # #     # # #   #     #   #
# # # # # # # # # # # # ### # # ##### # ##### # ### ######### # # # ##### # # #
#   #     # # #           # # #   #   #     # # # # #           # #       # # #
####### ##### # ########### # # ### ### ####### # # # ### ######### ### ### ###
#       #   # #               #     # #       # # #   # #   #   #     #   #   #
########### # ### ### ##### # ##### # # # # ### # ##### ### # # # ####### ### #
#           #   #   #     # #   #   #   # #   #       #   # # #   # #   #     #
# ##### ### # ### # ####### ### ######### ### ##### ##### # ####### # # ##### #
#   #     #       #       #   #             #             #           # #     #
###############################################################################
