###############################################################################
#       #     # #   #     #   #     #           #     #         #     #     # #
# ### # ##### # ### ### # # # ##### ######### ### ####### ####### ### # ##### #
# #   #     #         # # # # #             #   # #     #   #     # # #       #
# # ### ############# # ##### ############# # # # ##### ### # ##### # ##### # #
# #   # #         #   #       #       #       #           #       #         # #
##### # ### ##### # ######### # ############# ########### ### ##### ### # #####
#     # #       # # #     #         #     # #       #   #     #     #   #     #
# ### ### ####### # # ### # ### # ##### ### ####### # # ######### ### ####### #
#   #     #     #   # #   # #   #     # #         # # #     #     #   #       #
# # ########### # ### ##### # ### ##### ####### # ### ### ### ### ##### ### # #
# #       #   #   #     #   #   # #     #       #   #   #   # #   #     #   # #
# ### ### ### # ### ### # # ####### ##### # ### ### ### # # # # ### # ### ### #
# #   # #   #     #   #   #     #     # # # #   # #     # #   # #   #   #   # #
# ##### ### # # # # # ####### # ### ### ### # ### ####### ### ########### # ###
# # #   #   # # #   # #       #         #   # #       #     # #   #       #   #
### # ### ##### ### ################### # ### ##### ########### # # ####### # #
#   #   #   # #   # #   #       #       # #   # #       #       #   # #     # #
# # ### ### # ### # ### ### ### # ### ### # ### ####### # ####### ### # ##### #
# #     #   # # # #   # #   #       #     #   #       #   # # #   # #   #     #
# ### ####### # # ### # # ######### ####### # # ##### # ### # # ### ### ##### #
#   #               #   #       #   #       #   #     #   #           #     # #
###############################################################################
