###############################################################################
#       #       #     #     #   #       #     #       #       #   #       #   #
### ### # ##### # ### # # ### # ### ### ##### ####### # ####### # # ######### #
#   #       # # #   #   # #   # #     #   # #         # #       # # #       # #
# ######### # # ####### ### ### ##### # # # ######### # # # ### ### # # ### # #
# #     # #   # #       #   #     # # # #     #     #     # #         # #     #
# # ### # ##### # # ##### ### ### # ### ####### # # ### # # ####### ### #######
#   #       #   # # #   #   # # #     #       # # #     # #   # #     #       #
### ####### # ### ### # ### # # # ##### ##### ##### ### # ##### ##### ####### #
#   # #     #   #     # #   # #   #   #   # #   #   #   #         #   #     # #
# ### # # ############# # ### ### # # ### # ### # # # # # ######### ####### # #
#   #   #   #   #     #   # # # #   #     #   # # # # # # #     # #     #     #
### # ### ### ### ####### # # # ### ####### # # ### ##### # # ### ####### # ###
#   # # #   #     #     # #   #   # #       #   #   #       #           # # # #
# ### # ### ### ### ### # ### # ####### # ############# ### # # ### ### # ### #
# #   #   # #   #     # #   # # #   #   #           # #   # # # #   #   #   # #
# # ### # # # ### ### # ##### # ### ######### ##### # # ### # ####### ##### # #
# #     # # #     #   #   #   # #   #   #       #     # #   # #   # # # #     #
# ######### ########### # ### # ### # # # ##### ##### # ##### ### # # # # ### #
#     #   # #     #   # #   # #       #   #   #   #   # #   #     # # # # #   #
# ##### # # # ##### ### ### ####### # ##### ######### # ### # ##### ### # #####
# #     #                 #         #               #   #       #             #
###############################################################################
