###############################################################################
#                   #       #         #         #   #   # #                   #
# ### ############### ##### ### ####### ### ### # ### ### ### ############### #
#   # #         #         #   #     # #   # # #   #   #   #   # # # #     #   #
### ### ####### # ####### ### ### ### ### ### ##### ##### # ### # # # # ### ###
#   #   #       #   #   #   #   # #         # #   #             #     # # # # #
# # # # # ##### # ### # ### ### # ####### # # # ####### ######### ####### ### #
# #   # #     # # #   # # # #   #         # # #     #       #       #   #     #
# ########### # # # ### # ### ##### ####### # ##### # ### ##### # # # ### #####
#   #       # #   # # # #         # #   #   # #   #   # #     # # #   #       #
# ### ##### # ##### # # ### ##### ### # ### # ### # # # ### # # ### # ### #####
#   # #         # # # #     #     #   #   #     #   #   # # #   #   #   #     #
### # # ##### ### ### # ##### ### # ### ##### # # ##### # # ### ####### # ### #
#   # # #   # #   #   #   #     #   #   # #   #   #   # #     #   # #   #   # #
# ### ### ##### ##### ### # ##### ##### # ### # # # ####### # ### # # ####### #
# # #   #       #       # #   #   #   # #     # #   #       # #   #           #
### ### ##### # # ####### ### # ### # ######### # ##### ### ######### #########
#     # #   # #         # #   #   # #         # #     # #   #                 #
# # # # # ############# ### ##### # ##### ### # ### ####### # # # ### ####### #
# # #   # #       #   #         #   #   #   #     #     #   # # #   # #   #   #
# ####### # ##### # # ### # ######### # # ##### # ### ### # # ######### ##### #
#         # #       #     # #         #   #     #   #   # # #               # #
###############################################################################
