###############################################################################
#   #     #   #         #     # # #   #     #       #           # #   #   #   #
### # ##### # # ##### # ### ### # ### ### # # ### # ### ####### # # ### ### ###
# #   #   # #   #   # # # #   # #   #   # # # #   # #   #     # # # #     #   #
# ### # ########### ### # ### # ### ### ### ##### ##### ### ##### # # # # # # #
#               #   #       # #   #     # #       #         #   # #   # #   # #
# ############### ### ### ### ### ### ### # ####### ##### ### ### ####### #####
#   #   #             # # #   #   #   #   # # #     # # #   # # #       # #   #
# ### # # # # ######### ### ##### # # ### # # # # ### # # # # # # ### # # ### #
#   # #   # # #   #   #   #   #     #   #   #   #   #   # # #   #   # # # #   #
### # ##### # # ### # ### ### ### ##### # ########### ### # # # # ##### # # # #
# # # #     # #   # #       # #     # #   #     #   #     # # # # #     # # # #
# # ### # ####### ##### # # # ##### # ### # ##### # ####### ### ####### # # # #
# #     #   #   #     # # # #     #   #   # #     # #       #   #       #   # #
# ######### # # ### # # # # ### # ##### ### # ##### # ### ### ### ### ### # # #
#       #     # #   #   # # #   # #     #   # # # #   # # #   #   # #     # # #
# ##### # ####### ######### ##### # # ### # # # # ##### # # ### # # # ####### #
# #     #   #     #   # # #       # #   # #     # #     #   # # # # #   #     #
# # ####### # ##### # # # ### ### # ### # ####### # ### # # # ##### ### # #####
# #       #   #   # #   #   #   #   #     # #   #   #   # #         #   # #   #
# ############# # # ### ### # ### ### ##### ### ##### # ##### ### # # # # # ###
#               #     #       #   #         #         #       #   #   # #     #
###############################################################################
