###############################################################################
#             #   #   #     #   # # #   #   #   #   #   #   #   #     #   #   #
# ####### ### # # # # ### ### # # # ### # # # # # # # # # ### ### # # # # ### #
# # #   #   # # # # # # #     #     # #   # # # # #   # # # # #   # # # #   # #
# # ### ##### ### ### # ### ### ##### ### ### # # # ##### # # ### ##### # # # #
# #   # #   # #       # # # # # #           # # # # #   # # # #   #     # #   #
# ### # ### # ##### ### # # # ### ######### # ### # # # # # # # ### ##### ### #
# #   # #   #       #   # # # #   #   #   #       #   #     #       #     #   #
# # # # # ##### # # # ### # # # ##### ### # # ### ############### ####### # ###
# # # #   #     # # #   #   # #       # #   #   #   #   #           #   # # # #
# # # ### ### ### ##### # ### ### ##### ##### ####### ### ### # ### # # # # # #
#   # #     # #   #       # #   # # #   # #         #   #   # #   #   # # # # #
# ### ##### ### # ####### # ### # # # ### ########### # ### # ### # ### ##### #
# # # # #     # # #           # # # #     # #   #     #     # #   # #   #     #
# # # # # ### # # # ####### # # # # ### # # # ### ########### ########### ### #
# # # #   #     #     #     #     #     #       #       #   #               # #
# # ##### ##### ##### ##### # ##### # # # ### ### ##### # ########### ### # # #
#     #   # # # # #   # #   #     # # # #   #   #     # #     #     # #   # # #
####### ### # ### ### # # # ### # # ### ##### ### # # # ### ####### # ####### #
# #   # #   #         # # #   # #     #   #       # # #     #           # #   #
# # # # # # ##### ### # ### # ### ### ### ##### ######### ############### # ###
#   #     #     # #   #     #   #   # #   #           #               #       #
###############################################################################
