###############################################################################
#             #                         #     #     #       #     # #     #   #
# ### # # ##### ##### # # # ######### ##### ##### ### ### # ##### # ##### # ###
# #   # #   #   #   # # # # #     #       #           #   # #       #     #   #
# # ####### # ### # ##### ####### # ####### ########### # ### ##### # ####### #
# #   #   # #   # #   #   # # #               #   #     #     #     #   #     #
# ### ### # # # ### # # ### # # ####### # # # # ##### ######### ####### # ### #
# #   #   # # # # # # # # #     #     # # # #   # # #         # # #     # #   #
##### # # # # ### ### # # # ### # # ### ##### # # # ### ####### # # # ### ### #
#   #   # #   #     #   #   # #   #   # # #   #       #       #   # #   #   # #
# # # ### ##### ####### # ### ### # # ### ##### ####### ########### ### ### ###
# # #   # # #           # #     # # #     #   # #     #   #         # # #     #
# # ### ### # ### ### # # # # # # # ### ##### ### # ##### ### ####### # # #####
# #   #   #   #   # # # # # # #   #   #       #   #     #         # # #   #   #
# ### ########### # ### # ### ### ############# ################# # # ##### # #
# # #   # #     #   #   # #     #   #     # #               #       #   #   # #
# # ### # ### # ########### ##### ### ### # # # ############# ####### ### ### #
# #   #     # #   #   #     #     # #   # #   #     # #     #     #       # # #
# # ####### ##### ### # ######### # # ### ### ### # # # ### ####### ### ### # #
# #     #   #       # #       # #       # #     # # #   # #   #   # #   #   # #
# ##### # ### ##### # ######### ### ### # ### ### # # ### ####### # # ##### # #
#       #     #                       # #       # #                 #       # #
###############################################################################
