###############################################################################
#     #                         #   #   #         #     #             #   #   #
##### # # ##################### ### ### # ### ##### # # ### ######### # # ### #
#   #   # #     # # #         #     # # #   #     # # # #   #     # # # #     #
# # # ### ##### # # # ##### ####### # # ### ##### # ##### ### # # # ### ### ###
# #   #   #     # #     # # # #   #   #   #   #   #   # #   # # #   #     # # #
# # ####### ### # ####### # # # ### ### ##### ####### # # # ### # ### # ### # #
# #   # #   #   # # # #   # #   #   # # #   # # #     # # #     #     #   #   #
# ### # # ### ### # # ### # ### # ### # # # # # # # ### # ##### ##### # # ### #
# #   #   # #     # #   # #   # # #     # #   # # # # #       #     # # # #   #
# # ####### ##### # # # # ### # # ##### # ##### # ### # ######### ##### ##### #
# # #           #   # #     # #   #   #       #     #   #     #       #     # #
### ##### # ####### ##### ### # ##### # ### # ##### ### # ### ####### ##### # #
# #   # # # #   #   #               # # #   #           # #   # # #     # # # #
# ### # # ##### ### ### ### ####### # ############# # ### ##### # # ### # # # #
#   # #       # #         # # #     #       #       #             #   # #   # #
# # # # ##### # ### ### # # # # ### # ############### ########### ### ####### #
# #   #   #   #     #   # #   # #         # #   # #           #   # #       # #
# ####### ####### # ####### ### ######### # # ### # ##### ### ##### ####### ###
# #     #         #   # #   #   #       # # # # #     #     #   #   #   #     #
# ##### ##### ##### # # ### ##### ##### # # # # # ### ##### ##### ### ### ### #
#           #     # # #       #     #               #   #             #     # #
###############################################################################
