###############################################################################
#     #     #     # #     #           #   #     #         #           #       #
##### # ### # # # # ##### ### ### ##### # ### # # ##### ##### ### ### # # ### #
#   #   #   # # #   #   #   #   # #   # # #   #   #     # #   # #   # # #   # #
# ##### # # # # ##### # ### ### # ### # # ########### ### # ### ######### # ###
#       # # # #     # #   # #   # #     # # #       #   #       #       # #   #
########### # ##### # ##### ##### # ##### # ##### # ### ####### ### ######### #
#   #     # # # # # # #   #         #   # #     # #   # #         #     #     #
### # # ### # # # # # # ########### ### ####### # ### # # ########### # # ### #
#   # # # # # # #   # #   #   #       #         #   # # #             #   # # #
# ### # # # ### # ### ### # # # ############### ##### # # ##### ##### ##### ###
# #   #   #       # #       #   #     #       # #     #       # #   # # #   # #
# # ### # ### ##### ### ####### # # # # ####### ##### # ### ### ### # # # ### #
#   #   #   #   # #   # #   # # # # #     #   # # #       # #   #   #     #   #
##### ######### # ### # # # # # ### ##### # # # # ##### # # # ### ####### ### #
#   #         # # #   #   #   #     #       # # # # #   # # #   #       #   # #
# ##### ### # # # # ### ### ############### # # # # # ### # # # # ### # ### # #
#   #   #   # # #   #   #   #               #     # # #   # # # #   # #   # # #
### # ### ### # # ####### ### ########### ### ### # # ##### ### # ### ### # # #
#   # #   #     # #       #   #     #     #   #           #   # # #     # #   #
# ### ### ### ### # ####### ####### # ####### # # # ### ##### # # ### #########
#     #     #           #         #   #       # # #   # #     #     #         #
###############################################################################
