###############################################################################
# # #   #   # # #       #       # #   #     #     #       # #   #   #       # #
# # # # # ### # # ##### ####### # ### ### ##### ### # ### # # # # ### ##### # #
# # # #   #   #       #   #         #           #   # # #     #   #     #   # #
# # # ### # ##### ### ####### ##### ### ### ### # ### # # ### ##### ### ### # #
# #   #   #   # # # # #   # # #   #   #   #   #     # #   # # #     # #   #   #
# # ##### # # # # # # # ### ### # ### ### # ### ##### ##### ####### # ### # ###
#     #   # #   # # #           #         # # #     # #   #   #   #   #   #   #
####### # ### # ### ##### ##### ##### # ### # ##### ### # ### # # ##### ##### #
#       #     #       #   # #   #     #   # #       #   #     # #     # #     #
# ##### ####### # ######### # ### ##### # ### # ##### ### ##### ##### # ##### #
#   # #     #   #       #     #   # #   #   # #     # # # #   #     # #     # #
### # ##### # ##### ### ##### ##### ### ##### ### # # # # # ##### ### ##### # #
#     #   # # #       #     # # #   # #     #   # #     # #   #   # #     # # #
### # ### ####### ### ### # # # ### # # # ####### ######### # # # # ##### # # #
#   #     #   #   #   #   #   #     #   # # # #             #   #   #   #   # #
# ########### # ### # ############# # ### # # ####### # # ########### ####### #
# #         # #   # #     #     #       #   #   #     # # #           # #   # #
# ######### # ### ### ### # # # # # ####### # # ####### ### ########### # # # #
#     #     #     #   #   # # #   #     #   # #   #   #   #             # # # #
##### # ########### ### ### ############### # # ### # ########### ##### # ### #
#     #             #   #             #       #     #                 # #     #
###############################################################################
