###############################################################################
#   #             #   # #   #           #     #       #   #   #       #   #   #
# ### # ####### # ### # ### # ######### ### # # ### # # # # # ### ### # # ### #
# #   #       # # #       # # #     # #     #   #   #   # # #     #     #     #
# # ############### ##### # # # ### # # ##### ### ######### # ##### ##### ### #
# # #   #     #     # # #   # # #   # # # #   #   # # #     # #   #   # #   # #
# # ### # ####### ### # ##### # # ### # # # ### ### # ### ##### ####### ##### #
#   #   #   #   #   #     #     # #   # # # #   # # # #   #   #   # #         #
### # ##### ### ### # ### # ##### # ### # # ### # # # # # ### ### # # # #######
#     #       #   #   #   #   # # #       # #   #     # #         # # # #     #
# ##### ##### # # ##### ####### # # ####### ### # ##### ### ##### # ##### #####
#   #   #   # # #   #             #       #   # #       #   #     #       #   #
### # ##### ##### ### ################### ### ##### ##### # # ##### ####### ###
#   # #       #   # # #   #     #       #   #   # # #     # # #   #       #   #
### # ####### ### # # # # # # ##### ######### ### # ##### # # # ### ### # # # #
#     #   #   #     # # #   # #             #     #     # # #   # #   # #   # #
### ### ### ### ##### # ##### ### ### # # ####### ### # ### ##### ### ####### #
#     #   #   #     # # #   # #   #   # # #     #     #   # #   #       #   # #
### # # ### ##### ### # # ### # ##### ### # ############# # # # # ##### ### ###
#   # # #     # #     # # #   # #   # #   # #   #   #   # #   #   #   #   #   #
# # # # ### # # # ##### # # ### # # # # ### # # # # # # # ######### # ####### #
# # #       #           #         # # #     # #   #   #             #         #
###############################################################################
