###############################################################################
#       #                               #           #     #     #     #     # #
# # ##### # ####### ######### ######### ### ##### # # ### ### ### ##### ### # #
# # #     # #   #   #         # #       #     #   #   #     # #         # # # #
# # # ######### # # ##### ##### # ####### ##### ### ### # ### ### ####### ### #
# #     #     #   # #     #     # #   #   #   # #   #   #     #   #       #   #
# ####### ### ### # # ####### # # ### ### ### # ##### ##### ### ##### # ##### #
#   #   #   #   # # #   # #   # # #   #   #     #     #               # # #   #
### # # # ##### # # ### # # # ### # ################### ### # # ##### ### ### #
# #   #   #     # # # # #   # #                   #     #   # #     # #     # #
# # ##### # ##### # # # # # ### ##### # ####### ### ### # # ##### ### ### ### #
# #   # # #   # # # #   # # # # #     # #   #   #     # # #     # #     #     #
# ### # ##### # # ### ### # # ### ####### # ### ####### # ######### ######### #
#   # #     # #     # #   #   #     #   # # # #   #   # #   #     # #         #
# ######### # ####### ### ######### # # ### # # ### # # # # # ### # # #########
# #       #   #     #   #           # #             #   # # # #   #   #       #
# # # ####### ##### ### # ##### # ### ######### ### ####### ### ### ### ##### #
# # #   #     #       # #   # # # # #   #         #     #     #         # #   #
# # ### # ##### ####### # ### # # # ### # ########### ### ##### # ##### # # ###
#   #   # #     #       # #     # #   # #       #     #   #     #   #   # #   #
# ### ### # ### # # ####### ####### # # ### ####### ############# ####### ### #
#   #     #   #   #   #     #       #   #   #             #             #     #
###############################################################################
