###############################################################################
#   #   # #   #   #     #   # #   #         # # #   # #   #     #       #     #
# # ### # # # # # ### ##### # # ##### ### # # # ### # # # ### # ##### # # ### #
# # #   #   #   #   #   #   #   #       # # #   #       #     #     # # # #   #
# # ### # ##### ### # ##### # ### ### # ### # ### ##### ##### ##### ### ### # #
# # # # # #   # #   #     #       #   #   # # #     # #   #   #   #   #     # #
### # # ### # # ### ##### # ####### ##### # # # ### # # # ##### # ### ####### #
# # #   #   # # # # # #   #   #       # # #   # #   #   #       #   #   #     #
# # ### ##### ### # # # ##### # # # # # # # # # # ### ### # ########### ##### #
#             # #   # # #   # # # # # #   # #   #   # # # #     # #       # # #
##### # ### ### # ### # # ### ### # # ### ##### # ##### ####### # # # ##### # #
# #   # #         # #         #   # # # # #     # #   #     # #   # # # #   # #
# ##### # # # # ### # ##### ##### # ### # ####### # ### ### # # ### # # # # # #
#   #   # # # #       #       #   #   # # #   #         #   # # #   # #   #   #
# ####### # ### ####### # ##### ##### # # # # ####### ### ### ### ####### # ###
#   #   # # #   #       #     #     #   #   # #   #     # #   # #   #   # # # #
### ### ######### # # # ### ############# ### # ### # ####### # ##### ### # # #
#   # #   #       # # # #         #         # #   # #         #     #   # # # #
# # # ### # ### ### # # ##### ### ##### ### # ### # # ##### ### ##### # # # # #
# # #     # # #   # # #     #   # #   # #   # # #   #     # #   # # # #   # # #
# ##### ### # ### # ####### ### ### # # # ##### ##### ### # # # # # # ##### # #
#               # #       # #   #   #   #       #     #   #   #       #       #
###############################################################################
