###############################################################################
#   #     #   #     #     #     #   #   # #         #       #   #       #   # #
# # # ##### # # ### # # # # # ##### # # # ####### # # ####### # # ### ### # # #
# #   #   # # # #     # #   #     #   # #     #   #   #   #   #   #   #   #   #
# # ##### # ####### ### ######### ### ##### # ### # ### # ######### ### ##### #
# #       #     # # #   #       # #     #   #   # #   # #   #       # # #   # #
# # ########### # # # ######### # # ### # ##### ### ### # ### ####### # # # # #
# # # #     # #     # # # # # # #     # # #             #     #     #   # #   #
# ### # # ### ####### # # # # # ####### ######### # ######### # ##### ####### #
#       #   # #   # #   # # # # #     #   #       #     #   # #     #     # # #
# ##### ##### # ### ##### # # # # ####### ### ### # ##### ##### ##### # # # # #
# #   #         # # # # #       #   # # # #   # # #   #     #   #     # # # # #
### ##### # ##### # # # ####### ### # # # ### # # ### # ##### ### ### # # # ###
#   #     #           #       #   # # #     # # #   # #       #   #   # #     #
### # # ##### # ##### ##### # # # # # ### ##### # ##### ### ### ####### #######
#     # #     # #   # #     #   #   #     #   # #   #   #   #   #             #
# ####### ### # # ### # # # # # ### # # ##### # ### # ### ### ####### ####### #
# #     #   # # #   #   # # # #   # # # # #     #   #   #       # #   #     # #
# ### ### ### ##### ######### ### ##### # # ### # # # # ##### ### ### ### ### #
#   #   #   #   #             #         # # #     # # #   # #     # #   # #   #
# # ### ### ########### # ##### # ####### # ####### # ### # ####### ### # # ###
# #       #       #     # #     #                 #   #               #   #   #
###############################################################################
