###############################################################################
#   #   #               #                 #     #         #   #   # #         #
# # # # # ### ##### ### # ####### ##### # ### ### ### ### # # # # # # # #######
# #   # # # #   #   #     #   # # #     #   # #   #   #   # #   #   # # #     #
# ##### # # ### ####### # # ### ########### # # ####### ### ####### # ### ### #
#   # # # #     # #   # # #         #   # #   #     # #   # #     # #     # # #
##### # ### ### # ### ### ### ### ### # # ########### # # # ##### # ####### # #
#     #   # #   #           #   # #   #   #       #     #   #   # #   #   # # #
# ##### # # ####### # # ### ### ####### ##### ### # ##### ### ### # ### # # # #
#   #   # # # #     # # #   #   # #   #   #   #   #   #   #     # # #   #   # #
# # ##### # # ##### ### # ### ### ### # ### ##### ### # ### ##### ### ### ### #
# #   #   # #       #   #   #         # # #   # #   # #   #     # #   #   #   #
### ### ##### ######### ### # # # ##### # # ### ### # # ####### # # # ### ### #
#     #     # #       #   #   # #   #   # #   # #   # #       # #   #   #   # #
# ### # # # # # ##### ##### # # ####### # ### # # ### ######### # ##### ### # #
# # # # # #   #   #   # #   # #           #     # # # #         #   #   #     #
# # # # # ### ### # # # # # # # ### # ##### ##### # # # ########### # #########
#   # # #   #   # # #     # # #   # #       #     # # #         # # #       # #
### # # # # ### ### ####### # ### ########### ### # # ### # ##### # ####### # #
# # #   # # # # #   # #     #   #         #   # # #       #       #     # #   #
# # # ##### # ### ### # ### ### # # ##### ##### # # # ######### ####### # #####
#   # #     #       #   #     # # # #           #   #         #               #
###############################################################################
