###############################################################################
# #                   #       #     #   #         #       #     # # #   #     #
# # ### # ##### ##### ##### # # ### # # # ##### ### ### # # ### # # # # # # ###
#     # # #     # #       # # #   #   #   #     #   #   # # # #     # # # #   #
####### ### ### # ##### ### # # # ######### # ### ### ##### # ##### # # ##### #
#     #   # #   #     #     # # #       #   #   # #   #     #     # # #       #
# ### # ##### ### # ######### ##### ##### ##### # # ####### # # ####### #######
#   # #     #     # # #     #           #   #     #         # #         #     #
# ### ### # # ####### ### ########### ##### ####### ### ##### ##### ####### # #
#   #     # # #     #   #       #   # #   #   #     # #   #       # #       # #
##### ######### ##### # # ##### # ##### # ####### ### # # # ##### # # ### #####
#   #   #       #     # # #   #     #   # # # # # #     # #   #   # # #   #   #
### ### # ####### # ### # # # # ##### ##### # # # ############# ### # ##### ###
#     #           #   #   # #     # # #     #   #           #   #   # #   #   #
# ### # # ##### # ### # ####### ### # # ##### ####### ##### # ##### # # # ### #
# #     # #   # # # # #       #     # #   # #   #     # # #   #   # # # # #   #
### ### # # ##### # # # # ########### # # # ### # ##### # ##### # ### # ### # #
# # #   # # #   #   # # #         #     # #     # #         #   #   # # #   # #
# ####### # # ##### ### # ### ##### ### # ##### # # ####### ##### # # # # ### #
# #         #   # #   # #   # #   # # # #       #   #   # #     # #   #     # #
# # ##### # ### # # ### # # ### ##### # # ### ####### # # ##### ##### ##### ###
#       # #     #     # # #             #   #         # #                     #
###############################################################################
