###############################################################################
#     # #               #     #               #     #   #           #       # #
# ##### ############# ### ### ### ##### # # # ### ### # # ### ### # # # ### # #
#     #           #     #   # #   # #   # # # #       # # # # #   # # #   #   #
##### ########### # ### ### ### ### # # ### # ######### ### ### ##### ##### # #
#   # #         #     #       #   #   # #   #   #       #     # # #   # #   # #
# ### # ####### ############# ### ### ### ####### ### ### ##### # ### # # #####
# #   #   #   # # # #       #   #   # #           #   #   #     #   #   # #   #
# # ### ### # # # # # ######### # # # # ##### ##### ### ####### ### ##### ### #
# #     #   # # # #   #   # # # # # # #     # #   # # #       #   #   #   # # #
# ######### # # # ### # ### # # ### # ### # ### # # # # # ### # # # ### ### # #
#         # # #       #     # #   # #   # # #   #   # # # # # # # # # #       #
# ##### ### ######### ##### # # ### # ### # ######### # ### # # ### # # #######
#     #       #   #       #   # #   # #   # #           #   #   # # # #     # #
### ##### ### ### # ####### ### # ##### # # # ### ####### # ##### # # ##### # #
# # #     #   #   # #       #     # #   # #   # # # # # # #   #     # # #     #
# ### # ### ### ### ##### ### ### # ##### ### # ### # # # ### # # # # # # ### #
#     #   # #       #     # #   # #   #   # #     # #   # #     # # #   #   # #
######### # # ### ##### ### # ### ### # # # ##### # ### # # ##### ### ### # # #
#   #   # # #   #         # # #   # # # # #   #   # #   # # #   # #   #   # # #
# ### # # # ### ######### # ### ### # # # # ### ### ### # ### # ### ### ##### #
#     #   #             #           #   #     #               #         #     #
###############################################################################
