###############################################################################
# #   #     #               #   #             # # #     # # #     #           #
# # # ### # # ############# ### ##### ##### # # # ### ### # ##### ##### # ### #
#   #     # #     # #     #   #           # #   #   #       #     #   # #   # #
# ### ##### ##### # ##### ### ############# ##### # # ####### ##### ####### # #
#   #     # #   # #     # # #                 #   # #     # #   #   #       # #
# ### ####### ### # ##### # ################# ##### ### ### ### # ### ### #####
#   #   #         # #   #         # #   # #         #   #       #   #   # #   #
### ### # ####### # # ### ##### ### ### # ####### ### ### ### # ### # # ### # #
# # #   #     #     #   # #   # #   #     #     #     #     # #     # #     # #
# # # ######### ### # ### ### # # ##### # # # ##### ### ### ### # ########### #
#   #   #   #   #   #   #   # # #     # # # # #   #       # # # #   #   #     #
# ### # # # # ######### # # # # ##### # # ### # # # ######### # ### # # # #####
# #   #   #     #     # # # #     #     # # # # #           #   # # # #   #   #
# ################# # # ### ####### ##### # # ### # # ### ####### # # ####### #
#           #       # # #     #   #   #   #   #   # # # #     #   # #     #   #
##### ##### # ######### ##### # # ### ### # ### ####### # ##### # # # ### ### #
#   # #     # #   #     #   #   #     #   #             #   #   # # # # # #   #
# ### ##### # # # ##### # # ### ### ### ### ### ### ####### # ##### # # # # ###
#     #     #   #     #   #   # #   # #     # #   # #   #     #   #   # #     #
####### ### ####### ##### ### # # ### ##### # ### # # # # ##### # ##### ##### #
#       #         #         #   #         #     # #   # #   #   #             #
###############################################################################
