###############################################################################
#   #     #         #             #   #   #   # #                             #
# # # ##### ####### # ### ####### # # # ### ### # ################# # #########
# #     #   #       #   #   #   # # #     #         # #             #         #
# ##### ### # ####### ####### # ### # # # ### ##### # ##### ### ##### # # ### #
#     # #   #     # #         #     # # # #     # #   #   # #     #   # # # # #
### ### # ######### ### ############### ### ##### ### # ####### # # ##### # # #
# # #     #     #     #       #   # #   #   #   #     # # # #   # # #   # #   #
# # ##### # ### ##### ####### # ### # # ####### ### ### # # # ### # # #########
# # #   #   # #         #   #       # #           #     #     #   # #   #     #
# # # # # ### ### ##### # # # ##### ####### ##### # ####### ### ### ### ##### #
# #   # # #     # #   # # #   #   #       # #     #       # #   #     # # # # #
# ### # # # ### # ### # # # ### # ####### ### ### # ####### # ##### ### # # # #
#     # # # # # # # # # # #     #   #       # #     #   #   # #     #     # # #
######### # # ##### # # # ########### # ##### ### ##### # ### ### ### ##### # #
#     # #   #       #   # # #       # #   #     #       # #     #     #     # #
##### # # ####### ##### # # # ### ### ### ##### ######### ### # ### ### # ### #
#   # #   #     #       # #   #   #   # # #   #   #         # #   # # # # #   #
# ### # ####### # ##### # # ### ####### # # ##### ######### # ### ### # # ### #
#   #   #   #   #     #   # #       # # #   # #     #       #   # # # # #   # #
# # ##### ##### ##### ##### ######### # ### # # # # # ######### # # # # ### # #
# #                       #                 #   # # #         # #       #     #
###############################################################################
