###############################################################################
#   #     #       #     #       #     #   #       #   # # #                   #
# # # ### ##### ### # ####### ### ### # ### ####### # # # ####### ##### #######
# # #   #       #   # # #   #     #   #     #   #   # #     #   # #   #       #
# ##### ##### ### ### # ### ### ##### ### ##### ##### ##### # # ### ##### ### #
#   #   #         #       #   # #   # #   #     # #   #       # # # #   # #   #
# # # ######### ######### ### # # # ### ### # ### ### # # ####### # # ##### ###
# #     #   #     #   #   #   #   #         # # #   #   #   # #   # # #   #   #
######### # # ### ### ####### ##### ########### # ### ####### # # # # # ### # #
#       # #   #     #   #   #   #   # #               #     # # # #   #     # #
# ### # ### ### # ##### # ##### # ### # ############### ### # # ##### # ### ###
# # # #     #   #       #   #   # #   # #   #   #       #   # #   # # # # # # #
# # ##### ### ##### ##### # # ### # # # ### # ### ########### ### # # # # # # #
# #   # # # # #       #   # #       #   #   #   #   #     # #     # #   # # # #
# ### # ### ##### ######### ##### ### # ### # # # ####### # # ### # # # # ### #
# #       #           # # #         # #   # # #     #   #     #   # # # # #   #
# ####### # ######### # # ### # # ### ##### # ####### ### ### ##### # # # # ###
#   #   #   #       #   # #   # # #     #       #       # # # # #     # # #   #
### # # ######### ### # # # ### ### # # # ####### # # ##### # # # # # ### # # #
# #   #   # #   #   # #     #   #   # #   #   #   # # # #   #   # # #   # # # #
# ####### # # ### # ############# ### ### ### ##### ### ### ### # # ##### # # #
#         #       #                 #   #                         #         # #
###############################################################################
