###############################################################################
# #   # #   #   # #           #     #     #           #       #   #         # #
# # # # # ### # # # # ### ##### # # # # # # ######### ### ##### # # ### ### # #
#   #     #   # #   #   #   #   # #   # #   #   # #             # # #   #     #
### ### # # ### # ### ####### ####### ####### ### ############### ### # #######
#     # # #   # #   #         # #   #     #               #     #   # # #     #
# ### # ### # # ### ##### ##### # ####### # ##### ##### # # ### ### # ### ### #
# #   # # # # # #     #   #             # # #   # #   # # # #   # # # #   # # #
# # ##### # # # ####### ### # ############# # # ### # # # ### ### # # # ### # #
# #     # # # #   #   # #   #   #   #   #     #     # # #     #   # # # #   # #
# # ### # # # ### # # # # ##### # ##### # ########### # ######### # # # ### # #
# # #     # # # # # #   #   #     #           # #   # #           #   #   #   #
# # # ####### # # # ##### # ####### ####### # # # # # ############# ##### # ###
# # #     #     #         #       # #   #   #     # #   #     # #       # #   #
# ### # ##### ### ########### ### # ### # ############# # ##### # ##### # #####
# # # #         #     #     #   #   #     #     #     #       #   #   # #     #
# # ############### ### ### # ####### # ### ### # ### ### ### ##### ### ##### #
#           #     #     #   # #     # #     # #   # #   # # #       # #       #
### # ##### # ##### ##### ######### # ##### # ### # ### # # ######### ####### #
#   #   # # #   #   #   # #   # #   # #   # #   #     # #   #         #   # # #
# ### # # ##### ##### ### # ### # ####### # ### ##### # ### # ######### ### # #
#   # #               #         #             #       # #               #     #
###############################################################################
