###############################################################################
# #   #   #           #           # #       #       #   #     # #     #       #
# # ### # ### ### ### # # ### ##### # # # # ##### ##### ### # # # ### ##### # #
#   #   #     #   #   # #   # #       # # # # # # #   # # # # #   #       # # #
### # ######### ### ####### # # ######### ### # # # # # # # ### ####### # # ###
#   #   #   #   #   #       #   #           #       #     # # # # #   # # #   #
# ##### ### # ### # # ### ####### ##### ##### ############# # # # # # # ##### #
#         # #   # # # #   #   #   #             #       #   #   #   # # #   # #
### ##### # ### # ### ### # # # ##### ##### ### # ####### # ##### # ### # # # #
#   #     #     #   # # # # #   # # # #     #   #     #   #   #   #       # # #
# ##### ########### # # # ####### # ### # ### # ##### # ### # # ### ##### # # #
# # #   # #   #       #   #   # #       # #   #   #   #   # # #   #     # #   #
### # ### # ### ######### ### # # ############### # ####### # ### # ##### ### #
#   # #   #             #     #   #     #       # # #       #     # #   # #   #
# # # # # # ########### ########### # ##### ### # # ### ### # ### # ### # # ###
# #   # # #   #     # # #   #       #   #   #           #   # #   #   #   #   #
# ##### ##### # ### # # # ############# # ### ### # ##### # # # ##### ####### #
# #           # # # #   # #   #   #     # # # # # # # #   # # #     #     #   #
# # ####### # # # ### ### ### ### # ### # # # # # ### ### ### # # ####### ### #
# # #   #   # #       #     #   # # #   # # # #   #     #   # # # #     # #   #
# ##### # ############# # ##### # ### ### # ### ### ### ### # # # ##### ### ###
#       #   #           #                     #       # #   # # #     #       #
###############################################################################
