###############################################################################
#   #   #   #   #   #       #   #     # #     #   #   #       #   #           #
# # # ### ### # # # ### ### # # # # ### # # # # ### # # ##### # ### ### ##### #
# # #   #     # # #   # #   # #   #   #   # #   #   #       # #     # # #   # #
### # # ### ### # ### ##### # ####### ##### ### # ########### ####### ### # # #
#     #     #   # # # #     #     #       #   # #       #   #     #   #   #   #
# ####### # ### # # # ##### ### ############# ##### ##### # # ### # ### #######
# #     # #   #     # #       #   #           #     #   # # #   # #   #   #   #
# ### # # ################### # # # ##### ### ####### # # # ##### ### ### # # #
#     # #   #                   #   #       #       # # # #     #       # # # #
# ##### ### ##### ### ############################# # # # ##### ####### # ### #
# #       #     #   #               #     #   #   #   # # #         #   #     #
# # ##### # ### # # ######### ########### ### ### ### # # # ####### # ####### #
# # #   # #   #   #         # #   #     #   #   # #   #   # #   #   # # #     #
# # ### # ### # ##### ### ##### ### ### # # ### # # ####### ### # ### # ### ###
# # #     #   #   #   # #     #   #   #   #       # #     #   # # #   # #   # #
### ##### # ##### # ### # ### # # ### ##### ##### # # ### # ### # ### # ### # #
#   #     # #     #     #   #   # # # #   # #   # # # #   #     #     # #   # #
# ##### ### ######### ########### # # ### # ### ### # ####### # ### ### # ### #
#   # #   # #   #   # #     #   #   # #   #   #   #   #     # #   # #   #   # #
##### ##### # ### # ### # # # # ##### # # ### # ##### ##### # ##### # # ### # #
#                 #     # #   #         #   # #           #       #   #       #
###############################################################################
