###############################################################################
#     # #     #     #     # #             #     #       #     # #             #
# ### # # # ##### # ### ### # ######### ##### # # # ### # # ### # ########### #
# #     # #       #               # #         # # # # #   # # # #     #       #
# ####### # ##### ######### # # # # # ######### ### # # ##### # ### ###########
#         #     # # #   #   # # #   #         #       # #         # #     #   #
### ##### ####### # # ### ### ##### ### ####### ### ##### ### ##### # # # # # #
# #     # #     # # #     #     # #   # #         #     # #   #   # # # #   # #
# ### # ### ### # # # ### ##### # ##### # # ########### # # ### ### # # ##### #
#   # # #   #     #   # # #     #   #   # #   #   #       #   #     # #   #   #
# ### # # ############# ##### ### ### ######### # ### ##### # ##### # ### # ###
#     # #     #   #             #               #   # #   # # #     #   # #   #
####### # ####### # # ### ####### # ####### # ####### # # ### # # ##### # #####
#       # #     #   # # # #     # #   #     # #   #   # #   #   #   # # # #   #
##### ### # ### ##### # # ### # ##### ##### ### ####### ### ### ### # # # # ###
#   # #   # #   #       #   # #     #   #   #           #     # # #   # # #   #
### # ##### ### ####### ##### ### # ### # ### # ######### # ### # ##### ### # #
#   # #   #   #       #     # # # #   # #     #   #   #   #   #       #   # # #
# ##### # # ####### # ##### ### # ### # ##### ##### # ####### ####### ### ### #
#       #   #     # # #         #   #   #   #   # # #       # #   # #     #   #
##### ##### ##### # ### ########### ##### ### # # # ##### # ##### # ####### # #
#         #     #       #                 #   #     #     #                 # #
###############################################################################
