###############################################################################
#                   #   #               #   #       #   #     #       #   #   #
# ########### # # ##### ### # ### ##### # ### ### # # # ##### # ##### # # # # #
#       #   # # # #   #   # # #   # #     #   # # # # #   #   # # #   # #   # #
# ######### # ### ### # # ### # ### ### # # ### # ### # # # ### # # ######### #
#   #     # #   #     # #     # #     # #       # #   # # #     #   #     #   #
### ### ### # # ### # ### # # # # ### ### ####### # # # ### ##### # # ### # # #
#     #     # # #   #   # # # # #   # #       #     # #   #     # #   #     # #
# ######### # ### ### # # ### # # ##### ####### # ####### # ### ####### #######
# # #     #     #   # #   #   # #     #   #     #       # # #       # #     # #
# # # ### ### ### ### ######### # ### ### # ### ####### # # # ##### # ##### # #
# # # #   #   #   # # #   #         # #   #   # #     # #   #   # # #     # # #
# # ### ### # ##### # ### ### ### # ### ### # # ### # # ### ### # # # ### # # #
#   # #     # # #         # # #   #   # # # # #   # # # #   # # #   # # # #   #
##### ####### # ######### # # ##### ##### # ####### ##### ### # ##### # ##### #
#       # #   #       #     # # #   #   # #       # #       #         #       #
# # ### # # ######### ######### # ### # # ####### # # ####### ####### ##### ###
# # #     #       # #       #   # #   # #     #   #   #       #   # #   # #   #
# ### ########### # ####### # ##### ### # ### # ####### ##### # ### ##### ### #
# #   #       #   #   #           # #   #   # # #           #     # #     #   #
# ##### ##### ### # ### ### ##### ### # # # ### ##### ### # ##### # # ##### ###
#       #           #   #       #     #   #         # #   #     #   #         #
###############################################################################
