###############################################################################
#   #     #   #       #                 # #             #             # #     #
# # # ### # # # ##### ####### ########### ########### ### ### ### ### # # ### #
# #   #   # # # #   #       # #   #         #       #   #   #   #   #       # #
# ##### ### ### # ##### ### # # # # ####### ### ### # # ### ##### ### ### #####
# #   # #       # #   # # #   # # # # #   #     #     # #   # #   #     #   # #
# # # # ### # ### # # ### ##### # ### # # ##### ##### # # ### # # # ####### # #
#   # #     # #   # # #     #   #     # #     # # #   #   #   # # #   #   #   #
### ####### ### ### # # ##### ##### # # ### # # # ### ##### # # # # # # ### # #
#   # #   #     #   #   #         # #   #   #   #     #     #   # # #   #   # #
##### # # ### ### ####### ####### ####### ####### ##### ####### # # # ### ### #
#     # #   #   #   #   #       # #       #   #   # #   # #     # # #   # # # #
# ##### ### ### ### # # ####### ### ######### # ### ### # # ### # # ##### # ###
# #       # # #       #     #     # #     #   # # # #   #   #   # # #     #   #
# ####### # # ######### ##### ##### # ### # ##### # ### ####### ##### ####### #
# #       #   #   #     #     #   #   #   #   #   #   # # #   # #   # #       #
# # ######### # # # ##### # ### # # ### ##### # # ### # # # ### # # # # ##### #
#     #       # # #       # #   # #   #     #   #       #       # #     # #   #
# ### ######### # # ### ### ##### ####### # ############### ##### ### ### ### #
# # #   #       # # # # #       #         #       #     #   #       #   #   # #
# # ### ### ### ### # ### ##### ############### ##### # # ######### # # ### # #
#     #       #     #       #   #                 #   #           # # #     # #
###############################################################################
