###############################################################################
#       #   #   # # #     #       #   #         #   #   # #     #             #
# ### ### # # ### # ##### # # ### # # ##### # ### ### ### # ### # # # ### ### #
# # #     # #     #   # #   #   # # #       #     #   #     #     # # # #   # #
# # ####### # ##### # # ### # # ### ##### ##### # ### # # # # ####### # ### # #
#   #   # # #       # #   # # #     #   # #     #   #   # # # #       # # # # #
### # ### # ####### ##### # # # ### # # ### ##### # # ####### # ####### # ### #
#   #     #   #     #       # # #   # #     #     #   #   # # #   #     # #   #
# ### ##### # # ##### ######### ### ##### # # ### ### # # # ### # ### ### #####
#   #   #   # # #   #   #       # # #     # #   #   #   #     # # # #       # #
# ##### ##### # ### ##### # # ### ### ##### ### ##### ##### # ### # # ####### #
# #   #     # # #   #   # # #   #     # # # # #   #   #   # #   #   # #       #
# ### # ### # # # ##### # # ### # ##### # ### ### ##### ### ### ### # # ### # #
# # #   #   # # # #   #   #   # # #   # #               # # #   # # # # # # # #
# # ### ##### # # # # ##### # # # # # # ### ##### ### # # # # ### # # # # ### #
#     #   #     #   #   #   # # #   # #   # #   #   # #   # #     # # # #     #
# ####### ##### ##### ### ##### # # # ### # # # ### ####### ######### ####### #
# #       # #     #     #   # # # # # #   #   #   # #   #     #               #
### ####### # ##### ### # ### ##### ### ############# # # # # ### # ##### #####
#   #       #         #   #     #   #     #   #     # # # # #   # #   #   #   #
# ######### ######### ##### ### ##### ##### ### ### # ### ##### ##### # ##### #
#                           #         #         #         #           #       #
###############################################################################
