###############################################################################
#   #                     #     #             #           # #   #     #       #
# # # ####### ##### # ### # ### # ####### ### ##### ##### # # # # ### ### ### #
# # # #       #   # # # # #   #   #       #   #   #     #     # #   #   #   # #
# ##### ####### # # # # # ### ######### ##### ### ##### ### ### ### # ##### ###
#   # # #   # # #   #   # #       # #   #     # # #   #   # #       # #       #
# # # # ### # ### ##### # # ####### ##### ##### # # # # # # ####### # ### ### #
# # #   # # #       #   #             #   #   # # # #   # # # #   # #     # # #
### ##### # ####### ################### ##### # # # ####### # # ### # ##### # #
#   #     #       # #         #         #   #         # #     # # # # #       #
# ### ####### ####### # ### # # ### # ### ### ### ### # ####### # # ##### #####
# # #       # #   #   # #   #   #   #   #       # #   #         # # #   # # # #
# # # ##### # # # # ########### ####### ### # ### ### ##### ##### ### ### # # #
# #       # #   #   #   #   #   # # #   #   # #     #     #   #   #   #     # #
# ####### # ### ##### # # # # ### # ### # # # # ### ##### ### # ### ####### # #
#       # #     #   # #   #   #         # # # # #   #   #   # # #         #   #
####### ##### ### ### ##### ### ####### # # ### # # # # ### # # # ####### #####
#   #   #         #   #   # # # #     #   # #   # # # # #     #         # #   #
# ### # # ######### ##### # # # # ### # ### ####### # ####### ##### ### ##### #
#     #   # #   #   #     # #   #   # # #         # #       # #     #   #     #
# ######### ### # ### ### ##### ### # ### # # ##### ##### # ### # ### ##### # #
#             #       #       #     #   # # #   #         #     # #         # #
###############################################################################
