###############################################################################
#   #     #     #     #     #           #   #           #   #       #     #   #
### ### ### # ### # # # ##### ####### ##### # ### ##### # ### ##### # # # # ###
# #       # #     # #   #         # #         # # #   #       #     # # #     #
# ####### ### ########### # ### # # # ######### # # # ######### ### # # ##### #
#     #     #     #   # # #   # #   #   #         # # #   # #   #   # # #   # #
# ### # # ##### # ### # # # ### ########### ####### # ### # # ### ##### # # # #
#   #   #     # #     #   # #     #       # #   # # # #   #     #     # # # # #
##### ####### ####### ####### ### # ######### ### # # # ### ####### # # ### # #
#     #     #       # #   #     #   # # #   # #   # # # # #   #     # #   #   #
# ##### # # ##### ### # # ### ####### # # # # # # # # # # ##### ##### ### ### #
#     # # # # # #   # # #     #     # # # #   # #   # # #   #   #           # #
# # # ### ### # ### # # # ##### ##### # # ######### # # ### # ##### ### ### # #
# # #     #   #     # # # # # #     # #       #   # # # #   # # #   #   #   # #
# ### ##### ##### # # # ### # ### ### # ### ### ##### # # # # # ### ##### ### #
# # # #       #   #   #   #       # #   # #   # #     # # #   #   # #       # #
# # # # ####### ####### # ####### # # ### # # # ### ### ####### # ######### ###
# # #   #   # #     #   #         #   #     #     #   # #     # # #       #   #
# # ####### # ##### ####### ### ### ### ### ##### ### # # ### # # ### ### ### #
# #     # #                   # #     # # #     #   # #     #   #   #   #     #
# # ### # ##### ####### ############# # # # # ####### ##### ##### ##### #######
#   #   #       #                     #   # #             #     #             #
###############################################################################
