###############################################################################
#       # #   #   #     #   #   # #   #           #           #         #     #
# ##### # # ##### # # ### # # ### # # # ### ##### ### ##### ### ####### # #####
#   # # # #     #   #   # # #   #   #   #   #             #   #   #   # #     #
# # # # # # ### ####### # # # # ####### # ### # # ##### ##### # # # # # # ### #
# # #   # #   #   #       #   #   #     #   # # #     # #       #   # # # # # #
### # # # ### # ### ############# # ####### ### ####### ############# ### # # #
# # # # # #   # # # #               #     #   # #           #       # #   #   #
# ##### # # ### # # # ######### ### ##### ### # ### ##### # # # ##### # ##### #
#         # #   #   # #       #   # # #     # # # #     # # # #       #     # #
### ####### ####### ### ### # # ### # # ### ### # ##### ### ####### ######### #
# #               #   #   # #   #   #   # #       # # # #   #     # #   #     #
# ############# # ### ### ############# # # ### # # # # # ### ##### ### # ### #
# #     #       #   #   # #     #     # #   #   #     # #     #     #   # #   #
# # ### # ######### # # ### ### ##### ######### ############# # ##### ### #####
#   # #       #   #   #   #   # #   #                     #   # #       #   # #
# ### ######### ######### ##### # # ####### ############# # # # # # ### ### # #
# #       #     #     #       #   #   #           # # #   # # #   #   #     # #
# ### ### ##### ##### ####### ##### ### # ####### # # # ### ### ##### ### ### #
#   #   # #       # #       #   # #     #   # #     #   # # # #   # #   #   # #
### ### # # ##### # ##### ##### # # ####### # # ### ### # # # ##### ### ### # #
#       #   #           #         #   #       #   #   #   #   #           #   #
###############################################################################
