###############################################################################
#           #         #     #   #     #   #     #           #         # #     #
# ####### ### ##### ### ### # # # ### # ####### # ####### ### ### ### # # # # #
#       # #   #     #   #   # #   #     #     # #   #         # # #   #   # # #
# ##### ### ### ##### ### ### ############# # # # ### # # ##### # ### ##### ###
# #   #       # #     #       #     #     # #   # # # # # #         # #       #
# # # ######### # ##### ########### # ### # ### # # ### ### # ### # # # ##### #
# # #   #       # #   # #   #   #     #   # # #   #   # #   #   # # # # #   # #
# # ########### # # ### # ##### ####### ##### # # # ### # # # ##### ##### # # #
# #   #     #   # #     #   #   #           # # #   #   # # #     # #     #   #
##### # ### # ### ######### # ########### ### # ##### ### # ######### ####### #
#     #   # #     #       # #     #   # #           #   # #           # #     #
# # ##### # # # ### ##### # ### ### ### ### # ### # ################### # #####
# # #   # # # # #   # #     #   #   #       #   # #     #     #         # #   #
### # # ### ### # ### ### ### ##### # ######### # ##### # ### ##### ### # ### #
# #   #             #   #     #       # # #     # #       #       #   # # #   #
# ### ################# # ########### # # # ### # # # ############# # ### # ###
#   # #         # #     # #     #     #     # # # # #     #     #   #   # #   #
# # ### ### ### # # ### # ### # # # ####### # # # # ### # # # # # ##### # ### #
# #   #   #   #   # #         #   #   #   # # # # # # # #   # # #   #   #     #
# ### # ##### ### # ############### ### # ### # ### # ##### # ####### ##### # #
#   #       #   #   #                   #   #   #   #       #       #       # #
###############################################################################
