###############################################################################
# #   #     #         #         # #             #       # #       #       #   #
# # # # ##### ####### # # ####### ##### ### # # # ##### # # ##### ####### # # #
#   #   #     #   # # # #     #       # #   # #   #   # #       # #       # # #
# ##### # ##### # # # ### ### # ##### ### ##### ### ### # ##### # # ######### #
#   #   # #     # # #     #   # # #       #   #   #     #   #   # #           #
### ##### # # ### # # ### # ##### ##### # # ####### ##### # ### # ### ##### ###
#       # # #   # # #   # #       #   # #   #   #         #   # #   #   #   # #
### # # # ### # # # ### ### ####### ### ### # # ############# # ######### ### #
# # # #       # # # #   #   #   # #   # # #   #   # #   #     # #         #   #
# # ############### ####### # # # ### # # ##### # # # # # # ### # ### ##### # #
# # #     #   #     # #   #   #       # # #     # #   # # #   #   # #   #   # #
# ### ##### ##### ### ### # # # ### ##### # ##### # ##### ######### # ### # # #
#     #     #   # #         # #   # #     #   # #   #   #       #     #   # # #
# ####### ### ### ### ##### # ### ### ##### ### ##### # ####### ####### ### # #
#         #   #       #     # # #   #           # #   #       #       # #   # #
# ######### ### ##### # # ### # ##### ########### ### ### ########### ### ### #
# #         # # #   # # # #   #     #             #     #   #   #       # #   #
# # ####### # ##### # # ### ### ### # ### # ####### ### ### # ### ### ### # ###
#   #     #   #       # # # #   # #   #   # #     #   #   # #       # #   #   #
##### ### # ### # ### ### # # # # ### # # # # ### ### # ########### # # ##### #
#       #       # #   #       # #     # # #   #       #     #       #   #     #
###############################################################################
