###############################################################################
# #       # #             #             #   #         #       #     #     #   #
# # ### # # # # ######### # ####### ### # ### # ##### # ####### ### # ### # ###
# #   # #   # #   #   #   #       # # #   #   #   #   #   #     # #   #   #   #
# ### # ######### # # # ######### ### # ### ############# # ##### ##### ### # #
#   # #   #   #   # #   #     # # #   #         #   # #   #     # #     #   # #
### # ### # # # ### ### ##### # # # ######### # # ### # # ### # # ####### ### #
# #   #     # # # # #   #   # #   # #     #   # #   #   #   # # #   #     #   #
# ##### ##### ### ### ### # # # ### # ### # ### # ### # ### ### ### # ####### #
#     # #       #   # #   #   # #   #   # # #   #   # #   #     #           # #
##### # # ##### ### # # ##### # # ### ############# # ### # ################# #
#     # #   #     #   # #     #       #     #       # #   #       #         # #
# ### # ### ### ##### ### ####### ##### ### ### ##### # ######### # ####### # #
# #   #   #   # #         #   # #   # # #   #       # #     #     #   #     # #
### # ##### # ### ####### # # # # ### ### ### ##### # ### # ### # ##### ##### #
# # # #   # # #     # #   # #   #   # #   # #   #   #   # # # # #       #     #
# # ### # ### ### # # # ##### ### ### # ### # # # # ### ### # ########### ### #
# #     #         # #   #   #         #     # # # # #   #   #   #     #   #   #
# ################# ### ### # ####### ### ##### # # # ### ### # # ##### ### ###
# #         #         # #           #     #     # # #   # #   # # #     # #   #
# ##### # # # ####### # ### # # ### ### ##### ### # ### ### ##### # ##### ### #
#       # #   #       #     # # #   #         #   #                 #         #
###############################################################################
