###############################################################################
# #     #   #             # #   #           #           #       #             #
# # ### # # ####### # ### # ### ### # ### ### ####### # ##### # ### # ####### #
# # # # # #   # #   #   #     # # # #   # #   #     # # #     #     # # #   # #
# # # # # ### # # ##### ### ### # ##### # ##### ####### # # ####### ### # ### #
# # # #   #   # # #     # # # # #   #   # #             # # #           #   # #
# # # ##### # # # # ##### ### # ### ##### ######### ##### # ### # ######### # #
#   #   #   # #   #       # # # #     # # #   #     #   # #   # #   #       # #
# ### ### ### # ########### # # ##### # # ### ### ##### # # # # ### ### # ### #
#     #   #   #   # #     #           #           #   # # # # # # # #   # #   #
##### # ######### # # ### ######### ############# # ### # ##### # # # ### # ###
#     #   #   # #   #   #           # #   #   #   #   # #   #     #     # # # #
####### # ### # ### ### ##### # ### # # ### ### ##### # ### ##### ##### # ### #
#       #         #     #   # # # #   #   # # # #   # #   # # # # #   # #     #
# # ### ### ############### ### # ### # # # # # ### # # ### # # # # ######### #
# #   #   # #   #   #     #   # #   #   #   #     #   # #   # #   # #         #
# ### # ### # # # # # # ### ### # # # ##### # ####### # ### # # ### ####### ###
#   # #   # # #   #   #   #     # #       #   #       #       #         # # # #
### # ### ############# # ####### ##### # ### # ####### ### ####### ### # # # #
# # #   #   #           # #   #   #   # #   # #       #   #     # # # #   #   #
# # ### ### # ########### # # # # # ##### ### ##### # # # ##### # # # ####### #
#     # #     #             #   # #         #       #   #   #   #   #         #
###############################################################################
