###############################################################################
#   #   # #       #   #   #     #   #   # #   #       #     #             #   #
# ### # # # ### ### # ### # ### # ### # # # # ### ##### # # ##### ####### ### #
#   # #   #   # #   #     #   #   #   #     #   #       # #       #     #     #
### # # ### ### # ####### # ####### ### ####### ### ##### ####### # ##### ### #
# #   #     #   #   #     #       # # #       #     # #   #   #   #     #   # #
# ### ### ### ##### ############# # # ##### ##### ### # ##### # ### ### ### # #
# #   #   #   #     #     #         #     # #   #   #     #   #   # #   # # # #
# ### ##### ### ######### ### ### ####### ### # ####### # # ##### # # ### ### #
# # # #   #     #         #   # #   #   #   # #   #     #   # # # # #   #   # #
# # # ### ####### ##### ### # # # # # # ### # ##### ##### ### # # ### # # ### #
#                 #       # # # # # # #     #           #     # # #   #   #   #
# ####### # ##### # # ### # ### ##### ##### ####### ### ####### # # ##### #####
#     #   #   #   # # #   #   # #         #     #     #   #   # # # #   #     #
### # ################# ### # # ### # ################### # # # # # ### ##### #
# # #   #       # #   #   # # # #   # #   #     #   #   #   # # # #   #     # #
# ####### ### # # ### # # # # # # ### ### ##### # # # # # ### # # ### ### ### #
#     #   #   # # #     #   # # # # #   #   #     # # # #   # # # #   # #     #
# ### # # # ##### # # ##### # # # # ### ### # ##### ### ### # # # # # # #######
# # #   # #     # # #   #   #   # #     #   # #   #   #   # #   #   #   #     #
# # ########### # ### # # ####### # ##### ### ### ### ### # ####### ######### #
#     #               # #         #                 #     #       #           #
###############################################################################
