###############################################################################
#       #   #       #       # #   #   #       # #       #           # #   #   #
### ### ### ### ##### ##### # # # # # # ##### # # # ### # ### # ### # # # ### #
#   #     # #   #     #     #   # # #       #     # # #     # # # # #   #     #
# ### ##### # ### ##### ### # # ############### # ### ######### # ### ##### # #
# #     #   #     #   #   # # # #       #       #       # #     # #       # # #
# ####### ##### ### ### ##### # # ##### # ### # ### ##### # ##### ####### # # #
#             # # #         # # #   #   #   # # #     #   #   #   #       # # #
############# ### # # ####### ### ### ### ####### ##### ##### # ### ####### ###
#       #     # #   #           # #   #   #       #     #       #   #     #   #
# ####### ### # ### ####### ### ### # # ####### ### # ########### ####### #####
#       #   #     #   # #     # # # # #     #       #   #   # #               #
# ##### # ####### # ### ##### ### # ### ####### ####### ### # # ############# #
#   #   # #   #     #   #       #       # # # # #     # #   # # # #       # # #
### # # ### # # ### # ### # ####### ##### # # # ### # # ### # # # # # ##### # #
#   # #     #   #   #     # #     #   #             # #   #   #   # #   # #   #
# ### ################# ### # ### ##### # # ### ### ####### ##### # ### # # ###
# #     #   #     #     # # #   # #   # # # #   #       #   # #     #   # # # #
# # ### # # ##### # ##### # ##### ### # # # ##### ##### # ### # # ### ### ### #
# # # #   #   # # #   #             # # # # #   #     #   #   # # # # #     # #
# ### ####### # # ##### ####### ##### # ##### # ### ### ### # # ### # ### # # #
#   #           #             #         #     #       #     #   #         #   #
###############################################################################
