###############################################################################
#   #       #           #     #                   #     #             #       #
### # # ### ##### ### ### # ### ### ### ########### ### ##### ##### # # #######
#   # # #   #   # #   # # # #     # #   #         # #   #   # #   # # # #     #
# ### # ##### # ### # # # ########### # # ####### ### ### # ### ##### # ##### #
#     #       # #   # # #   #       # #   # #   #     #   #   #       #     # #
# ############# # ### # ### # # ##### ##### ### ##### # ####### # ##### ### # #
# # #           #   # #       # #     #     #       # # # # # # #   #   #   # #
# # # ##### # ##### ### ##### # # ######### ### ##### # # # # # ######### ### #
#   # #   # #     #     #   # # # #   #             #   # # #           # #   #
### # ### # ##### ####### ### # # # ### ######### ##### # # ### # ### ### # ###
#   #     # #   #     #   #   # # # #   #         #   # #   # # # #     #     #
# ####### ### ####### # ### ### # # # ### ####### # ### # ### ### ##### # ### #
# #     # # #       #       #   #   # #   #     #   #               #   # #   #
# # ##### # # ### ########### ### ########### ### ##### # ########### ### # ###
# #   #   #   # #     #       #   # # #   #   # #   # # #           #     #   #
### ### # # ### ##### # # ##### # # # # ### ### ### # # ### # ##### # ####### #
# #   # # # # #       # #       # #   #   #             #   #   # # # # #   # #
# ### ##### # ####### # ####### # ### ### ######### ### ### ##### ### # # ### #
#   #       #   #     # #     # # # #   #   #     #   #   # # # # #   #   #   #
# # ### ##### ### # ### # ### ### # # ##### # ### ######### # # # # ### ### ###
# #         #     #     #   #       #           #               #       #     #
###############################################################################
