###############################################################################
# #       # #         #   #               #         #   #   #       # #   #   #
# ####### # # ##### ### # # ############# # # ### ### # # ##### # ### # ### ###
#   #     #     # # #   # # #     #   #     # #   #   #         #     # #     #
### # ##### ### # # ##### # ##### ### # ####### ### ##### # # ######### ##### #
#   # #   # # # #   #   #   #   #   #       #   #       # # # #   #     #     #
# ### # # # # # ####### ####### ### ######### # ### ### ####### # # ##### #####
# #     #   # # #       #       # #   # # #   # #   #           #   # #   #   #
# ##### ### # # # ####### # ##### ### # # # ####### ##### ######### # # # ### #
#     #   # # #           #       #   #                 #       #     # # #   #
##### # ### # ##### ############# # ############### ### ##### ### ##### ### ###
#     # # #       # # #   #       #     #         #   # #   #   # #   # #     #
# # ##### ####### # # # ##### ### ### # # ##### ####### ### ### # # # # ### ###
# # #           # # # #     # # # #   #   #       #           # #   # # #     #
# ### ######### # # # ##### # # ### ########### # # ##### ##### ##### # ##### #
#   #       # #   #         # #     #     #   # #   #     #   # # #   #     # #
### ####### # ############### ########### # # ##### ##### ### ### # ####### # #
# #     #   # #   #         #           #   #   #       # # #   # # #     # # #
# ##### # ### # # # ####### # ####### # ##### # ### ### # # ### # # # # ### # #
#     # #   #   # #   #   # # # #     #       #     # # # #   # # #   #     # #
# ### # ### # ### ### ### # # # ### # # ######### ### # ### ### # ##### ##### #
#   #       #   #         #       # # #     #         #         #             #
###############################################################################
