###############################################################################
#   #           # #         #   #       #         #       #         #   #   # #
# # # ##### # ### ### ### ### # ##### # # # ##### # # ##### ##### # # ### # # #
# #   # # # # #     #   # #   #       # # # #   #   #   #   #     # # #   #   #
### ### # # # # ##### ### # ########### ### # # ####### ### ####### # # ##### #
#   #     # # #     # # # # #     #   #     # #       #   # #   # #   # #   # #
# ### ### ### ##### # # # # ##### ### # ##### ############# # ### ### # # ### #
# # #   #   #     # # #   #   # #   #   #   #     #         #   #     # #   # #
# # ### ### ### # # ##### # # # ### # ### # ### # # ########### # ##### ### # #
#     # # #   # # # # #   # # #     #   # #     #       #       #     # #   # #
# ### # # ### # ### # # ##### ##### ### ##### ### # ### # ############# # ### #
#   # #   #     #     #     #         # # #   # # #   #   #             #     #
# ### ### # ####### # ### # ##### ####### # ### # ### # ### ### ############# #
#   #   # #   #     #   # #   #   #   #   #   #   # # # #   #     # #       # #
######### ### # # ##### # # ### ### ### # # ####### # # ##### ### # # ####### #
#     #   # #   # #     # #         #   # # #       # # #   # #   #   #       #
# ### # ### ##### ### # ####### ##### ### # # # ####### # ### ####### ### #####
#   # #   # #     #   #       #   #     #   # #       #       #     #   # #   #
# # # ### # ####### ######### # # ##### ##### # ############### ##### # # ### #
# # #   #   #       #   #       # # #   #     #   #           #   #   # #   # #
### ########### ####### ##### ### # # # # ##### # # ##### ### # ####### ### # #
#                 #           #       #   #     #   #       #           #     #
###############################################################################
