###############################################################################
#   #                     #       #         #         #   #         #   #     #
# ### ####### ######### ##### ### # ### ##### ####### # ######### # ### # ### #
# #     #     #     #   #     #   #   #       #           # #   # #     # # # #
# # ##### ##### ### # ### ### ##### ######### ### ####### # ### # ####### # # #
#   #   #     #   #   # #   #       #   #   #   #     #   # #   #           # #
##### # # ### ### ##### # # ######### # # # ### # ##### ### # ############### #
#     # # #   # # #   # # #           #   # #   # #       #   #     # # #     #
# ##### ### ### # # # # ######### ######### ##### # ####### ### ### # # # # ###
# #   # #   #   # # #   #   #     #   #       #   #   #   # # # #   #   # #   #
# # # # # ##### # # ##### # # # ##### ### ##### ##### # ### # ### ##### # # ###
#   # # #     #     #     #   # #       # #   # #     #           #     # # # #
##### # ##### ##### # ################# # # # # ########### ##### # # ### # # #
#     #   #   #   # # #   #     #       # # #         #   # #     # # # # # # #
# ####### # ### # ### # # ##### # ##### ### # ########### # ####### # # # ### #
#     #     #   #     # #   #     #     #   # # #   #       #       #   # #   #
##### # ##### ######### ### # # # ##### # ### # # # # ####### ### # ##### # ###
#     # #     #     #   # # # # #   # #   # #     #           # # # #   # # # #
### ##### ##### ### ### # # # ### ### # ### ############### # # ####### # # # #
#   #   #   #   # #   # # # # #   #   #   #     # #   #   # # #         # #   #
# ### # ### # # # ### # # # # ##### ##### ### # # ### # # # ### # ##### # # # #
#     #     # #     #   #         #           #     #   #       # #         # #
###############################################################################
