###############################################################################
#             #           #           #         #         #   #   #   #     # #
# # # ######### ####### ### ######### ##### ##### ####### # # ### # # # ### # #
# # #                 #   # # #       #   #       #     #   #   # # # # # #   #
### ################# ### # # # ####### # ######### ### ### ### # # # # # # ###
#         #         # # #   # #         #   #   #   # #   #   # # # #   #   # #
# ####### ####### ### # ### # ### ### ### # # # # ### # # ### ### # ##### ### #
#       # #     #   # #   #   #   #   #   # # # #   #   # # # # #   #       # #
####### # # ### ### # ### ##### ####### ### # ##### ##### # # # ### ######### #
#     # #   #       #   # #       #   #   # # #   #   #   # # # #   # #       #
# # ### ##### ########### # ####### ##### ### ### ### # ### # # # ### # # #####
# #     #     #         #           #         #     # #   #           # #   # #
####### # ##### ####### ####### ####### ####### ##### ### ### ### # ### ### # #
#     # # #   # # #                   #   #             #       # #     #     #
### ##### ### # # # ####### ######### # ### ################### # ####### ### #
#   #     #   #   # #         #   #   # #       #   #       #   #     #   # # #
# # # ##### ### ### ######### ### # # ### ##### # # ### ### # ### ### # ### # #
# # # #   #     #   #     # # # #   #   #   #   # #   # # #   #   # # # #   # #
# ##### # # ######### ### # ### # ### # ### # ####### ### ### # # # # # ### # #
#       # #           # #       #   # #     #   #       #     # #   # #   # # #
# ##### ######### ##### ##### # ### ############# ####### ######### ##### # # #
#     #                   #   #   #               #           #     #       # #
###############################################################################
