###############################################################################
#   #   # #               #     #       #   #         #     #     #     #     #
# ### # # ### ##### ### ### # # # ##### # ### ####### # ######### ### ### # ###
# #   # #   #     # #       # #   # #     #   #     # #         #   #     #   #
# ##### # # ##### ### ### ### # ### # ##### ### ##### # ####### ### ######### #
#     #   # #   # #     #   # #     # #     # #   #   # #   # #   # #       # #
# ####### ##### ### ### # # # ######### ##### ### # ### # # # ### # ### ##### #
#   #   # # #     # # # # # # #   #   #         # #       #   #   #   # #   # #
### ### # # # ### # # # ##### # # # # ### ####### ##### ####### ##### # ### # #
#   #   #     #   #   # # # #   #   #   #       #   #   #     #   #     #   # #
# ### ######### ### ##### # ########### # ##### # # ##### ### ##### ##### ### #
#   #       # # #       # #       #     #   #     #       # #             #   #
# ######### # # # # ### # ### # ##### ######### # ######### ####### ####### ###
# #         #   # # # # #   # # # #   #         # #       #     # #   #       #
# # # ######### ### # # ### ### # ########### ##### ##### ##### # ### ##### # #
# # # #     # #   #   #     #   #             # #   #   #         # #     # # #
# # # # ### # ### # ####### # ### # ### ####### # ##### # ######### ### # ### #
# # # #   #   #   #   #     #     # #   #       #       #   #           #     #
# # ##### ####### ### # ##### ### ### # ### # ##### ##### # ###################
# #   #           #   # #     #   #   #     #       # #   #     #             #
# # # ####### ##### ### ##### # ##################### ### # ### # ########### #
#   #                 #       #               #           #   #   #           #
###############################################################################
