###############################################################################
#         #     #   #     #     #           # #         #     #       #       #
######### # ##### # # ### ### # # ######### # # ##### ### ### # ##### ####### #
#     #   #       #     # #   #   #     #   #       #   # #   #   #         # #
# # # # ####### # ##### # ####### # ### # ### ######### # # ##### ######### # #
# # # #       # #   #   # #       # #     # # #   #       # #     #     # #   #
### ####### # # ### # ##### ### # ### # ### # # ### ### ### # # ### ### # #####
# #     #   #   #   #       #   # #   #   #     # # # #   #   # #     # #     #
# ### ### ##### ####### ##### ### # ### # # ##### # # # # # ##### ##### # # ###
#   #   #   #         #     # #   # #   # #     #   # # # # #   # #     # # # #
### # # ### ### ### # ####### # ##### # # ### ### # # # ### # # # # ##### ### #
#   # #   # #     # # #     # # # #   # # #     # #   #   #   #   #     # #   #
# ### ### # ####### # ##### ### # # ### # # ##### ####### ####### ### # # # # #
#     # # # #       #     #     #   #   #   #       #   #     # #   # #   # # #
####### # # ############### ################# ##### ### ### # # ##### ##### # #
#       #   #   #         # # #       #     # #   #   #   # # # #     #     # #
##### ##### ### ####### # # # # ##### # # ### # ##### # # ### # ####### ##### #
#   #   #     # # #     # # # #     #   # #   #         # #   #       #     # #
# # # # ##### # # # ##### # # ##### # ### ####### ######### ### ##### ##### # #
# # # # #   # # # # #   # #         # # #   #   # #       # #   #   # #   # # #
# # ### # # ### # # # # # # ##### ### # # ### # ######### # # ### # # ### # # #
# #       #         # #         #   # #   #   #               #   #         # #
###############################################################################
