###############################################################################
#     # #     #     # #       #   #     #     # #   #   #     #   #           #
### # # ##### # ### # ### ### # # ##### # ##### # # # ##### # ### ######### ###
#   # # #   # # #           #   # #   # #   #     # #   #   #   #   #     #   #
# ##### # # # ##### ############# # # # ### # ##### # # ### ### ### # # ##### #
# #   #   # #     #   #   #   #   # #   #     # #     # # # #   # #   #       #
# # # ##### # # # # # # # # # # ### ####### ### # ##### # ### ### ### # #######
# # #     # # # #   # # #   #         # # #     #   # #     # #     # # #   # #
# # ##### # # ### ##### ############### # ### # ### # ##### # # ### ### # ### #
# # #   # # #   #     # #     # #       #   # # # # #     # #   # #     #   # #
# # # ### # ##### ##### # # # # ### ##### # # # # ### ### ##### # # ### # # # #
# # # #       # # #     # # # #   #     # #   #   #     # #   # # # #   # # # #
# # # # ####### # # ######### ### ### # # # ##### # ### # # ### # # ##### # # #
# #   #       # # #     #       #     #   #     # # #   #   #   #         #   #
# ### ####### # ##### ### ##### ##### ########### ### ####### ####### # # ### #
#   #   #       #   #     #   # #         # #         #     #   #   # # # # # #
# ########### # # # ######### # # ##### # # ############# ##### # # ### ### # #
#         #   # # #   #   #       #   # #   #           #     #   #   # # # # #
# ### # ##### ### ### # ### # ##### # # # ### ######### ### ######### # # # # #
# #   # #   # #   #       # #     # #   #   #         #     #     #   #   #   #
# # ##### # # # # ####### ##### ######### # # # ##### # ##### ### ### ##### ###
# #       #     #       #       #         #   #   #   #       #           #   #
###############################################################################
