###############################################################################
#     #   #       #     #     #           #       #     # #         #         #
### ### # # ### # # ### # ### ### # ##### ### ### ### # # ### # ### # ##### ###
#   #   # #   # # # #       #     # #     #     #     #       # # # #   #   # #
# ### ### ##### ### ##### ##### ### # # ### # # ##### ########### ### # ##### #
#     #             #     #     #   # #     # # #   # #   #   #   #   #       #
### ### ######### # # # ### # ### ##### # ##### # # ##### ### # ### ######### #
# # #   #   #     # # #   # #   # #     #     #   #             #   #         #
# # # ##### # ######### # ##### # ### ### ### ################# ##### #########
#   # #     #       #   #     # #   #   # #       #     #   #     #   #       #
##### # # # ####### # ############# # # # ######### # ### ### ### # ### ### ###
#     # # # # #     # #   #     #   # # #           #   # #   # #   # # # #   #
### ##### # # # ### ##### ##### # ##### ##### ### ### # # ### # ##### # # ### #
#   #   # #   # #     #       #     #   #       #   # # # #   #     #     #   #
# ### # # # ### ##### ##### ####### ### # ##### ####### # ##### ### # ##### # #
#   # #   # #     # # #   #   #       # #     # #     #       #   # # #     # #
### # ### ### ##### # # # ### # # ######### # ##### # ####### # # # ### ##### #
#   #   # #   #       # #   # # #   #     # #     # #   #     # # #     #   # #
# ##### ### # # ##### # ### # # ######### # ### ##### # # ####### ####### # # #
# #   #     # # #   # #   #   # #   # #   #   # #     # #         #     # #   #
# # # ####### # ### # ### ### # # # # # ### # ### ##### ########### ##### #####
# # #         #     #     #   #   #     #   #     #                     #     #
###############################################################################
