###############################################################################
#   #           # #           #   #   #     #   #     #         #       #     #
# ##### ##### # # # ############# ### # ### # # ### # # ### ##### ####### ### #
#       #   # #   # #     #           #   # # #   # # #   #   #   #       #   #
### ##### # # ##### # ### ### # ######### # # ### # ### ### # # ##### ##### ###
#   #     #   #   #     #   # #   # #   # #   # #       # # #   #   #   #     #
##### # ##### ### ##### ##### ### # # # # ##### ### ##### # ### # # # # #######
#     #   # #       #   #     # # #   #       #     #       # #   # # #       #
# ######### ##### ### ### ### # # # ### ##### # ##### ####### ##### # ##### # #
# # #     #           #     # #   # # #   #   # #   #     #         # #   # # #
# # ##### ### ##### ######### ### # # ### # ##### # ##### ### ### ### # # ### #
#     #   # #   # # #       #   # # #   # # #   # # #   #   #   # #   # #     #
# ##### ### ### # # ### ##### # ### ### ### # # ### # # ### ### # ### # ##### #
# #     #     #   # #         #           #   # # #   #   # #   #   # #   #   #
# # ######### ##### # ############# ### ####### # ####### ### ########### #####
# #   #             #     #     # # # #       #         # #   #   #   # #     #
# ### ### ####### # ##### ### # # ### ################# # # ### # # # # ##### #
#   #     #   #   #       #   # # #   #     # #   # #     # #   # # #   #   # #
### ##### ### # ##### ##### ### # # # # ### # # # # # ##### ### # # ### # # # #
#   #   #   #       #         #   # # #   #   # # #   #   #   # #   # # # # # #
# ### # # # # ################# ### # ### ##### # ### # # ### ### ### # # # # #
# #   #   # #                 #     #           #   #   #   #     #       #   #
###############################################################################
