###############################################################################
#         #     #         #     #   #   # #       #   # #       #   #   #     #
### ##### # ### ### # ##### ##### # # # # # ##### # ### ### ##### # # # # #####
#   #     #   #     # #     #   # # # #     #   # #               #   #     # #
# ########### ####### # ##### # # # # # ####### # ##### ############# # ##### #
# #   #     #     #   # #   # # # #   # # #     #       #     #       #     # #
# # # # ### ##### # ### ### # # # ##### # ### ##### ######### # ############# #
#   #     #       #       #   #   #     #         # #     #   #   #       #   #
######### ### # ######### ### ##### ##### ### ##### # ### # ### # # ##### # ###
#       # #   #     # # # # #     #     #   #       #   #       # #     # #   #
# ##### ########### # # # # ### # ### ### ##### ##### ####### # ####### ##### #
# #   #               # # # #   #   # #   #   # #   #     # # #         #     #
# # # ############### # # # # ### ####### # # # # ##### ### ##### ####### #####
#   # #     #       #   #     # # #   #   # # #     # #       # #       # #   #
##### # # # # ##### ########### # ### # ### ### ##### ####### # ####### # # # #
#     # # #   #   #     #     #   #   # #   # #     #       #         #   # # #
# ##### # ##### # # ### # # # # ### ### # ### ### # ### ### ######### ##### # #
#   #   #   #   # #   # # # #   # # #   #     #   #   # #   #   #     # #   # #
### # ########### ##### # # ##### # ######### # ### # # # ### ##### ### # #####
#   # #     #   #     #   # #     #   #     #   #   # # #     #   # #     #   #
# ### # ### # # ##### ##### ##### ### # ### ### ### # ### ### # # ### ### # # #
#   #   #     #     #               #     #     #   #     #     #     #     # #
###############################################################################
