###############################################################################
#               #   #     #     #   #     #   #       #     #       #         #
# ############### # # ### # # ##### # ### # ### # # # ##### # # ### ### ### # #
#       #         #   #     #     # #   # #   # # # #       # # #     # #   # #
# ##### # ################### ### # # # # ### # # # ######### ### ####### # # #
# #   #           #       #   #   # # # #     # # #     #   # #         # # # #
# # # ########### # ##### # ### # # # # ####### # ### # # # ### # ### ### #####
# # #   #   #     #   #   #   # # # # # #   #   # #   # # #     #   #     #   #
# ### # # # # ####### # ##### # # # ### # # ### # ### # ##### ### # ####### # #
#   # #   # #     #   #   #   # # #   #   #   # #   # #     #   # # #       # #
### # ##### ##### # ##### # ### # ### # ##### # ### ##### ### ### # # ####### #
#   # #   # #   #   #   # #   # #   # # #   #   #   #     #     # #   #     # #
# ### # # # # # ####### # ##### ### # # # # ### # ### ##### ### ####### # ### #
# #   # # # # #   #     #     # # #     # # # # #   #     #   #         #   # #
# # ### ### # # ### # ####### # # ####### # # ######### # # ##### #############
# #   #   # # #     #   #   # # #         # # #         #       # #   #       #
# ### ### # ##### ##### # # # # ####### ### # # ####### # ####### ### # ##### #
# #     #   #   #     #   # # #   #   # #   #   # #   # #   # #   # # # #     #
# # ### ##### # ### ####### # ### # # ### ### # # # # # ### # # ### # # # #####
#   #     #   # #   #     # # # #   #   # #   # #   # #   # # #     #   #   # #
# ######### ### ##### ### # # # ### ### # # ### # # ##### # # # ##### # ##### #
#           #         #   #       # #     #   #   # #     #   #       #       #
###############################################################################
