###############################################################################
#     #     #           #   #     #     # #       #     #       #     #     # #
##### # # ### # ######### # # # # # ### # # ##### ### # ####### # # ### # # # #
# #   # #     #         # #   # # #   #   #     # #   # #     #   #     # #   #
# # # # ######### ##### # ##### # ### ######### ### ### # ### ####### # # ### #
# # #   # #   # #     #   #     #     #       #       # # #   #       # # #   #
# # ##### # # # ##### ##### ########### # ### # # ### ### ##### ##### # #######
# # #       #       # #   # #   #       # #   # #   #   # #   #     # # #     #
# # # ########### # # # # # ### # ####### ### ##### # ### # # ### ##### # ### #
# # # #   #   #   # # # # #         #     # #       # #     #     #   #     # #
# # # # # # # # ### # ### ######### ####### # ############### ##### ######### #
# # #   #   # #   # #         #     #   #   #       #               # #   #   #
# ### ########### ######### # ####### ### # ####### ####### # ### ### # # # ###
#   # #         #       #   # # #         #           #     # #   #     # # # #
# # ### ### ### ##### ### ### # # ######### # ########### ### # ##### ##### # #
# # #   # # #   #   #     #     #   #       # # #     #     # #       # #   # #
### # # # ### ### # ########### ### # ##### # # ##### ### ############# # ### #
#   # # #   # #   #           # #   #   #   # #   #     # #   #         # #   #
# ### ##### # ### ######### # # ##### ##### # # # # ##### # ### ### ### ### # #
#   #   # #     # #     #   # # #       # # # # #         #     #   # #   # # #
# # # # # ### ### # # ### ### # ######### # # ####### # ### # # # ### ##### # #
# #   #     #     # #       #   #           #         #     # # #           # #
###############################################################################
