###############################################################################
#         #   #     #       #             #     #   #   #     #       #   #   #
##### ### # ### # ### # ##### # ######### # ##### ### # # ##### ##### ### # # #
#     # # #   # #     # #     # #       #     #   #   #         #   # #     # #
# ##### # ### # ####### # # ##### # ### # ### # ### ######### ### # # # ##### #
# #     #     # # #   # # #   # # #   # # #   #           # #     # # # #     #
# # ### ##### # # # # # # ### # # ### # ### # ########### # ### ### # # #######
#   # #   #   # # # # # #   #   # #   # #   #           # #   #   # #   #   # #
##### ### # ### # # # # ### # ####### # # ############# # # ### ### ##### ### #
#     #   # #   #   # #     # #       #   #   #   #       # #   #     #   # # #
# ### # ### # ### ### ######### # ######### # # # ######### # ### ### ### # # #
#   # # #   # #   # #       #   # #   #     #   #     #   #     # #     # #   #
### ### # ### ### # # ##### # ##### # # ####### ### # # # ##### # ####### # # #
#   #   #   #   #   # #   #     #   #   #     # #   #   #     # #       #   # #
# ### ##### ### ### ### # ############### # ### # ####### ### # ####### ##### #
#   #     #   # #   #   # #   # #   #     #     # #       #   #   #   #       #
### # ### ### # ##### ### ### # # # # ### ##### ########### ######### ### #####
#   #   # #   # #   # # # # # # # #   #   #   # #         #         #   #     #
# ##### # # ### # # # # # # # # # ######### # ### ### ### ### ### # # # ### ###
# #   # # #   #   # # #   # # #   #   #     #   # # #   #   # # # # # #     # #
# ### # # ### ##### # # ### # ### # ### ####### # # ### ### # # # ### ##### # #
#       #   #         #     #     #           #   #       #     #         #   #
###############################################################################
