###############################################################################
#           #   # #           #         #   #         #     #               # #
# ####### # # ### ######### # # ######### ####### # # # ##### # ######### # # #
#   #   # #   #         #   # #         # # # # # # #     #   #     # #   # # #
### # ### ##### ####### ##### # ####### # # # # ### ##### # ### ### # # ### # #
#   #     #   # #   # # #       #     # #           # # #   #   #   #     #   #
######### # # ### # # # # ####### # # # ##### # # ### # # ### ### ########### #
#       # # # # # #   #   #   #   # # #       # #     #     #   #     # #     #
# ### ### # # # # ##### ##### # ##### ##### ########### # ##### ##### # # #####
#   # #   # #   #   #       # # #       #   #         # # #     #     #   #   #
### ### # # ####### ######### ### ##### # # # ####### ##### ### ### ####### # #
# # #   # # #   # #   #         # # #   # #       #     # # #     #   #   # # #
# # # ### # # # # ### # ### ### # # ##### # ### ### # # # # # ####### # # # # #
#   #   #   # # #   # # # #   #   #   #   # #   #   # # # # # #     #   # # # #
# ### # ##### ##### # # # # ######### ##### # ### ####### # ### ######### # ###
#   # #     # #     #     #     #   #   #   #   # #       #     #       # #   #
### # ####### # ##### ##### ### # ##### # ##### # # ############### ### # ### #
#   #     #   #   #   #     #   #     #   # #   #     #           # # # #     #
# ##### # # ##### ##### ##### ### ### ##### # ####### ##### ##### # # # ##### #
# #     # #     # #     #   #   # # #     #   #   # #     # #   # #   # #   # #
# # ##### ### ### # ##### # ### # # # ### # ### # # ##### ### # # ### # # # # #
#       #           #     #       #     #       #       #     #   #   #   #   #
###############################################################################
