###############################################################################
#     #         #     # #       #       #         #     #     # #   #         #
# # ### # ### # # # # # ##### ####### # # # ##### # ### # # # # # ### # #######
# #     #   # # # # # #     # #       # # # # #   #   # # # #     #   # #     #
########### # ### # # # ##### # ######### ### ##### ### # # # ####### ### ### #
#   #       #     # #         #   #       #   #   # # # # # # #     #       # #
### # ### ######### # ### ##### # ### # ### ### # ### # # # ### # # # ##### ###
# #   #   #         #   #   #   #   # # #   #   #   # # # #     # # #   #     #
# ##### ####### ### ### # ######### # ### ### ### ### # ##### ### ### ####### #
#   #     #       #   # #         #   #   #   # # #         # #   # # #   #   #
# # ##### ##### ##### # ##### ##### ### ### ### # # ####### # # ### # ### # # #
# #     #     # #     #     # #   # # #   #     # # #       # # #       #   # #
# ##### ### ### # ##### ### # # # # # # ##### ####### ######### ### ####### ###
#   #   #   #   # # # #   # #   #   # #       # #     #       #   #   #   #   #
### # # # ####### # # ### ########### # ####### # # ####### # ### ##### # ### #
#   # # #     # # #     #         #   #   # #     #   #   # #   # #     # #   #
# ### ####### # # ##### # ### ##### ##### # # ####### ### ### ### # ##### # ###
#   # #     #   #     #     #     # #   # #   #       # #     #     #     #   #
# ### # ### ### ##### ##### ### # # # # # ##### ##### # ### # # ### # ####### #
# #   # # #     #   # #     #   # #   #   #         # # #   #   #   #   #     #
# # ### # ####### # ### # ### # ### # ##### ####### ### ### ##### ####### ### #
# #               #   # #   # #     #             #         #             #   #
###############################################################################
