###############################################################################
#                     #   #         #         #     #   #   #       #         #
# ######### ####### # ### # # ##### ######### ### # ### # # # # ### # ### ### #
#   #       #   # # #   # # #     #   # #   #   # #   # # #   #   # #   #   # #
### # ### ### # # # ### # # ##### ##### # # ### ##### # # ######### ### ### # #
#   # #   # # # # #   #   #     #   #     # #       # #   #   #     #   #   # #
# ### # ### # ### ### # ####### ### # ##### # ####### # ### # # ####### # ### #
# #   #     #   # #   # #   # #   # # # #     #       #     # #     # # # #   #
### ######### # # ### # # # # ##### # # # ####### # ##### # ####### # ### # ###
# #         # # #     # # #   #     # #         # # #   # # #   #   #     #   #
# ### ##### # ####### ####### ### ########### # # # # ### # # # # # ##### ### #
#       #     #   #       # #   #   #     #   #   # #     # # #   # #   #   # #
# # ### ####### # ##### ### ### ### # # # # ####### ####### # ####### # # # # #
# # #   #     # #   # #     #   #     # #       # #   # #   #         # # # # #
# # # # ##### # ### # # ##### ### ##### ####### # ### # ##### ######### # # # #
# # # #     #   #       #       #     # #   #     #   # #   # #   # #   # # # #
### # ##### ######### ##### ### # ##### # # # ##### ### # ##### # # # # ### ###
#   #     #   #       #   # # #   # #   # # #     #   # # #     # #   # #     #
# ####### ### # ####### # # # ##### # # # # # # # ##### # # ##### ##### ### # #
# #   #   #   #   #   # #   #     # # # # #   # #   #   # #     #   #   #   # #
# ### # ######### # # # # ##### ### # # ####### ### # # # ##### # # # # ##### #
#     #         #   #   #       #     #     #   #     #         # #   #       #
###############################################################################
