###############################################################################
#     #         #   #             #             #   #     #         #       # #
### ### ### ##### # ####### ##### ####### ##### # ### # # ##### ##### ### ### #
#   #     # #     #           #         # #   # #     # #         #   #   #   #
# ### ##### # ################### ### ### # # # ####### # ### ### # ####### ###
#   #     # # #       #           # #     # #     #     # #     #   #   #     #
### ### # # # # ### ####### ####### # # ### ##### # # ### ##### ##### ### ### #
#   #   # #   #   # #       #       # # # #     # # # #       #   #       #   #
# ### ##### # ### ### # ######### ### ### # ### # # # # ### # ### ### ##### ###
#       #   #   # #   #   #     #   # #   # # # # # # #   # #   #   # #   #   #
######### ##### # # ##### ##### ### # # ##### # ### ##### ######### # # ### # #
#         #   #   #   # #         #     #   #     #   # #   #     # # #   # # #
########### # ### ##### ### ### # ####### ####### ### # ### ##### # # ### ### #
#           #   #         #   # #         #       #   #   #   # #   #   # #   #
####### ##### ######### ##### # ##### ########### # ### ##### # ### ##### # ###
#   # #     #         # #     #     #   # #   # #   # #       #   # #     # # #
# # # # ##### ### ####### ######### ### # # # # # ### ####### # # # # # ### # #
# #   # #   #   #       #   #       #   # # #   #   # #   #   # #   # # #     #
# ####### # ########### ##### ####### ### # ##### # # ### ### # ##### # ### ###
# #       #     #     # #   # #       #   # #     # #   #   # #   #   #   #   #
# ### ######### # ### # # # # # ####### # # # ##### # ### # # ### ### ### ### #
#             #     #     #   #         # #   #           # # #         #     #
###############################################################################
