###############################################################################
# #   #   # #     #       #         #   #   #     # #       #     #           #
# # # ### # # ### # ####### # # # # ### # # # ### # # ##### # ### ### ### ### #
# # #   #     #     #     # # # # #   #   # # #   #   #   # #   #     # #   # #
# # ### ### # ######### # ### ### ####### ### # ### ### # # ### ####### ### # #
#   #     # #           #   # # #         #   # # #   # # #   # #       #   # #
# ### ### ####### ######### # # # ######### # # # # # # # # # # ##### # # #####
#   #   # #       # #       # #   #     #   # # #   # # # # #   #   # # #     #
####### # # ### ### # ####### ### # ### ### # # # ### ### # ##### # ### ##### #
#       #     #   #       # # # #   #   #   # # #   # #   # #     #   # #   # #
######### # ##### ##### # # # # ##### ### ##### # ### # ### # ######### ### # #
#         #   # #     # #   # #     #     # #   # #   #     # #   #     #   # #
# ##### ##### # ### # # # ### ### ##### ### # ### # ##### ### ### # ##### # # #
#   #     # # # #   # # #     # #       #   #   # #     #   #   # #       #   #
### # # # # # # # ########### # ######### # ### ####### ### # # # #############
#   # # # #   #   #     #   # # #     # # #   #       # #     #     #         #
# ### ### # ### ### # # # # ### # ##### # # ### ##### # ########### # ####### #
# #   #   # #   #   # # # #     #         #   # #   # #     #   # # # #     # #
### ######### ####### # # ### ### ########### # # # # # ### # # # # # ### ### #
#   # #       #   #   #   # # # # #   #     #   # #   # #   # #   # #   # #   #
# ### # ####### # # ##### # ### # # # ### # ##### ####### ### ##### ### # # ###
#     #         #   #     #         #     #   #           #             #     #
###############################################################################
