###############################################################################
#     #   #     #       #   #         #               # #       #       #     #
# # # # # # ### ### ### # ### # ##### ### ########### # # ### # ##### # # #####
# # # # # # # #   #   #   #   # #   # #   #   #         #   # #     # # #   # #
### # # # # # ### # # ######### # # # # ##### ### ######### # ####### # ### # #
#   # # # # #   # # #   #       # # #   #   #   # #   #     #   #   # #   #   #
# ### # # # # ### ##### # # ##### # ##### # ### # # ####### ##### # # ### ### #
# #     #   #   #     #   # #     #     # #   # #   #     #     # #   # # # # #
# ########### # ##### ##### # # # ##### # ### # ##### # # ##### # # ### # # # #
#   #   #   # #     #   #   # # #   #   # # #   #   # # # #   # # #     #   # #
# # # # # # ##### ##### # ##### ### # ### # ####### # ### ### # ### ### # # # #
# # # #   # #   #     #         # # #   # #     #   # #     # #   # #   # #   #
# # ##### # # # ##### ########### ### ### ##### ### # # ### # ### # # #########
# # #     # # # #   #           #     #     #     #   #   # #       #     #   #
# # # ### # # ### ####### ##### # ##### # ### # ##### ### ##### # ####### # # #
# # #   # #       #     #     # # #     #     #     #   #   #   #       # # # #
# # ### # ######### ### # ### # ####### # ##### ########### # ########### ### #
# # #   #   #     #   #   #   #   #   # #   # #   #     # #   #       #   #   #
### # ##### ### # ##### ### ##### # # ##### # ### # ### # # # ### ### ### # # #
#   # #     #   #     #   # #   # # # #     # #   # # #     # #   # #     # # #
# ### # ####### ##### ##### # # # # # # ##### # # # # ####### ##### ##### # # #
#     #             #         # #   #   #       #           #           #   # #
###############################################################################
