###############################################################################
#         #       #   #   #             #           #       #     #     #     #
# ### ### ##### ### # # # ### ####### ### # ####### # # ##### ##### ### # ### #
#   # # #     #     #   #     #     # #   # #   #   # # #   #         #   #   #
# ### # ##### # ##### ########### # # # ### # # ### # # # # # ####### ##### ###
# #   #   #   #   # #   #       # # #     #   #   #   # # #   #   #   #     # #
# # ### ### ##### # ### ### ### ### ############# ####### ##### # # # ### ### #
# #     #   #   # #   #   # # #     #           #       #   #   # # # # # #   #
##### # # ### ### ### ### # # # ##### ######### ####### ### ### ### ### # # # #
#     # #     #         #   #   #             # #     #   #   # #   #   # # # #
# ##### ########### ######### ### ############# # ### ### ### # ### ### # # ###
#     # #     #   # #     #   #   #             #   #   # #     #       # #   #
### ### # ### # # # # ### # # # ##### # # ####### ####### # ### ##### ### ### #
# # #   #   #   # # # # # # # # #     # #     #   #     # #   # #   #   # #   #
# # ### ### ##### ### # # # ### # ##### ##### # ### ### # ######### # ### ### #
# #   #   #     # #   # # #     #     #     #   # # # #       # #   # # #     #
# ### ######### # # ### # ########### ##### ##### # # ######### ### # # ##### #
#   #       #   # #   # #   #   #   #   # # #       # # # #   #   #         # #
# ##### ### # ### ### # ### # # # # # # # # # ####### # # # # # ####### ### ###
#       #   #   #   #     #   #   #   # #   #   #   # #     # #       # # #   #
# ####### ##### ### ##### ############# # ##### # # # # ### # ##### ### # ### #
#       #         #             #       #     #   #     #   #               # #
###############################################################################
