###############################################################################
#   #     #       #   #           #   #     #   #       #       #             #
# # # ### # ##### # # ##### ### # # # ### ### # ##### # # ##### # ### ####### #
# #   #   #     #   # #   # #   #   # #       #       #   #   #   # # #   #   #
# ### ### ### ####### # # ### ######### ############# ##### ####### # # # # ###
# # # #       #     #   #             # #   #         #               # #     #
# # ########### ### # ### ### ##### # # # # # ##################### ######### #
# # #   #         # # # #   # #     #   # # # #       #       #   #       # # #
# # # # # ####### ##### ### # ############# # ### ### # ##### # # ####### # ###
# #   #   #       #   # # # #             # #   # #   # # #   # # #       #   #
# ####### ######### # # # # ############### # ### # ### # # ##### ##### ##### #
# #         #       # #   #   #             # #   # #   #     #   #   # #   # #
# ####### ### ##### ### ##### # ####### ### ##### # ### # ### ### # # # # # # #
#           #   #   #       # # #     # #   #     #     #   #     # # #   #   #
### ##### ####### ### # ### # ### ### # # ### ############# ####### # ####### #
# #     # #     #     #   # #     #     # # # #         #   #   #   #     # # #
# ####### # ### ########### # ####### ### # # # ### ### # ### # # ####### # # #
#     # #   # # #   # #   # #       #   # #   # #     # # #   # #   #   # #   #
##### # # ### # # ### # # # ########### # ### ### ### ### ##### ### ### # ### #
#       #   #   #       # # #     #     # #     #   #   #     #     #   #   # #
# ##### ##### ######### # # # ######### # # ### ####### ### # ####### ##### # #
#   #                   #   #           #   #       #       #               # #
###############################################################################
