###############################################################################
# #     #   #           # #   #     #     # #         #       #     #         #
# # ### ### ### # ##### # # # ### ### ### # # ##### # # ##### # ##### ##### ###
# # #     #   # #     #   # #     #   # #   #   #   #   #     #       # #     #
# # # ### # # # ### # ##### ### # # ### ### ##### ######### ######### # ### # #
# # # #   # # # #   # #   #   # # # #     #     #     # # # # #     #   # # # #
# ### ### ### # # ### # # ### ### # # ### ##### # ### # # # # # ### ### # ### #
# #   #   #     # # # # #   # #   #   #     #   # #   #   # #     #   # #   # #
# # ### # # ##### # # # ### # ####### ##### # ##### ### ##### ####### ##### # #
#     # #     # # # #   #   # #       # #   #         # #   #   #   #   #     #
# ##### ##### # # # ##### ### # ####### # ##### ##### # ### ### # # ### ##### #
# #         #   # #     # #   # # #   # # # # #   #   #   #   # # #   #       #
########### ##### ##### # # ##### # # # # # # ### # ##### ### # # ### ##### # #
#     #   #   #   # #   # # #   #   # # # #     # #         #   #   # #   # # #
### ### # ### # ### # ### # ### ### # # ####### # ### ##### # ##### # # # # # #
# # #   #   # # #   #   # #   #     #     #   #   #   #   # # #   # # # # # # #
# # # ##### # # # ##### # # ########### # ### # ##### ### # ### # # # # # ### #
#   #     #   # # #   # #   #   # # #   #   #       # # #   #   # # #   #   # #
# ####### # ##### # ### ##### # # # # ##### # ### ### # # # # ### # ######### #
#         #       # #       # # #     #   #   #   #   # # #   # # # #         #
# ######### ####### ##### ### # ### # # # # ##### ##### ####### # # # ####### #
#         #                   #     #   # #     #         #           #       #
###############################################################################
