###############################################################################
#         #       #       #   #         #   #         #         #       #     #
# ####### # ##### ### ##### # ##### # # # # # ##### ### # ### ### # ### # ### #
#     #   # #       #       #     # # # # #     #       # #   #   #   #   #   #
### # ##### ##### ########### ### ### ### ##### ######### # ### ##### ####### #
# # #   #   #   # #         #   #     #   # # #   #   # # # #       #       # #
# ##### # ### # ### # ######### # ### # ### # ### ### # # # ####### ####### # #
#             #     #   #     # # # # #   #   #     # # # #       #       # # #
# ########### ####### # # ### # ### # ### ### ##### # # # ##### # ####### # ###
# #         # #   #   # # # #     # # # #   # # #   # #       # #     # # #   #
### ####### # # # # ### # # ##### # ### ### # # ### # # ##### ####### # # ### #
#   # #   # #   # # # #   #     #   #   #   #     # # # #     #     #   # # # #
# ### # # # # ### # # ##### ### ### # ##### ##### ### # # ##### ### ### # # # #
#   #   #   #   # # #         #     # #   # #     #   # # #   #   # #   # # # #
# # ### ######### # ################# # # # # ### # ### # # ##### ### # # # # #
# #   #     #     #   #   # # #     # # # # # #   #     # #     #   # # #   # #
# ### ####### ####### # # # # # ### # ### ##### # ### ### ##### ### # # ### # #
#   #       #   #       #   #   #   #     #     #       # #     # #   #   # # #
### ####### ##### ####### ### # ####### # # ####### ### # # ### # ####### ### #
# #     #   # #   # #   #     # #     # # #       # # # # # # #   #       #   #
# ##### # ### # # # # # ######### ### # # ### ### # # ### # # ### ### # ### # #
#       #       #     #           #     #       # #   #     #       # #     # #
###############################################################################
