###############################################################################
#       # #       #       #           #   #       #           #             # #
# ##### # ####### # ####### ######### # # # ##### # # ### ##### # ######### # #
# # # # # #   #   #     #     #     # # # #   #     #   # #     #     #   # # #
# # # # # # ### ####### ##### # ### # # # ##### ################### # ### ### #
# # #   # #   #   #   # #     #   # #   #     #       #   # #       #     #   #
# # ### # # ### # # # # # ##### # ########### # ##### # # # # ########### # ###
# #   # # # #   #   #   # #   # # #         #   #   #   # #   #           #   #
# ### ### # # # ######### # # ### # ####### # # # # ##### ### # ############# #
#   #   #     #       #     #     #   #   #   #   # #   #   # #   #           #
# ##### # ####### ##### ############# # # ### ##### # # ### # ### ####### ### #
#         #     #       #         #   # #     # #   # #     # # # #     #   # #
##### ######### # # ####### ####### ####### ### # ### ####### # # # ### ### # #
# # # #         # #   # #   #       #   #   #   # # #       # #     #     # # #
# # # # ####### ##### # # ### ####### # ### ### # # ####### # # ##### ### # # #
# #   # #   #       #   #     #       #   #     # #       #   #   # # # #   # #
# # ### ### # ##### # ######### ####### ######### ### ##### ####### ### ##### #
# #   #   #   #     # #     #       #   #       #   # #   #       # #   #   # #
# ### # # ##### ##### # # # ### ### # ### ### ### # # # # ##### # # # ### ### #
#   # # #   #   #     # # #   # #   #   #   #     # #   # #     #   #   # #   #
# ### ### ### ##### ### # ### ### # ####### # ##### ### # # ### ####### # # ###
#         #       #     #   #     # #       #     #   # #     #         #     #
###############################################################################
