###############################################################################
#         #   #   #   #       #     #   #         #           #     #         #
# ####### # # # # # # # # ### ##### # # # # ####### ########### ######### ### #
#   #     # #   # # # # # #   #       # # # #             # #   #           # #
# # ####### ##### # # ### ##### # ##### ### # # ### # ### # # ### ### ####### #
# # #     #   #     #   # #     #     #       #   # # #     #     #         # #
# # # ### ### ######### # # ######### # ######### # ### ##### # ############# #
# # # # #   # #       # # #   #   #   # #     #   #   #       #       #   #   #
# # # # ### # # ##### # # # ### # # ### ##### # ##### ##### ####### # # ### ###
# # # #       # #   # #   # #   # #   # #   #   #   #   # # #     # # #     # #
# # # ######### ### # ##### # ### ### ### # ### # # ### # # ### ##### # ##### #
# # #       #   #   # #     #   #   # # # #   # # #   #   #     # #   #     # #
### ##### ### ### ### ######### ####### # ### # # ### # ######### # # ##### # #
#     #   #   # #     #       #     #       # #   #   # #   #     # # #     # #
# ### # ### ### # ### # ##### ### # ####### # ######### ### ### ### # ### ### #
# #   #   # #       # # # #   #   #     # # #     #     # #   # #   #   #   # #
# ####### # # ####### ### # # # ####### # ##### # # # ### ### # ### ### # ### #
# #     #   # #         #   # # #     #   #   # # # #   # #   #   #   # # #   #
# ##### # ### # ######### # ### ##### # ### # # # # # ### # # # ##### ##### ###
# #   #   #   #   #       # #   #     # #   # # #   # # #   #   #   #     #   #
# # ####### ##### # ##### # # ### ##### # ### ####### # # ### ### # # ### # # #
#               #   #     #   #             #         #     #     #     #   # #
###############################################################################
