###############################################################################
# #       #         #   # #     #         #       #   #         #   #     #   #
# # ##### # ##### ### # # # ### ####### # # ##### # # # ##### # # # ### # # # #
# # #     # #   #     # #   #   #   #   # #     #   # # #   # #   #     #   # #
# # # ##### # ######### # ######### # ######### ##### ### # # ############### #
#   #     #   #         #     #     #     #         #     # #   #   #         #
# ####### # # ### ########### # # ##### # # ##### ######### # # # # ### #######
# #     #   # #   # #         # # #   # #   #   # #       # # #   #   # #     #
### ########### ### # ######### # # # ### ### # # ### ### # ######### ### ### #
#       #   #   #   #     #     #   #   #   # # #   #   # #   #     # #   #   #
# ##### # # # ### # ##### ######### ### ##### ##### ### # ### # ##### # ### # #
# # # #   # # #   # #             #   #             #   #   # # #   #     # # #
# # # ##### # # ### ##### ####### ### ### ####### ######### # # # ######### # #
#   # #   # # # #   #   # #   #   #     #     # #     #     #   #       #   # #
### # # # # # ### ### # # # # # ######### # # # ### # # # ######### ### # ### #
#       # #     #     # # # #   #       # # # #   # #   # #       # #   # # # #
####### ############# ### # ####### ### ### # ### # # ##### ##### ### ### # # #
#     # #       #     #   #   #     #   #   #   #   #   #   #     #   #   #   #
# ### # ### ### # ##### ####### ######### # ########### # ### ##### ### ### ###
# #         # #   #     #       #     #   #   #   #       # #   #       # #   #
# ########### # ##### ##### ##### ### # # ### # # ######### ### ####### # ### #
#             #                   #     #   #   #       #               #     #
###############################################################################
