###############################################################################
#     #     #   #       #     #     #     #                 #   # #           #
##### # # ### # # # # ### # # # # ### # # # ########### ##### # # ##### ##### #
#   # # # #   # # # # #   # #   #     # # #   #     #         #   #     #   # #
# ### # ### ### # # # # ############### ##### # ### ### # ############# ### # #
# #   #   # #   # # # #     #     # #   #     #   #     #     # #   # #   #   #
# # # # # # # ### # ####### # # # # # # # ####### ####### ### # # ### # #######
# # #   #   # #   # #   # # # # #   # # #   #     # #   #   # #   #           #
# # ### # # # ##### ### # # ### ### # ##### # ### # ### ##### # ########### ###
#   #   # # # #         # #     #   #     # # # # #           # #         #   #
# ### ### # # # ######### ##### ######### # ### # ### ####### # # ### ####### #
#   # # # # #   #     #     #   #         #     #   # #     #   # #       #   #
# ### # # # ##### ### ### # ### # ####### # ####### ### ##### # # ####### # ###
# # # #   #     # # #   # #     # #         # #   #   #       # # # #   #     #
### # # ### ##### # ### ### ##### # ######### # # ### ### ####### # # # # # ###
#   # #   #     #   # #   #   #   #       #     #   #   #     #   #   #   # # #
# # # ### ##### ### # ### # ############# # ############### ### ##### ### # # #
# # #   # #   #   #     # # #   #   #   #   #   #   # #         #     # # #   #
# # ##### # # # ####### # ### # # # # # ####### # # # # ######### ##### ### # #
# # #   # # # #       # #     #   #   #     # #   #   # #   #   #   #     # # #
# ### # # # ### # ##### ########### ######### ### # ### # # # # # # ### # # # #
#     #   #     #                 #               #       #   # # # #   #   # #
###############################################################################
