###############################################################################
# #   #           #           #       #     #       #           #       #     #
# ### # ######### ####### # # ##### # # ##### ##### ####### ### # ### # ##### #
#   # #   #     #     # # # #       #   #         #       #   #   #   #   #   #
# # # ### # ### # # # # # # ##### ####### ############### ### ##### ### # # ###
# # #         # # # #   # #   # # #   # #     # #         #   #     # # # #   #
# ##### ####### ######### # # # ##### # ##### # # ######### ### ##### # # ### #
#     #       #     #     # # #     # # #   #   #         #   # #   #   #   # #
# ### ####### # ####### ### # ### # # # # # # ########### ##### # ### ##### # #
#   #   #     #   #   # #   #   # #     # # #       #   #       #     #   # # #
##### ### ######### # ### ##### # ####### # ##### # ### ######### ##### # # # #
#     #   #     #   #     #       # #     #       #       #     # # #   # #   #
# ### # ##### # ########### ####### # ####### ############# ### # # # # # ### #
# #   #   #   #   # #     #     # #   #   #                 # # # #   # #   # #
# ####### # ### ### # ### ##### # # ### # # ################# # # ### # ##### #
#       #   #   # # #   #     # # #   # #               #     # #   # #     # #
# ##### ##### ### # # # # ### # # ### # ######### ##### # ##### ### # ##### # #
# #   # #   #   # # # # # #   # #     #     #   # #     #     # # # #     #   #
### # # # ##### # # ### # # ### # ######### # ##### ######### ### # ### #######
#   # #       # # #     # #     # #   #     #       #       #   # #   # #     #
# ### ### ### # # ####### ### ##### # # ##### ########### # # # # ### ### # ###
#   #       #             #         #   #                 #   #     #     #   #
###############################################################################
