###############################################################################
#             #     #   #   #   #       #   #                           #     #
### ### ### # # # ### # # # # # # ### # # # # ################# ### ######### #
#   # # #   #   #     # # # # #   # # #   # #   #       # #     # #           #
# ### # # ############# # # # ##### # ####### # ### ### # # ##### ########### #
#   #   # #       #     # # #     # #     #   #   #   #   #   #     #         #
# # ### # ####### ### # # ####### # ##### # ### # ### ####### # ### # ### #####
# # # # #           # #   #     #       # # # # #   #         # # #   # #     #
# # # ### ######### ##### # ### ####### # # # # ### # ####### # # ### # # ### #
# #   #       #     #   # # #   #   #   #   #   #   # #     # #   #   #   #   #
### ######### # ##### # # ### ### # ############# ### ### # # ### # ### ### # #
#   #         #   #   # #   #   # # #           # #     # # # #   # #     # # #
# ### ########### # ### # ##### # ### ##### ### # ##### # # # ##### # ##### # #
# #     #     #   # #   # #   # #     #   # # # #     # # # # #     # # #   # #
# ##### ##### # ### # ##### # # # # ### ### # # # ### # ### # # ####### # ### #
#   #     #   #     #   #   # #   #     # # # #   # # #   #   # #     # #   # #
### # ### # # ######### ##### # ######### # # ##### # ### ### # # ### # # # ###
#   #   #   #     #   #     # #   #       # #   #     #     # # #   #   # #   #
# ##### ####### ### # ####### # # # ####### # # ####### ### # ### # ####### # #
#   # # #     # #   #   #   # # #   #   #   # #       #   # #   # #   #   # # #
### # # ### # ### ####### # # # ####### ##### ##### ##### # ### ##### ### ### #
#     #     #             #           #           #       #   #         #     #
###############################################################################
