###############################################################################
#   #                       # #           #   # #     #         #     #     # #
# ### ############### ##### # ### ####### # # # ### # ### ####### # # ### ### #
#     #     #         #   #     #   #       #       #   # #     # # #   # #   #
# ##### ### ##### ##### ########### # ############# ### # # ### ### ### # # # #
# #       #     # #   #       #     # # #     #   # # # # #   #       #   # # #
# # ######### # ### # ####### # ####### ### ### # ### ### ### ########### # ###
# # #   #   # #     #   #             # #   #   #   #       # #   #       #   #
# # ### # # ########### ### ### # ### # # ### ### # ##### ### ### # ######### #
#   #   # #           #     #   # # #   #       # #     #   #   # #     #     #
### # # # ##### ##### ####### ##### ############# ##### # # ##### ### ### #####
# #   # # # #       #       # #         #         # #   # #         #   # #   #
# # ### # # # ########### ### ### # ### # # ####### # ##### ### ##### # # # # #
#   # # # # #   #           #     #   # # #     #   #     #   # #     # #   # #
##### # # # ### # ######### # ########### ##### # ### ### # ### # ##### ##### #
#   #   # #     #   #   #   #   #   #   #   #   #   #   # # #   # # #   # #   #
# ### ########### ### # # ##### # # # # ### # ##### ### ##### ### # # ### # # #
#     #         # #   # #     # # # # # #   #     # #     #   #   # #     # # #
# ############# # # ### ##### # # ### # # # ##### # # ##### # # ### ### # # # #
#   #         # #     #   # #     #   #   #   #   #   # #   #   #   # # # # # #
### # ####### # ######### # ### ####### ####### ####### # # ##### ### # ### # #
#     #           #           #               #           #       #         # #
###############################################################################
