###############################################################################
#     #   # #   #     #   #     #     #             #         #       #       #
# ### # # # # # # # # ### # # # ##### # ### ####### # ### ### # # # # ##### # #
#   #   # # # #   # # #     # # #   #   #   #     # #   # #   # # # #   #   # #
# ####### # # ##### # # ##### ### # ##### ### ### # # ### # ##### # ##### #####
# #   # # #   #   # #   # # # # # #     # #   #   #   #   #     # #     #     #
### # # # # ### # # ### # # ### # ##### # # # ######### ####### # ##### ##### #
#   #   #   #   # # # #     #   # #   #   # # #     #   #     #   #   #       #
# # ##### ### # ### # ##### # # # # # ##### # # ### ### # ### ##### # ####### #
# #     #   # #       #   # # # # # # #     # #   #     # # #       #   #   # #
# ##### # # ##### ####### # ### # ### # ##### ### ####### # ####### # ### # # #
#     #   # #   # #     #       #     #   #     #       #       # # # #   #   #
# ##### ### # ### ##### ### # ####### ### # ##### ##### ####### # # ### #######
#   #   # #     #     # #   #       # #   # #   # #         #     #     #     #
##### ### ##### ####### # ######### # # ##### # # ######### # ####### ### # ###
# #   #   #           #     #     # # #       # #         # #   #   #   # #   #
# # # # ############# # ####### ### # ######### ########### ##### # ##### ### #
#   #   #     # #     # #     #     #         #   #       # #   # # #   #   # #
# ### ##### # # # ####### ### ############### ### # ##### # # # # # # # # ### #
#   #     # # #   #   #   # #   # #       #   #   # #   #   # #   # # # # #   #
### ##### # # # # # # # ### ### # # # ##### ### ### # # ##### ####### # ### # #
#       #   # # #   #   #           #       #         #               #     # #
###############################################################################
