###############################################################################
# #     #             #   #   #       #           #     #   #         # #     #
# # ### # ########### # # # # # ##### ####### ### # ### # # ### # ### # # ### #
#   # #   #   #       # # # # # #   #     #   #   #   #   #   # # #     #   # #
# # # ##### # # ######### # # # # # ##### # ######### ####### # # # ####### # #
# # #     # #   #         # #   # #     #     #     #   # #   # # #         # #
# # ### ####### # # ### ### ####### ##### ### # ### ### # # ### # #############
# #   # #   #   # # #   #     #     #   #   #   #   #     # #   # #     # #   #
##### # # # ##### # # ### ### # # ### # ### ##### # # ##### ### # ### # # ### #
#     # # #       # # #   #   # #     #         # # # # #   #   #     # #   # #
# ##### # ######### ### ### ########### ####### # # # # # # # ####### # ### # #
#     # #       #   #   # #           # # #   # # #     # # # #   #   #   #   #
##### # # ####### # # ### ############### # ### ######### ### # ### ##### # # #
#     #   #   #   # #   #         # #     #     # #         #     # #       # #
# ######### # # # ### ### ##### ### # ########### ### ##### ##### ####### ### #
# #       # # # #     #   #   # #     #         #     #     #       #     # # #
# # # ### # # # ####### ### # ### ### # ####### ####### # ### ####### ##### # #
# # #   # # # #       #     #   #   # #       #     #   #     # #     #   #   #
# ### ### # # # ##### ######### ### ############# # # ### ##### # # ### # ### #
#   # #   # # #   # #     #       #   #           # #   #       # # #   #   # #
### # # ### # ### # ##### # ##### ### ########### # # ##### ### ### # ##### ###
#     #     #           #   #       #             #       #   #   #   #       #
###############################################################################
