###############################################################################
#           #     #           #       #   #       #               #           #
### # ####### # # # # ####### # ####### # ### # ### ### ### ##### ########### #
#   #         # #   # #     # #         #   # # #   #   #   #   #           # #
# ##################### # ##### ### ####### # # # ### # ##### # ########### # #
#       #       #       #   #   # # #       # #     # #   #   #     #     # # #
##### ### ##### # ######### # ### # ##### # ######### ### # ### ### # ### # # #
#   #   # # # #   # #       # #     #   # #   #     # # # # # #   # #   #   # #
# ### # # # # ### # # ####### # ##### ### ### # ### # # # # # # ### ### ##### #
# # # #   #     #   #       # #   #         #   #   #   # # # # # #   # #     #
# # ########### # ### ####### ### ############### ##### # ### # # ### # ### ###
# #       #   # # #   #       #   #       #     #     # #   # # #     #   #   #
# ### ### # # # # # # # ### ### ### ##### ##### ### # ### # # ### ####### ### #
#     #   # # # # # #     # #   # # #         #     #     # # #   #       # # #
# ##### # # # # ### ########### # # ######### ############### # # ##### ### # #
#   #   # # # #   # #   # #   #   #     #         #       #   # # #   #   #   #
### # ##### ### # # ### # # # ######### ####### # ####### # # # ### # ### ### #
#   #     #   # # #         #       # # #       # #     # # # #     # # # #   #
# ####### ### # ### ####### ####### # # # ####### # ### # # # # ##### # # # # #
#   #   # #   #   # #     #   #       # # #         #     # # # #     #   # # #
### # # # # ### # ### ##### # # ####### # ################# # ### ##### ### # #
#     # #       #           # #         #                   #     #         # #
###############################################################################
