###############################################################################
#       #     #     #         #             # #           #       #           #
# ####### # ### ### # ####### ######### ### # # ######### # ##### ##### ### ###
#   #   # #   # # #   #       # #     #   #   #     #     # #   #     # # #   #
# # ### # ### ### # ####### # # # ### ### ######### # ##### # # ##### # # ### #
# #   # #   # #   #   #     # #   # #     #   #     #         # #   # #     # #
# # ### ### # # # ##### ### # # # # ####### # # ##### ########### # # ####### #
# # #       # # #   #   #   #   #           # #     # #   #       #   #   # # #
# # ######### # ### # ### ########### # ##### ##### ##### # ### ####### # # # #
# #     #     # # #   #   #         # #     #       #     # # #   #     #   # #
# ##### # ##### # # ### ### ############# # ######### ##### # ######### ##### #
# #     #     # #   #       #   # #       #   #     #     #             #     #
### ### # ### # ##### ### ### # # # ######### ### ####### ### ######### # ### #
#   #   # # #   #   # #   #   #   # #     # #     #     # #   #   #     #   # #
# ####### # ##### ### # ### ##### # # ##### ####### # ### # ##### ##### ### ###
# #     # #   # #     #   #     # #   # #           #   #   #     #     # #   #
# # ### # # # # ######### ##### # ##### ##### ### ### # ### # ##### ##### ### #
# # #     # # #           #   # # #   #   #   # # #   #   #   #     # #       #
# # # ##### # ############# # # # # # ### # ### # # ##### ### # # ### # ##### #
#   # #     #     #     #   #   # # #       #   # #   #     # # # #   #   #   #
# ### # ####### # # ### # ######### ######### ### ### ####### # ### ##### # ###
#   #   #       #   #     #         #               #         #           #   #
###############################################################################
