###############################################################################
#       # #     #   #   #       #   #       #                   #             #
# ### ### # ### # # # # ####### # # # ##### ### ############### ### ### ##### #
#   # #   #   # # # # # #     #   #   #   #   #     #         #   # #   #   # #
# # ### ##### # # ### # # ### ### ##### # ### ##### ##### # # ### ### ### # # #
# #   #   # # #   #   #   #       #   # #     #     #   # # #   #     #   # # #
# ### ### # # ##### ####### ####### # # ####### ##### # ### ########### ### # #
# #     # # #     # #       #       #   # #   # #     # # # #         # # #   #
# # ##### # # ### # ######### ########### # ### # ##### # # # ####### # # #####
# # #       # # # #       #   #           #   # # # #     #       # # # #   # #
# # # # ##### # ######### # ### ### ### # ### # # # # ########### # # # # # # #
# # # #   #   # # #       # #   #   # # # #   # # # # #       # # # #   # #   #
### ##### # # # # # ######### ### ### # ### ### # # # # # ### # # # ##### ### #
#     #   # #   #   #       # #       #   # #   # #   # # # # # #     #   #   #
# ### # # # ####### # ### # # ########### # ### # # ##### # # # ##### ### #####
# # #   #   #       # #   # # #   #       #     # # #   # #   #   # #   #     #
# # ### ##### ##### ### ### # # # ####### # ### # # # # # # ### # # ### ### # #
#   #   #   #   #   # # #     # #       # # #   # #   #   #     #   # #   # # #
### ### # # # # # ### # # ##### ######### # # ### ####### # ####### # ### ### #
# #   #   #   # # #     #   #   #   #   # # #   #   # #   #       #     #   # #
# ### ######### ### ####### ### # ### # # # ### ### # # ######### ##### ### # #
#             #           #           # #   #       #         #       #   #   #
###############################################################################
