###############################################################################
#     #           #       #         #     #     #       #       #   #     #   #
# ### # ####### # # ### # # ##### ### # ##### ### ##### # ### # # # # ### # ###
# #   #   #     #   # # # # # #       #   #   #   # #   # #   #   #   #   #   #
# ####### ### ####### # # # # # ######### # # # ### # ### # ####### # # ##### #
#       #   # #   # #   # # # # #     #   # # #     #     #     #   # #     # #
# # ### ### ### # # # # ### # # ### # # ### # # ####### ### # ### # # ##### # #
# #   #     #   # #   #     # # #   # # #   # # #       # # # #   # # #   #   #
# ### ##### # ### # ######### # ### # # ### # # # ####### ##### ##### ### #####
#   # #   # #   # # #     #   #   # #   #   # # # #   #   #     #     #       #
### # ### # # # # # # ### # # ### # ##### # ### # # ### ####### # ##### # ### #
# # #   # # # # # # # #     # # # #       # #   #   #         # #   # # #   # #
# # ##### # ### # ### # ####### # ########### ####### ####### ### # # # #######
#   #   # #     #   # #       #     #         # #   # #     #   # # #   #     #
# ### # # ######### # ######### ### # ######### # # # # ### ### ### # # ##### #
#     # #   #       # #     #   #   # #           #   #   #   # # # # # #   # #
####### ### # ####### # ### # ##### # # ############# ### ### # # # # # # # # #
#     #   #     #   #     # # #   # # #     #   #   # #   #     # # # #   # # #
# ### ### ##### ### ####### # # ### # ##### ### # ##### ### ##### # ####### # #
# #   #   #   #   #   #   # # #   #   #   # #   # #     # #     # #   #   #   #
# # ### ##### ### # # # # # # ### ##### # # # # # # ##### ##### # # ### # # # #
# #             #   #   #   #   #       #     # #   #                   #   # #
###############################################################################
