###############################################################################
#       #   #       #         #     #     # #     #     #             #       #
### ### # # # ### ########### ### ### ### # # ### # ######### ######### # ### #
#   #     # # # #             #   #   #   # #   # #   # #   # #         # #   #
# # ######### # ######### ##### # # ### ### ### # ### # # # # # ######### ### #
# # #     #   #       #   #     # #   # #     # #   # #   # #   #   #   # # # #
# ### ##### ### ##### # # ##### # ### # # ##### ### # # ### # ##### # # # # ###
#         # #     #   # # #     # #   # #     #   # # # #   # #     # #   #   #
# ####### # # ### ### # # # ##### # ### # ### ##### # # # ### # # ### ### ### #
#   #     # # # #   # # #   #     #   #   # #       #   # # # # # #   #     # #
### # ##### # # ### # # ################### ##### # ##### # # # # # ######### #
#   #   # # # #   # # #                 #       # # # #   #   # # #     #     #
# ##### # # # ### # ################# ### ##### ### # # ### # # # ##### ##### #
# #   #     #   # #   #       #   #   # # # #     # #   #   #   # #     #     #
# # # ######### # ### ### ### ### # ### # # ##### # # # ######### ### ### ### #
#   # #         #   #   # # # #   # #   # #   #       # #       #   # #   #   #
##### ### ####### # ### # # # # ### # ##### # # ####### # ### # ### # # ### ###
#   # #   #       #   #   # #   #   #   #   #   #   #   #   # # #   #     #   #
# # # # ### ### ########### ### # ##### # ##### # # ####### # # ### ##### #####
# #   # #   # #       #   #   # # #   # # #     # #     #   # #   #   #   #   #
# ##### # ### ####### # # # # # # # # # ### ##### ### ####### ### ### # ### # #
#       #           #   #   #   #   #             #             #     #     # #
###############################################################################
