###############################################################################
#   #         #       #     #   #               #       #             #       #
# # # # ### ### ##### # ### # ### # ########### # # ##### ########### # ##### #
# # # # #   #   #     #   # # #   #   #     #   # #           #     # #   #   #
# # # # ##### ### ### # ### # # ##### # ### # ### ############# ### # ### # # #
# # # #   #   #     #     # #     #   #   #   #   #     #   #   # # #   # # # #
# ####### ##### ####### ##### ##### ##### ##### ### ### # # # ### # ### # # # #
#       #     #     #       #   #   #   #   #   #   # # # #   #   #   # # # # #
# # # ##### # # ### ### ######### ##### ### ##### ### # # # ### # ### # # # ###
# # #   #   # #   # #   #         #       #       #   #   # #   #   # # # #   #
# ##### # ### ##### # ### ######### ##### ######### ### ### ##### ### # # ### #
#   # # # #         #   #     #     #     #   #   #   # # #     #   # #   #   #
### # # ##### # # ######### # ##### ### ### ### # # # # # ### # ### # ##### # #
# #   #       # # #   #     #   #   # # #       #   # #   #   #   #   #   # # #
# # ########### ### # # ### # # # ### # # ########### ### # ########### # # ###
# # #         #     #   # # # #   #   # # #       # #   # #   #         # #   #
# # ######### # ######### ### ##### # # # # ### # # # ### ### # ### ##### ### #
#       # #     #     # #     # #   #   # # #   #   # #   # # #   # #   #   # #
####### # # ##### ### # # ##### # ####### # # ##### # # ### # ##### # # ### # #
#     # #   # #   #   #   #     #     #   # # #   # # # #   # #     # #   #   #
# ### ##### # # # ##### ### ### ####### # ### # # # # # # ### # ##### ### ### #
# #         #   #       #     #         #     # #   #   #       #       #     #
###############################################################################
