###############################################################################
#         #   #   #       #     #     #         #       #         #           #
# ####### ### # # # ### ### # ### ### # # # ########### # ####### ### ####### #
# # #       # # #     # #   #   # # #   # # #   #         #     #   # #     # #
# # # ####### # ####### # # ### # # ##### ### # ##### ######### ### # # ### # #
# # # #         #     # # #   #     #   #     #     # #     # #     #   #   # #
# # # # ####### # ### # # ### # ####### # # ##### # # ### # # ######### # ### #
# # # # # #   # # # # #   #   #       #   # #     # #     #           # # #   #
# # # # # # ### # # # # ############# ##### ####### ##### ############# # #####
# #   # # # #   # # # # #         #   # #   #             #     #   #   # #   #
# # ### # # ### # # # ### ##### # ##### # ### ######### # # ### # # # ### # ###
# # #     #   # #   #     #     # #     # # #   #       # #   #   # #   # #   #
# # # ### ### # ### ####### # ####### # # # ### # ### ####### ##### ### # # # #
# # #   # #   # #   #       # #     # # #   #   #   #         #     #   # # # #
# ##### # # # ### ### ######### ### # ####### ### # ########### ######### # # #
#       # # #     # #     #     #   # #   #   #   #   #   #   #   #     #   # #
# ####### # ####### ##### ### ### ### # # # # # ####### # # ##### # ### ##### #
# # #     # #     #     #     # #   # # #   # # #       # #   #   #   # #     #
# # # ##### # ### # ### ####### ### # # ####### # ####### ### # ##### # # ### #
#   # #   # #   # # # # #         # # #   #     # # #   #   # # #   # #   #   #
### # # # ##### # # # # ### ##### # # ### # ##### # # # ### # # # # # ##### ###
#   #   #       #   #       #     #       #       #   #     #     #   #       #
###############################################################################
