###############################################################################
#     #     #     #             #     #       #     #     #     #   #     #   #
# ### # ### # ##### ############# ##### # ### ### ### ### # ### # # # ### ### #
#   #   #     #   #       #     #       #   #   #   # #   # # # # #   # #   # #
### ##### ##### # ####### # ### ######### # ### ### # # ### # ### ##### ### # #
#   #     #   # #         #   #     #   # #   # #   # #     #     # #     # # #
# ### ##### # # ### ####### # ####### ### ### # # ### ####### # ### # ### # # #
# #     #   #   #     # # # #   #     #   #   #       #   # # #   # #   # #   #
# ########### ######### # # ### # ### # # ############# # # # # # # ### # ### #
# #       #           # # # #   # #   # # #   #   #     # #   # # #   # #     #
# # ### ### ######### # # # ### # # ### # # # # # ### ### ##### # ### #########
#     # # #     # #   #   #   #   #   # # # #   #     #   #     # #         # #
# ##### # ##### # # ##### # ########### ### ########### ### ##### # # ##### # #
# #     #       # # #     #           #       #         #   #   #   # # #   # #
### ############# # # ##### ######### ### ##### ######### ##### ### ### # ### #
#   #           # #   #     # #   #   #   #   # #   #     #   #   #   # # #   #
# ### ### ##### # # ##### ### # # # ####### # # # # ### ### # ### ### # # # # #
# #   #     #     #     # #     #   #       # # # #     #   #     # #   #   # #
# # ### ####### ### ### ### ### ##### ####### # # # ##### ####### # ######### #
# # #   #     #     #   #   #   #     #       # # #   # #       #         #   #
# # ######### ### ####### # ##### ##### ####### # ##### # ##### ########### ###
#               #         #       #               #           #               #
###############################################################################
