###############################################################################
#   #               #                 #   #     #                   #         #
# # # # ########### ### ####### ##### # # ### ### ############### # # ### ### #
# #   #       #   #     #     # #   #   #   #     #   #         # # # #     # #
# ########### ### ######### ### # ######### # ##### ### # ##### # # ### ##### #
#           #   #         #     # #       # #       #   #   # # # #     #     #
####### ##### ########### ####### # ### ### ##### ### ##### # # # ####### #####
# # # # #   #     # #   # #       #   #       #   #   # #     # # #     #     #
# # # # # # ### # # # # # # # # ############# # ### ### # ### # # # ### ##### #
# # #   # #     #   # #   # # #           # # #   # #   #   # # #   # #   # # #
# # ##### ######### # ##### # # ####### # # # ##### # ##### # # ##### ### # # #
# #     #     #     #       # #     #   #   #     # # #   # # #   #         # #
# ##### ### # ############# # ##### ####### ##### # # # # # ##### ####### ### #
# #   # #   # #     #       # #   #       # #   # # #   # # #     #     # #   #
# # # # # ### ##### # ####### # ########### # # # # # ### # # ##### ### # # # #
#   # #   # #       # # #     # #     #     # # #   # # #   # #     #   # # # #
### # ##### ### # ### # # ##### # ### # ##### # ##### # ##### ##### # ##### # #
# # #   #     # # #   #   #   #   #   #   #   #     #     #         # #     # #
# # ### ### ### ### ### ##### # ### ##### ####### # ##### # ######### # ##### #
# #   # #   #     #   #     #   #   #     #     # #   #   #   # #   # # # #   #
# ##### # # # ### # ##### # ##### ### ##### ### ##### # ####### # # # # # # ###
#         #     #   #     #     #           #         #         # #     #     #
###############################################################################
