###############################################################################
#                 # #   #       #     #   #     #     #   #               #   #
# ### ########### # # # ### ### ### # # # # ### # ### # ##### ########### ### #
#   # #   #         # # #     #   # # # # #   #   #   # # #   #   #   #   #   #
# # ### # ### ####### # # ### ### # ### # # # ##### ### # # ### ### # # ### ###
# #     #   #     #   # #   # #   #     #   #     #     # #   #     #   #     #
# ######### ##### # # # # # # ################### ##### # ### # ### ######### #
# #   #     #     # # # # # # #   #       # #   # # #   #   # #   #     #     #
### # # ########### # # # # # # # # ##### # # # # # # ### ### ######### # ### #
#   # # #     #     # # # # # # # #   #   # # #   #   #   #   #     #   #   # #
# ### # # ### # ##### # ### ### # ### # # # # ##### ### # # # # ### # ### # ###
# #     # # # # #     #   #     # #   # #     #   #     # # #   #   #   # #   #
# ####### # # # # ####### # ##### # ### ####### # ######### # ### ##### # ### #
#   #   # # # # # #   #   # #     # #           # #         #   # #   # #   # #
### # # # # # # # # # # ### # ### # ############# # ########### # # ### ##### #
#   # # # # # # # # # # #   #   # #         #   #   # #   #   # # #   # #     #
# ### # ### # # # # ### # ##### ######### ### # ##### # # # # # ##### # # ### #
#     #     #   # #   #       #         #     # #   #   # # # # #     # # # # #
# ##### ### ##### ### ############# ### ####### ### # ### # # ### # ### # # # #
# #   #   # #   # #     #   #         #       # #   #   # # #     #     #   # #
# # # ### ### # ### ### # # # ############# # # # ##### # # ################# #
#   #   #     #       #   #   #             #   #       #                     #
###############################################################################
