###############################################################################
#   #           #           #   #       # #   #   #     #   #       #         #
# # # ####### # # ######### # # # ##### # # # # ### # ### # # ##### ##### #####
# # #   #   # # #   # #     # #   #       # # #     #     # # #     #   #     #
# ##### # # ### ### # # ##### ##### ####### # # ########### # # ##### # ##### #
# #     # #     #     #     #     # #     # # #           # # # #     # #     #
# # ##### ####### # ### ######### # # ### # # ##### ####### # # ### ### # ### #
#   #   #         #   # #         #   # #   # #   # #         #     # # #   # #
### ### ######### ### ### ############# ##### # # # # ############### # ### ###
# # #   #           #   # #     #   #   #     # #   # #         #     #   #   #
# # # # ############### # # ### # # # # # ########### # ### ##### ### ### # # #
#   # #   #         # #   #   # # #   # # #     #     #   # #   #   #   # # # #
# ### ### # ####### # ####### # # ##### # # ##### ####### # # # ### ### # ### #
#     # #   #       #   #     # #   # #   #   #   #       #   #   # # #     # #
# ##### ##### ### ### # # ### # ### # # ##### # ### ####### ### # # # ####### #
# #     #   # #   # # #   #   #     # #   #       # #     # # # # #   #       #
# # # ### # # # ### ####### ##### ### ### # ##### ### ### # # # # ### ### # ###
# # #   # #   #   #       #   #   # #   # #     #     #   #   # # # #   # #   #
# ##### # ####### ####### ### ### # # # # ##### ####### ####### # # ### ##### #
# #   # #   #   #   #   #     #   # # # #     # #     # #       # #   # #     #
# # ### ### # # # ### # ####### ### # # ##### # # ### # ### ##### # # # # ### #
#   #         # #     #     #   #     #         #   #       #       # #   #   #
###############################################################################
