###############################################################################
# #       #         #   #           #           #       #   #       #     #   #
# # ### ### ####### # # # ####### # # ####### # ### ##### # ##### ### ### # ###
#   # #   # #     #   #   # #     # # #   #   #     #     # #   # #   #   #   #
# ### ### # # # ########### # ####### ### # ##### ### ##### # # # ##### ##### #
#       # # # #     #   #   #   #         # #     #   # #   # # #     #     # #
### ##### # # ### # # # ### ### # ######### ##### # ### ##### ### ######### # #
#   #     # #   # # # #     #   # #   #         # #   #   #   #           # # #
##### ### # ##### # # ##### # ### # ### ####### ### # # ### # ######### # # # #
#       # # #     #   # #   #     #   # #   # #     #     # #         # # #   #
# ##### ### # ######### # ##### ##### # # # # ########### # # ####### ### # # #
# #   # #   #   #   #     #     #     #   # #   #         # # #     # #   # # #
# # # # # ##### # ### ##### ##### ### ##### # ### ######### # # ### # # ##### #
# # # #   #   # #     #     #     #   #   # #           #   # # #   # #     # #
# # ####### # # ##### ####### ##### ### # ### ######### # ##### # ### ### # # #
# #         # #     #     #     #       # #     #       #       # # #     # # #
# ##### ##### ##### ##### ##### ########### ##### ############### # ####### # #
#   #   #   # #     #     #   #       # #   #     #               #       #   #
### # ### ### # ##### ##### # ####### # # ### # ### # ############### # # #####
# #   # #     # # #   #     #         # #   # # #   #   #       #   # # #     #
# ##### # ##### # # ####### ####### ### ### ### ##### # # ##### # # ### ##### #
#               #           #             #   #       #   #       #     #     #
###############################################################################
