###############################################################################
#           #   #           #         # #           #       #           #     #
# # ####### # # # ####### ### # ##### # ####### ### # ##### ### ######### # ###
# # #   #   # # # #   #   #   # #   #   #   #   # #   #   #   #   #       #   #
# # # # # ### # # ### # ### ### # ####### ### ### ##### ##### # # # ######### #
# # # # #   # #   #   # #   #     #     # # # # #   #         # #   #   #     #
# ### # ### # ### # ### # ### ##### # # # # # # # ### ######### ####### # #####
#     # #   #   # #   #   #   #   # # # #   #   # #   #       #     #   #     #
# ##### # ##### # ### ### ### # ### # ### ##### # # ####### # ##### # ####### #
# # #   #     # # #     #   # # # # #       #   #   #       # #       #       #
# # # ### ##### # # ####### ### # # ### ### # ####### ####### ####### # ##### #
#   #   # #     #   #   #   #   #   # #   # #   #   #   #         #   #     # #
### ### ### ####### # # # ### ####### ##### # # # # ### ######### ######### ###
#   #       #     # # #   #   #     #   #   # #   #         #   #         #   #
# ### ####### ### # # ### # ### # # ### # ##### ########### # ########### ### #
#   # #   #   # # # # #   # #   # #   # #           #   #   # #         #     #
### # ### # ### # ### ##### # ### ### # # ########### # # ### # ####### ##### #
#   # #   # #       #     # #   #   # # #     #       #   #         #   #     #
# ### # # ### ##### # ### # ####### # # ####### ####### ##### ##### # ### #####
# #   # #   # #   # #   # #     #   #   #     #   #   #     # #   # #   #     #
# # ### ### ##### # ### # ##### # ### ### ### ### # # ######### # ### # ##### #
# #     #         #     #         #       #         #           #   # #       #
###############################################################################
