###############################################################################
#     #   #       #           #       #   #           #               #       #
# ### ### ##### # ####### # # ### # ### # # ####### # ######### ### # ##### # #
# #       #     #   #   # # #   # #     #   #     # #         # #   #       # #
# ##### # # ####### # # # # ### # ########### ### # ######### ### ########### #
# # #   #   #     # # # # #   # #     #       #   # #       #     #         # #
# # ######### ### # # # # ### # ##### # ####### ### # # ### ### ### ####### # #
# #     # #   # # # # # # #   # #   # #   #   # #   # #   # #   #     #   #   #
# ### # # # ### # # # # ### ### # # # ### # # # # ### ### ### ### ### # #######
# #   # #       # #   #     #   # # #     # #   # # # # #       # # # # #     #
# # ### ####### # ########### ### ##### ### ##### # # # ######### # # # # ### #
# #   #       # #         # #   #     # # #     # # # #       #   #   #   #   #
# ### ####### # # # ##### # ### ### # # # ####### # # # ##### # ##### ##### ###
#   #   #   # # # #     #     #   # #     #       # # #   #   #     #   #   # #
# # ### # # # # # # ### ##### ### ####### # ####### # # # # ####### ### # # # #
# # #   # # # # # # #   #   #   #       # #     #     # # #     #   # #   # # #
# # # # ### ##### ### ### # ############# ##### # ##### # ####### ### # ##### #
# # # # #   #   #   #     #       #   #   # #   # #   # # #     # #     #   # #
# # # ### # # # ### ############# # # ### # # ### # # # # # ### # # ##### # # #
# # #     #   #   #   #         #   #   #   # # # # # # # # # #   #     # # # #
# # ##### ####### # ### ############### ##### # # # # ### # # ########### # # #
# #       #         #                         #     #     #               #   #
###############################################################################
