###############################################################################
# #     #               # #       #   #     #   #   # #   #   #     #         #
# # # ### ############### ##### # ### ##### # # # # # # # # # # # # # ### #####
#   #   #           #   # #     # # #   # #   # # # # # #   #   # # # #   #   #
####### ####### # # # # # ####### # # # # ##### # ### # ####### # # ### ### # #
# #       #   # # #   # # #     #     #   #     #     #   #   # # #     #   # #
# # # ##### # # # ####### # ### ##### ##### ##### ##### ### # ### # ### # ### #
# # # #     # # #   #     # #       # #   #     #   #   #   # #   # # # # #   #
# # ### ### # ##### # # ### ####### # ### ##### # # ##### ### # ### # ### # ###
# # #     # #       # # #   #   #   # #         # #     #   #   # # #     #   #
# # # ##### ######### ### # # # ##### # ####### ##### # # # ##### # ### ##### #
# #   #   # #   #   # #   # # #   #     #   #   #     # # #   #     #   #     #
# ### # # # # # # # # # ##### # # # ##### # # # # ### # ##### ### ### ### #####
#   # # #   # #   #           # # # #   # #   #   #   #     #   #   # #   #   #
# # # # ##### ################# # # # ############# ####### # # ### # ##### # #
# #   #       #     #     #   # # #   #   #             #     # #   #       # #
# ############# ##### ##### # ### ##### # # ######### ######### ### ######### #
# #     #       #       #   #           #   #   #   # # #     #   #         # #
# # ### # ##### # ##### # ##### ### ##### ##### # # ### # ### ### ########### #
#   # # #   # # # #     #   #   #   #   #         # #   # #   # #     #       #
##### # ### # # # # ####### # ####### ##### ####### # # # # ### ##### # #######
#         #   #   #         #         #     #         #   #         #         #
###############################################################################
