###############################################################################
#                 #       #     #   #   #         #   #               #       #
# ##### ######### # ####### ### # # ### # # ####### # # ########### # ### # ###
# #     #   #       #       # #   # #   # #         # # #           #   # #   #
### ##### # ######### ### ### ##### # ### ####### ### ### ####### ##### ### # #
#   #     #           # # #   #   # #     #     # # #     #           #   # # #
# ### ### ############# # ### ### # ####### # # # # ####### ######### ### ### #
# #   # # #       #     #   #       #       # # #   #     #   #     # #   #   #
# # ### ### ##### ##### ### # ##### # # ##### # ### # ### ### # # # # # ### # #
# # #       #         #   # # #       # #   # # #   # # #   # # # #   #     # #
# # # ##### ######### # # # ####### ##### # # # # ### # # ### # # #############
#     #   # #   #     # # # #     # #     # # # # #   # #     # #       #     #
####### # # # ####### # # # ##### ### ##### # # ####### ####### ######### ### #
#   #   #   #       #   # #   # # #   #   #   #       #     #             # # #
# # ############### ######### # # # ##### ######### # # # ### ####### ##### # #
# # #   #     #   #       #   # #   #       #   # # #   # #   # #   # #   #   #
# # # # # ### # # ####### # ### ##### ####### # # # ### ### ### # # # ### #####
# #   # #   #   #       # # #       # #     # #   # #   #   #   # # #   #     #
# ##### ####### # ##### # # # ##### # # ### # # ### ##### ### ### # ### # ### #
# #   #   #   # #     #   # #     #   # #   # #           #   #   # #   #   # #
# # # ### # # # ##### ##### # # ####### # ### ### ######### ### ### # ##### # #
#   #   #   #       #       # #         #       #           #     #         # #
###############################################################################
