###############################################################################
#                 #   #   #     #         #             # #         #         #
# ########### # ### # # # ##### # ####### # # ######### # # ####### ### ##### #
#   #   #   # #     #   # #   #   #   #   # # #     #   # # #       #   #   # #
# ### # # # # ### ####### # # ##### # # ### # ##### # ### # # ####### ### # # #
# #   #   # # # #   #   # # #   #   #   #   # #   # #   #   #   # #       # # #
### ##### # # # ### # ### ##### # ########### # # # ### # ##### # # ####### # #
#   #   # #   # # # #           # #         #   # #   # # # #   #     #   # # #
# ### ##### ### # # ######### ### ### ##### ##### # ### # # # ####### # # # ###
# #   #     #   #           # #     #   #     # # #   # # # #       # # # #   #
# # # # ### # # ########### ### ### ### ##### # # ### # # # ####### ### # # # #
# # # # # # # # #   #       #   # #         #   # #   # # #       #   # # # # #
# ### # # # # ### # ####### # ### ######### ### # # ### # ### # ### # # # ### #
#   #   # #   #   #   #   #   # #     # # #   #   #     #   # # #   #   # #   #
# # ##### ##### ##### # # # ### # # # # # ### ############# ### # ####### # ###
# #   #   #     #   # # # # # #   # #     #       #             #       # #   #
# ### # # # ##### ### # # ### # # # ##### ####### # ########### ##### # # # # #
# #   # #   #     # #   #     # # #   # #     #   #   #     #   #   # # # # # #
# # ### ### # ##### ### # ########### # ##### # ####### ### ##### # ### # # # #
# #   #   #   # #       #             # #   # #     #   # # #     #   # # # # #
# ### ####### # # ##################### # # # ##### # ### # # ####### # # ### #
#   #         #   #                       #   #           #   #         #     #
###############################################################################
