###############################################################################
#       #       #         #     #   #       #       #     #             #     #
# ### # # # ##### ##### # # # ### # # # ### # # ### # # ### ########### # ### #
#   # # # #       #   # # # #     # # # #   # #   # # #   #     #   #   # #   #
### # ### ######### # ### # ####### # # ##### ### # # ### ##### ### # ##### ###
#   # #   #       # #     # #     #   # #   # #   # #   #   # #     #       # #
##### # ##### # # # ####### # # # ##### ### # # # ##### ### # ########### ### #
#     #     # # # #       # # # # #   #   # # # #       #   #           #   # #
# ### ##### # # ####### # # # # # # # ### # # ########### ####### ##### ### # #
# #   #   # # # #     # # # # # # # # # # #   #     #     # #     #       # # #
# # ##### # ### # ### ### # ### # # # # # ##### # # # ##### # ####### ##### # #
# # #     #     #   #     #   # # # # # #   # # # # # #         #   # #     # #
# # ### ### ####### ######### # # # # # # # # # # ### ######### # # # # ##### #
# #   #     #       #       # # #   # #   # # # #   #           # #   #       #
# ### # ##### ########### # # # ##### ### # # # ### ############# ### ####### #
#   # #   # #           # # # # #   #   # #   # # # #     #       # #         #
# # # ### # ### ####### # # # # ### ### # ##### # # # ### # ####### ### #######
# # # #   #   # # #       # #   #   #   #     #   # #   # #   #     # #       #
# # ### ##### # # # ############# ### ####### ### # ##### ### # ### # #########
# # #   #     # #   #       #     #   #     #   # # #   #   #   #   #         #
# # # ### ### # ##### ##### # # ### ##### # ### # # # # # # ##### ####### ### #
# #       #   #           #   #           #   #   #   #   #               #   #
###############################################################################
