###############################################################################
#     #           #       #     # # #       #     #   #       #             # #
# ### # ######### # # ##### # # # # # ##### # ### # # # # ### # ########### # #
# # #   #     # # # #   #   # #   # #     #   #   # #   #   # #   # #       # #
# # ##### ### # # ##### # ### ### # # ### ##### ########### # # # # # ####### #
# #     # # #   # #   #     # #   # # # # #   #             # # # #       #   #
# # # ### # # # # # # ####### # ### # # # ### ############### # # ####### # # #
# # #       # # # # #         #   # # #     #     #   #   # # # #       #   # #
# # ####### # ### # ############# # # ##### # ### # # # # # # ##### ### ##### #
# #       # #     #       #     # #   #     # # #   #   # # #     #   # #   # #
# ####### ############# # # # # # ### # ##### # ### ##### # ##### ##### ### # #
#       #               # # # # #   # # # #     #   #   # #     #     #   #   #
# ##### ################# # # ##### ### # # ##### # # ### ### # ##### ### # ###
# #   #   #   #     # #   # #     #     #     #   #   #   #   # #   #     # # #
# # ##### # # # ### # # ### ##### ############# ### ####### # ### # ####### # #
#   #   # # # #   # #   #   #   # #       #     #           # #   #         # #
### # # # # # ### # # ####### # # # # ### # ########### ####### ##### ####### #
#   # # # # #   # # # #       # #   #   # #         #   #     # #   # #       #
####### # # # ### # # # # ##### ####### ########### ##### ### # # # # ####### #
#       #   #     # # # #     # #           #   # # #   # #   # # # #     #   #
# ################# # ####### # # ######### # # # # # # # # # # # ####### # # #
#                   #         #   #           #   #   #   # #   #           # #
###############################################################################
