###############################################################################
#             #                 #     #     #         #   # #       #   #     #
# ####### ### ##### ########### ### ### ### # ####### # # # # ### # # # ##### #
# #   #   #         #       #       #   #   # # #       # #     # # # # #   # #
### # # ########### ##### ### ##### # ####### # ##### ### # ##### # # # # ### #
#   # #         # # #   #     #   # #     #     #   # # # #   #   #   # #   # #
# ### # ####### # # ### ### ### # ####### # ##### # ### # ##### ####### ### # #
# # # #   #   # # #   #   # #   #           #     # #   #       #   #   #     #
# # # ##### # # # ### ### # # ############### ##### ### # ######### # ### ### #
# #         #   #   #   # # # #         #   #   #     # # #   #     #     #   #
# # ############### ### # ### # # ### # # # ### ##### # # # # # ### ####### ###
# # #         #   #     #   #   # # # #   # #       #   # # # # #     #   # # #
# ### ####### # # # ##### # ##### # # ##### # ##### ######### # ### ### # # # #
#   # #     # # # #   #   #   #   # # #     # #   # #   #     #   # #   # #   #
# # # # ##### # # ### # ### ### # # # # ##### # # # # # # # ##### # # ### ### #
# # #   #     # #   # # # #     # #   #       # # # # #   #     # # # # # #   #
# # # ### ### # ### ### # ####### # ########### # # ##### ##### # # # # # #####
# #   #   # # #   # #   #       # #   #       # # # #     #   # # # # # #     #
# ##### ### # # ### # ##### ### # ##### ### ### # # # ##### ### # ### # ##### #
# #   #     # # #   #     # # # #       #   #   #   #   # #     #         #   #
# ### ##### # # # ####### # # # ######### ### ######### # # ############### # #
#         # #   #         #   #             #           #                   # #
###############################################################################
