###############################################################################
#     #                     #     #                         #       #         #
##### # ########### # ####### ### ####### ####### ### ##### ####### # ### #####
#     #   #   # #   # #     #   #   #   # #     #   #   # # #     # # # #     #
# ####### # # # # ##### ### ### ### # ##### ### ### ### # # # ### # # # ##### #
#       # # #   #     #   #   # # # #   # # #   #   #   # #   # # # # #     # #
##### ### # ######### # ##### # # # ### # # # ####### ### ##### # # # # # ### #
#     #   #         #   #     # #       #   #   #   # #     #   # # # # # #   #
# ##### ########### ##### ##### ######### ##### # # # # ### # # # # # # # # ###
# #   #             #     #   #     #   # #   # # # # #   #   #   # #   # #   #
# # # ####### ####### ##### # ### # # # # # ### # # # ### ######### ##### ### #
#   #     #   #       # #   #   # #   #   #     # #   #   #     #   #     #   #
# ##### # # ### ####### ####### # ######### ##### ##### ### ### # # # ##### # #
# #   # # # # #   #         #   #   #     # #     #     #   #   # # #   #   # #
# ### # ### # ### # ####### ### ### # # ### ### ####### # ### # # # ### # ### #
#     #     # #   # #     #   #   # # #   #     #     # #   # # # #     #   # #
##### ####### # ### # ### ### ### # ##### # ######### # ### # ### ######### # #
#   #   #     #   #   # # # #     # #   #   #         # #   #         #     # #
# # ### # ### ### ##### # # ### ### # ####### ######### ############### ##### #
# #   #   # # # #       #   # #     # #       #   #   #   #       #   # #     #
# ######### # # # ######### # ##### # # ### ### # ### ### # ##### # # # # #####
#               #                 #     #       #       #   #       #   #     #
###############################################################################
