###############################################################################
#   #   #     #         #   #       #     #       #           # #   #     #   #
# ### # # ##### ####### # # # ####### # ### # ### # # ####### # # # # ### # # #
#     # #   #   #   #   # # #         #     #   # # # #   #   #   # # #   # # #
##### # ### # ##### # ### # ######### ######### ### # # # ### ##### # # ##### #
#   # # #   #   #     #   #   #     # #   #   #   # #   #   #     # # #     # #
# # # # # # ### # ##### ##### # ### ### # # # ### # ####### ##### # # ##### # #
# #   #   #   # #       #   #   # #   # #   #   # #     # #     # # #   # #   #
# ##### ####### ######### # ##### ### # ### ### # ##### # ##### # # ### # ### #
# #     #     #       #   #         #   #   #         # #     # #   #   #     #
# ####### ### ####### # ####### ######### ####### ##### # ### # ##### ### #####
#     #   #   #     # # #   #   #       #   #   # #     #   # #   #   #       #
# ### # ### # ### # # ##### # # # ### # ### # # ### ##### # # ### # ######### #
# # #   #   #     # # #   #   #   # # #     # # #   #     # #   #   #   #     #
# # ##### ######### # # # ######### # ##### # # # ### ##### ### ### # # # ### #
#     # #   #     # #   #       #   #   #   # #   #   #   #   # # #   # # #   #
##### # ### # ### # ####### ### # # ### # ### ##### ### # ### ### ##### # # ###
#     # #   #   # #   #     #   # # #   #   #   #       # #   #   #   # # # # #
# ##### # # ### # ##### ##### ### ### # ####### ########### ### # # # # ##### #
#   #   # # #   #     #     # #     # # #     #       #     #   #   # # #     #
### ### # ### ####### ##### # ##### # ### ### ####### # ##### ####### # # ### #
#       #           #       #       #       #         #             #     #   #
###############################################################################
