###############################################################################
#     #           #   #     #   #   #             #     #           #         #
# # ### ### ##### # # # ### ### # # # # ### ##### # ### ### ####### ######### #
# #       # #     # # #   #   # # #   #   # #     #   #           #   #       #
######### # ##### # ##### # ### # ####### # # ####### # ############# # ##### #
#   # #   #     # #     # #     # #       # #         # #         # # # #     #
# # # ######### # ##### # ### ### # ####### ########### # ####### # # # # #####
# #   #     #   # #   #   #   # # #     # #           # # #     # # # # # #   #
# ##### ### # ##### # ##### ### ####### # # ######### ### # ### # # # # ### # #
#   #   #   #       #   #     #       # #       #         # #   # # # #     # #
### # ### ############# # ### ##### # # ####### ########### ##### # # # ### # #
#   # #     #   # #   # # # #   #   # #       #         #   #   # #   # # # # #
# ### # ### # # # # # # # # ### # ##### ##### ######### ### # # # # ### # # # #
#     #   #   #   # #   # #           # #     # #     #   #   #   # #     # # #
######### # ### ### ### # # ######### ### ##### # ### ##### ####### ### ### # #
# #       # # #     # #   #   #     #     #     # # #     #     #     # #   # #
# # ### ##### ####### ### ### # ### ######### # # # ### ####### ##### # # #####
# # # #   #       #     #   # #   # #         # #     #   #   #   #   # #     #
# # # ### # # ### # ####### ####### ### ### # ####### ### # # ### # ####### # #
# # #   # # # #   #       #   #   #   # # # # #     #   #   #   # #   #   # # #
# # # # # ### # ######### ### # # ### # # # ### ### ### ##### ### ### # # ### #
#     # #     #             #   #     #   #       #         #     #     #     #
###############################################################################
