###############################################################################
#       #       #   #   #           #   #         #             #   #         #
### # ### ##### ### # # ####### ##### # # ### ### ### ########### # # ####### #
#   # #   #   #   #   #       #       #   # # #       #     #   # #       #   #
# # ### ### # ### # ######### ######### ### # ####### ### # # # # ####### # ###
# # #       #   #           #   #     #     #     #     # #   #   #     # #   #
# ### ############# ####### ### # ### # ######### ##### # ######### ### # ### #
#     #     #     # #   #     #     # # #   #   # #   # #           #   #   # #
# ##### ##### ### # # # ############# ### # # # # # # ##### ######### ##### ###
# #   #         # # # #     #   #     #   #   # #   # #     #         #   #   #
# # # ########### ### ##### ### # ##### ####### # ### # ##### ########### ### #
#   # #   #   #   #   #       # # #     # #     #   #   #     #   #           #
##### ### # # # ####### ### # # # # ##### # ############# ##### ### ######### #
#   #   #   # #   #   #   # # # #     #   #   #           #       #   #     # #
# # ### # ### ### ### # ### # # ##### # # ### # ########### ##### ### # ##### #
# #     #   #   #   #   #   # # #     # # #   # #         # #   #   # #     # #
# ########### ##### # ### ##### # ##### ### ### # ### ##### # # ### # # ### # #
#       #   #     # #   #     # # #   #   #   # # #   #   # # #   #   #   #   #
####### # ### ### # # # # ### # # ### # # ### # # # ### # ### ### ######### ###
#     #   #   # # #   # #   #   #   # # # #   # # #     #   # # #     #   #   #
# ### ##### ### # ##### # ######### # # # # ### # ######### # # ### ### # ### #
#   #           #       #           #   #       #         #       #     #     #
###############################################################################
