###############################################################################
# #   # #   #     #                             #   #   #         #       #   #
# # # # # # # ### ####### ################### # # # # ### ####### # # ### # # #
#   # #   #     #   #   # #         #   #     #   # # #   #     #   #   #   # #
# ### ######### ### # # # # ####### # # # ######### # # ### ### ####### ##### #
# #   #   #   #   #   # # # #       # # #   #         #     # #   #   # #     #
# # ### # # # ### ##### # # # ####### # ### ####### ######### ### # # # # #####
# #     #   #   # # #   #   #       # #   #       # #     # #   #   # # #     #
# ############# # # # ############# ### # ####### ### ### # # # # ### # ##### #
#   #       #   #   #   #         #     # #     #   # # # #   #   # # #     # #
### # ####### # ### ### ####### # ####### # ### # # # # # # ####### # ##### ###
# # #       # # #   # #       # #       # # #   # # # # #   #       # #   #   #
# # # ##### # ### ### ####### ### ####### # # ##### # # ##### ### ### # ##### #
# # #     # #   #   #       # # #   #     # #       #   #     # #     #     # #
# # # ##### ### ### ### ### # # ### # ##### ### ####### # ##### ##### # # # # #
# # # #     #   # #     #   # #   #   #   #   # #       #       #   # # # # # #
# # ### ### # ### ##### ##### ### ##### # # # ### ########### ### # # ### # # #
#   #   #   #   # #     #       # #     # # #         #     # #   # #     # # #
# ### ### ##### # # ##### ####### # ##### # ######### # ### ### ### ######### #
# #     # #   #   # # # # #       #   # # #     #   # # # # #   # #         # #
# ##### # # # # ### # # # # ######### # # ####### # ### # # # ### ######### # #
#       #   # #       #               #           #     #     #               #
###############################################################################
