###############################################################################
#               #   #             #                   #       #           #   #
### # ########### # # ########### # ################# # ##### # ### ##### # # #
#   # #           # #     #     #   #   #   # #       # #   # #   # #       # #
# ##### ########### # ### # ######### ### # # # ####### ### # ##### ######### #
#     #   #   #   # #   #         #   #   # # # #       #   #   #   #       # #
# ### ### # ### # # ############# ### # ### # # ##### ### ##### # ### ##### ###
# #     # #     #   #           #   # # #   #       # #         #       # #   #
# # ### # # ##### ### ######### # # # # # ######### # # ######### ##### # ### #
# # #   # # #       #   #     # # #     #         #   # #       # #   #   # # #
# # # ### # ########### ##### # ####### ######### ##### ##### ### # # ### # # #
# # # #   # #         # #     #   #   # #   #     #   #     #     # # #     # #
### ### ### # # ### ### # ### ### # # ### # # ##### ####### ####### # ####### #
#   #   # #   #   #     # #     #   #     # # #     #     #     #   #         #
# # # ### ####### ####### ##### ##### # ### # ### ### ### ##### # ########### #
# # #       #     #   #     # # #   # # #   #   #     #   #   # #       # #   #
# # ####### ####### # ##### # # # # ### # ##### # ##### # # ### # ##### # # ###
# #   #   #         # #     # # # #     #       # #   # # # #   #     # # #   #
# ### # # ########### # ##### # # ############### # # # # # # ### ##### # ### #
# #     # #     #     # #     # #   #   #       # # # # #   # #   #   # # #   #
# ######### ### # ##### # # ### ### # # # # ##### # # # ##### ##### # # # # ###
#             #         # #       # # #   #         # #             #   #     #
###############################################################################
