###############################################################################
#       # #         #   #   #         #     #         #             #       # #
##### # # # # ### ### # # # # # # ##### ### # ####### # ### ######### # ### # #
#     #   # # #   #   # # #   # # #       #   #     # #   #           #   #   #
# ####### # # # ### ### # ##### ### ##### ##### ### # # ################# #####
#   #   # # # #   #   # # #   #     #   #   #   #   # # #                 #   #
# # # # ### # ####### # # # # ######### ##### ### ### # # ################# # #
# # # #   # #         # # # #   #     #     #   # # #   #   #             # # #
# # # ### # ########### # ##### # # ####### # # # # # ##### # ####### ##### # #
# #   # #   #     #   # # #     # #     #   # # # #       #       #   #     # #
# ##### ##### ### # ### # # ##### ##### # ##### # ############### # ### ##### #
# #     #     # # #   #   #     # #   #   #   # #           #     #         # #
# # ### ##### # # # # ######### # ### ##### # # ########### ########### ##### #
#   # #     # #   # #       #   #     # #   #   #   #       #   #     # #     #
##### ##### # ### ##### # # # # ##### # # # ##### # # ####### # # ### ### ### #
#       #   #   # #   # # #   #     # #   # #     # #   #     # # #   #   #   #
# ### ### ##### # # # ### ######### # ### # # # ### ### ### ### # # ### ### ###
#   # #   #     #   #   #         # #   # # # #   #   #   # #   # #   # #   # #
# ### # ### ########### ##### ### ##### # # # ### # ##### # # ### ### # # ### #
# #   # # #   #   #   # #   # #   #     # # #   # # #   #   #   #   # # # #   #
# # ### # ### # ### # # # # ### # # ####### ### # ### # ####### ### # # # # # #
# #           #     #     #     # #         #   #     #             #   #   # #
###############################################################################
