###############################################################################
#         #             #           #   #         #             #         #   #
# ####### # ##### ### ### # ####### # # # ### ### ######### # ### # ####### # #
#   #   # # #   #   #     #       # # #   # #   # #       # #     #         # #
### # # # ### # ##### ########### # # ##### ### # # ##### # ################# #
#   # # #     # #   #   #         # #   #     # #   #   # # #         #       #
# ### # ####### # # ##### ##### ####### ### # # ##### ### # ### ##### # ##### #
#   # #       # # #       #   # #     #     # # #   #     #   # #     # #     #
### # ####### # # ### ##### # ### ### ##### ### # # # ####### ### ### # ### ###
#   #       # #   #   #     #       #     # #   # # # #     #     # # #   #   #
# ######### # ####### # ########### ##### # # ##### # ### # ####### # ### ### #
#     #   # #       # #   #     #       # # # #   #       # #           # #   #
# # ### # # ####### ### ### ### ######### # # # # ######### # ########### # ###
# #     #   #     # #   #   #           # # #   #   #       #   # #       #   #
# ########### ### # # ### ############# # # ####### # ######### # # ######### #
#   #       # #   #     #   #   #     # # # # #     # #       #   # #       # #
### # ##### # ### ######### # # ### ### # # # # ##### ### # # ##### ### # ### #
# #   # #   #   # #   #   #   #   #   # # #   #   # #   # # # #   #   # #     #
# ##### # ##### ### ### # ### ### # # # # # ##### # ### ### # # # ### # #######
#         #     #   #   #   # #   # # # #   #     #   #     #   #   # # #     #
# ######### ### # ##### ### ### ### # # ##### ##### # ############# # # ##### #
#           #   #       #       #   #         #     #                 #       #
###############################################################################
